Host Name,Entire home/apts,Private rooms,Shared rooms,Hotel Rooms,Total Listings
Blueground,415,0,0,0,415
Eugene,4,0,396,0,400
Michael,187,0,108,4,299
David,176,0,96,2,274
June,37,0,195,0,232
Hiroki,9,0,198,0,207
Daniel,142,0,53,1,196
Shogo,5,0,187,0,192
Jeniffer,175,0,6,0,181
Momoyo,5,0,173,0,178
Kristina,61,0,107,1,169
John,102,0,58,4,164
Alex,83,0,75,1,159
Urban Furnished,156,0,0,0,156
Maria,73,0,74,1,148
Justin,21,0,122,0,143
Anthony,63,0,74,2,139
Ken,131,0,3,1,135
Andrew,91,0,43,0,134
Anna,76,0,57,0,133
Michelle,69,0,57,1,127
RoomPicks,86,0,40,0,126
Kaz,6,0,119,0,125
Stay With Vibe,124,0,0,0,124
Sarah,78,0,42,1,121
James,68,0,49,1,118
Jonathan,71,0,46,0,117
Chris,62,0,48,1,111
Jessica,70,0,37,1,108
Rachel,60,0,45,0,105
SharedEasy,0,0,76,29,105
Joseph,55,0,44,1,100
Avi,98,0,2,0,100
Kevin,62,0,36,1,99
Jason,71,0,26,0,97
Stanley,77,10,10,0,97
Mark,66,0,29,0,95
Jennifer,62,1,31,1,95
Jose,30,0,63,1,94
Mike,52,0,36,4,92
Sam,56,0,34,0,90
Laura,51,0,37,0,88
Robert,63,0,25,0,88
Ryan,51,0,34,1,86
Karen,48,0,37,1,86
Emily,55,0,30,0,85
Amy,51,0,33,0,84
Peter,53,0,31,0,84
Christopher,51,0,31,2,84
Matt,63,0,16,1,80
Nicole,51,0,26,1,78
Eric,48,0,29,0,77
Elizabeth,51,0,25,0,76
Julia,49,0,24,0,73
Blake,9,0,62,0,71
Benjamin,49,0,22,0,71
Alexander,44,0,26,1,71
Stephanie,42,0,28,0,70
Ben,36,0,32,2,70
Mikey,0,0,69,0,69
Alexandra,42,0,24,3,69
Nick,42,0,26,0,68
Ashley,43,0,25,0,68
Melissa,37,0,30,0,67
Andrea,39,0,26,1,66
Adam,47,0,19,0,66
Patricia,30,0,35,1,66
Nina,47,0,18,0,65
Steven,41,0,24,0,65
Matthew,44,0,21,0,65
Nathan,52,0,12,0,64
Sara,46,0,17,1,64
Brian,39,0,23,2,64
Thomas,41,0,23,0,64
MyNyHousing,63,0,0,0,63
Lauren,41,0,22,0,63
Paul,40,0,23,0,63
Sonder (NYC),24,0,39,0,63
Mary,33,0,29,1,63
The Local Stay,60,0,2,0,62
Natalie,44,0,17,1,62
Ana,30,0,31,1,62
Ali,33,0,28,0,61
Angela,23,0,37,0,60
Boomerang,59,0,0,0,59
Vanessa,24,0,35,0,59
Eliza,5,0,54,0,59
Carlos,28,0,30,0,58
Jeremy,51,0,6,1,58
Stat,0,0,57,0,57
Lisa,36,0,20,1,57
Oleksandr,0,0,55,1,56
Diana,18,0,38,0,56
Victor,20,0,32,4,56
Dan,33,1,21,0,55
George,34,0,21,0,55
Amanda,31,0,23,1,55
Aleph,2,0,52,0,54
Linda,27,0,27,0,54
William,26,0,26,1,53
Juan,26,0,25,1,52
Susan,27,0,25,0,52
Patrick,30,0,18,3,51
Christina,26,0,25,0,51
Carol,15,0,36,0,51
Jay,31,0,20,0,51
Joel,20,0,31,0,51
Hannah,27,0,22,1,50
RoomPicks By Antony,0,0,50,0,50
Jacqueline,29,0,15,5,49
Luis,26,0,22,0,48
Tony,28,0,20,0,48
Richard,32,0,16,0,48
Sandra,18,0,28,1,47
Marie,28,0,17,2,47
Samantha,23,0,24,0,47
Rebecca,24,0,23,0,47
Tyler,7,0,40,0,47
Joe,31,0,13,2,46
Scott,36,0,10,0,46
Sean,31,0,14,0,45
Christine,21,0,24,0,45
Joshua,25,0,20,0,45
Yana,38,0,7,0,45
Nomad,34,0,11,0,45
Inna,44,0,1,0,45
Heather,21,0,19,4,44
Shoreham,44,0,0,0,44
Christian,12,0,25,7,44
Eibhlin,0,0,44,0,44
Julie,29,0,14,0,43
Jeff,32,0,11,0,43
Emma,34,0,8,1,43
Charles,24,0,18,1,43
Katie,22,0,21,0,43
Marc,30,0,12,1,43
Javier,12,0,30,0,42
Tom,33,0,9,0,42
Sharon,24,0,17,1,42
Tiffany,31,0,11,0,42
Danielle,20,0,21,0,41
Liz,18,0,10,13,41
Steve,14,0,26,0,40
Alexis,16,0,23,1,40
Taylor,28,0,11,1,40
Eran,40,0,0,0,40
Nicholas,25,0,14,1,40
Katherine,21,0,17,1,39
Wendy,19,0,20,0,39
Monica,23,0,15,1,39
Hannah M.,39,0,0,0,39
Sonia,18,0,20,0,38
Josh,22,0,16,0,38
Aaron,25,0,13,0,38
Victoria,24,0,14,0,38
Marina,21,0,17,0,38
Annie,25,0,13,0,38
Ian,23,0,13,1,37
Kyle,17,0,20,0,37
Samuel,21,0,15,1,37
Kristina & Jack,6,0,31,0,37
Rafael,16,0,21,0,37
Rob,19,0,17,1,37
Cindy,9,0,24,4,37
Jordan,14,0,23,0,37
Kate,25,0,11,1,37
Ruth,14,0,19,3,36
Caroline,19,0,17,0,36
Gisele,30,0,6,0,36
Megan,17,0,19,0,36
Katya,8,0,28,0,36
Jorge,16,0,20,0,36
Zeus,36,0,0,0,36
Casey,28,0,7,0,35
Andy,21,0,14,0,35
Jenny,19,0,16,0,35
Max,14,0,21,0,35
Tim,21,0,13,0,34
Frank,13,0,21,0,34
Kimberly,17,0,15,1,33
Erin,23,0,10,0,33
Tara,15,0,18,0,33
Brandon,19,0,13,1,33
Greg,22,0,10,0,32
Central Park Apartments,32,0,0,0,32
Kim,17,0,15,0,32
Martin,20,0,12,0,32
Cristina,18,0,14,0,32
Gabriel,22,0,9,0,31
Sophia,11,0,20,0,31
AFI Apartments,31,0,0,0,31
Fukuda,0,0,31,0,31
Jt,30,0,1,0,31
Lindsay,20,0,10,1,31
Grace,18,0,13,0,31
Eva,21,0,9,0,30
Evan,23,0,7,0,30
Alicia,16,0,14,0,30
Vida,29,1,0,0,30
CRNY Monthly Rentals,30,0,0,0,30
Rose,18,0,11,0,29
Jack,15,0,14,0,29
Daniela & James,0,0,29,0,29
Catherine,18,0,10,1,29
Isaac,22,0,7,0,29
Jimmy,8,0,21,0,29
Claire,17,0,12,0,29
RoomPicks By Victoria,14,0,15,0,29
Jon,19,0,10,0,29
Natasha,14,0,14,1,29
Live Suite,29,0,0,0,29
Antonio,9,0,19,0,28
Manuel,11,0,17,0,28
Leo,19,0,9,0,28
Veronica,10,0,10,8,28
Alan,13,0,15,0,28
Lana,10,0,18,0,28
Carmen,16,0,11,1,28
Albert,12,0,16,0,28
Leah,8,0,20,0,28
Casamia 36,0,27,1,0,28
Kelly,19,0,9,0,28
Daniela,12,0,15,1,28
Nancy,22,0,6,0,28
Julian,14,0,14,0,28
Kay,9,0,19,0,28
Aamer,0,0,28,0,28
Jeffrey,16,0,11,0,27
Roger,19,0,8,0,27
Deborah,16,0,11,0,27
Oscar,18,0,9,0,27
BP Hosting,0,0,27,0,27
Fernando,18,0,9,0,27
Alice,17,0,10,0,27
Andre,17,0,10,0,27
Gregory,20,0,7,0,27
The Box House Hotel,16,3,8,0,27
Marcelo,6,0,21,0,27
Jamie,17,0,10,0,27
Marco,16,0,10,1,27
Stephen,16,0,11,0,27
Natalia,12,0,13,1,26
Mario,16,0,10,0,26
Crystal,13,0,13,0,26
Stella,9,0,17,0,26
Sasha,12,0,14,0,26
Sebastian,11,0,15,0,26
Jacob,19,0,7,0,26
Raymond,17,0,9,0,26
Erica,14,0,12,0,26
Will,15,0,9,2,26
Alberto,18,0,7,1,26
Shawn,16,0,9,0,25
Best Inns USA,25,0,0,0,25
Vincent,7,0,16,2,25
Gary,12,0,13,0,25
Edwin,15,0,10,0,25
Maggie,21,0,4,0,25
Eli,16,0,9,0,25
Lawrence,10,0,15,0,25
Denise,10,0,14,1,25
Jake,17,0,8,0,25
Claudia,20,0,5,0,25
Helen,7,0,17,1,25
Jane,10,0,14,1,25
Mohammed,6,0,18,0,24
Charlie,10,0,10,4,24
Anastasia,17,0,7,0,24
Stay And Smile,23,0,1,0,24
Emmanuel,8,0,15,1,24
Edward,14,0,10,0,24
Bryan,10,0,13,1,24
Karishma,9,0,15,0,24
Joan,5,0,18,1,24
Olivia,18,0,5,1,24
Evelyn,10,0,14,0,24
Anne,15,0,9,0,24
Kristina & Alex,2,0,22,0,24
Colin,13,0,11,0,24
Esplanade 99,0,0,23,0,23
Rosa,11,0,12,0,23
Jackie,8,0,15,0,23
Donna,14,0,9,0,23
Jean,13,0,10,0,23
Jaime,14,0,9,0,23
Martha,6,0,17,0,23
Barry,16,0,7,0,23
Tanya,13,0,10,0,23
Todd,19,0,4,0,23
Dee,10,0,13,0,23
Sabrina,15,0,8,0,23
Joanna,15,0,8,0,23
Lucy,7,0,16,0,23
Erika,17,0,6,0,23
Carla,8,0,14,1,23
Ricardo,12,0,10,1,23
Courtney,11,0,11,0,22
Dana,12,0,10,0,22
Dave,11,0,11,0,22
Shirley,5,0,17,0,22
Chloe,13,0,9,0,22
Sherry,7,0,15,0,22
Global Luxury Suites,22,0,0,0,22
Miguel,3,0,19,0,22
Bruce,16,0,6,0,22
Chelsea,14,0,8,0,22
Tina,13,0,9,0,22
Sophie,10,0,12,0,22
Miriam,11,0,11,0,22
Koichi,0,0,22,0,22
Yvonne,8,0,14,0,22
Diego,11,0,11,0,22
Jen,15,0,7,0,22
Doug,13,0,9,0,22
Address In NYC,8,0,13,0,21
Danny,11,0,9,1,21
Michele,8,0,13,0,21
Louis,9,0,7,5,21
Elena,13,0,7,1,21
M,8,0,13,0,21
Mia,8,0,13,0,21
Julio,8,0,13,0,21
Wapt,21,0,0,0,21
Ella,15,0,6,0,21
Allison,10,0,11,0,21
Lee,14,0,6,0,20
Philip,14,0,6,0,20
Terry,10,0,10,0,20
Paula,10,0,10,0,20
Cynthia,9,0,11,0,20
Maya,9,0,11,0,20
Ignacio,19,0,1,0,20
Katy,17,0,3,0,20
Gina,10,0,10,0,20
Theresa,13,0,7,0,20
Barbara,10,0,10,0,20
Ariel,12,0,8,0,20
Yael,17,0,2,1,20
Frances,13,0,7,0,20
Jesse,12,0,8,0,20
Charlotte,12,0,8,0,20
Simon,7,0,13,0,20
Omar,10,0,9,1,20
Pamela,7,0,13,0,20
Douglas,9,0,11,0,20
Olga,14,0,4,1,19
Luke,11,0,8,0,19
Joy,8,0,11,0,19
Henry,9,0,10,0,19
Leslie,9,0,10,0,19
Adrian,10,0,9,0,19
Devon,9,0,10,0,19
Qing,12,0,7,0,19
Alejandro,8,0,10,1,19
Judy,9,0,10,0,19
Mel,16,0,3,0,19
Ron,11,0,8,0,19
Ronald,8,0,9,2,19
Dadrine,0,0,19,0,19
Esther,7,0,11,1,19
Sheila,11,0,8,0,19
Travis,13,0,6,0,19
Amir,18,0,1,0,19
Ray,12,0,7,0,19
Mohammad,9,0,9,1,19
Angie,6,0,13,0,19
Jasmine,8,0,10,0,18
Yolanda,9,0,9,0,18
Francis,17,0,1,0,18
Debbie,3,0,15,0,18
Bella,8,0,10,0,18
Camila,7,0,11,0,18
Orfelina,0,0,18,0,18
Adriana,5,0,13,0,18
Drew,13,0,5,0,18
Irina,10,0,8,0,18
J,8,0,8,2,18
Juliana,8,0,10,0,18
Nadia,7,0,11,0,18
Andres,8,0,10,0,18
Marta,9,0,9,0,18
Mo,10,0,8,0,18
Pierre,13,0,5,0,18
Larry,12,0,6,0,18
Jerome,7,0,11,0,18
Alison,7,0,11,0,18
Alina,7,0,11,0,18
Sharedeasy,0,0,17,1,18
Brittany,12,0,5,0,17
Takatomo,0,0,17,0,17
Johanna,9,0,8,0,17
SoHoBlu,14,0,3,0,17
Jemar Ira,11,0,3,3,17
Lina,12,0,5,0,17
Derek,12,0,5,0,17
Valentina,6,0,9,2,17
Jenna,11,0,6,0,17
Isabelle,11,0,6,0,17
Mariana,8,0,9,0,17
Paola,7,0,10,0,17
Karina,6,0,11,0,17
Orit,4,0,2,11,17
Zach,11,0,6,0,17
Eduardo,9,0,8,0,17
An Artful Hotel,0,0,17,0,17
Francisco,13,0,4,0,17
Kristen,11,0,6,0,17
Sue,10,0,5,2,17
Jared,5,0,12,0,17
Fad,17,0,0,0,17
Jillian,13,0,3,0,16
Vivian,6,0,9,1,16
Studioplus,15,0,1,0,16
Svetlana,11,0,5,0,16
Valentin,11,0,5,0,16
Wayne,11,0,4,1,16
Angelica,8,0,8,0,16
Austin,8,0,6,2,16
Bridge,16,0,0,0,16
Zachary,10,0,6,0,16
Sol,13,0,3,0,16
Angelo,6,0,10,0,16
Nikki,7,0,8,1,16
Petya,0,0,16,0,16
Nate,7,0,9,0,16
Marlon,1,0,15,0,16
Bianca,7,1,8,0,16
Ed,15,0,1,0,16
Raanan,16,0,0,0,16
Michal,9,0,7,0,16
Lindsey,9,0,6,1,16
Heidi,8,0,8,0,16
Raquel,7,0,9,0,16
Tracey,13,0,3,0,16
Renee,12,0,3,1,16
Sonny,0,0,6,10,16
Eddie&Vlad,4,0,10,2,16
Pauline,4,0,12,0,16
Jim,13,0,3,0,16
Owen,7,0,2,7,16
Kathryn,13,0,3,0,16
Vicky,1,0,13,2,16
Whitney,12,0,4,0,16
Bugra Han,0,0,16,0,16
Lily,12,0,4,0,16
Simone,10,0,6,0,16
Rita,10,0,5,0,15
Johnny,9,0,6,0,15
Menachem,12,0,3,0,15
Ralph,14,0,1,0,15
Darina,4,0,11,0,15
Trevor,7,0,8,0,15
Beth,7,1,7,0,15
Ellen,13,0,2,0,15
Brad,8,0,7,0,15
Bobby,10,0,5,0,15
Ethan,13,0,2,0,15
Ahmed,7,0,8,0,15
Rodrigo,11,0,4,0,15
Lydia,7,0,8,0,15
Dennis,8,0,7,0,15
Carolyn,11,0,4,0,15
Joyce,7,0,7,1,15
Morgan,10,0,4,1,15
Stephanie & Idrees,6,0,9,0,15
Georgia,13,0,1,1,15
Yu,1,0,10,4,15
Alex And Nika,4,0,11,0,15
Isabel,10,0,3,2,15
Caitlin,6,0,9,0,15
Fenix,15,0,0,0,15
Jo'S Home,1,0,1,13,15
Lynn,8,0,5,2,15
Anyplace,15,0,0,0,15
Carl,11,0,4,0,15
Sandy,5,0,10,0,15
Hugo,8,0,7,0,15
Silvia,8,0,7,0,15
Josephine,5,0,10,0,15
Tania,7,0,8,0,15
Brianna,6,0,8,1,15
Elisa,5,0,10,0,15
Noomi,15,0,0,0,15
Teresa,4,0,10,1,15
Amber,6,0,9,0,15
Timothy,10,0,4,0,14
Al,5,0,9,0,14
Nora,2,0,10,2,14
Dawn,9,0,5,0,14
A,4,0,8,2,14
Jerry,11,0,3,0,14
Lou,5,0,8,1,14
Ingrid,8,0,5,1,14
Russell,10,0,4,0,14
K,3,0,10,1,14
Clara,13,0,1,0,14
Irene,10,0,4,0,14
Naomi,10,0,4,0,14
Angel,7,0,7,0,14
Elevate Properties,14,0,0,0,14
Felix,6,0,8,0,14
Felicia,10,0,4,0,14
Seth,8,0,6,0,14
Elle,10,0,4,0,14
Annette,12,0,2,0,14
Fabiola,8,0,6,0,14
Molly,11,0,3,0,14
Henry Norman,14,0,0,0,14
Rosy,1,0,13,0,14
Gordon,12,0,2,0,14
Kat,5,0,9,0,14
Cathy,13,0,1,0,14
Sofia,5,0,9,0,14
Kara,6,0,8,0,14
Daniella,12,0,2,0,14
Melanie,9,0,5,0,14
Stacey,11,0,3,0,14
Nia,8,0,6,0,14
Lena,9,0,4,1,14
Janet,9,0,5,0,14
Tamara,6,0,6,1,13
Corey,7,0,6,0,13
Kristin,12,0,1,0,13
D,11,0,2,0,13
JEMG’S Hostel,0,0,4,9,13
Carupano,8,0,5,0,13
Paradise Suites,13,0,0,0,13
J Ronald,4,0,7,2,13
Felipe,6,0,7,0,13
Brenda,7,0,6,0,13
Judith,6,0,7,0,13
Vk,1,0,12,0,13
Neil,12,0,1,0,13
Santiago,4,0,9,0,13
Carolina,6,0,7,0,13
Craig,10,0,3,0,13
Cheryl,9,0,4,0,13
Alex & Vlada,0,0,13,0,13
Sergio,6,0,7,0,13
Luciana,8,0,5,0,13
Sohotel,0,0,13,0,13
Nesva Hotel,0,7,6,0,13
Durostarz Pro,8,0,5,0,13
Shani,3,0,10,0,13
Camille,9,0,4,0,13
Tatiana,8,0,5,0,13
Eddie,8,0,5,0,13
Margarita,11,0,2,0,13
Marvin,8,0,4,1,13
Fred,5,0,8,0,13
Nelson,8,0,5,0,13
Cesar,6,0,7,0,13
Abdo,1,0,11,0,12
Ivan,5,0,7,0,12
Adrienne,9,0,3,0,12
Oliver,4,0,8,0,12
Ollie,0,0,12,0,12
Sangdon,9,0,3,0,12
Nathaniel,3,0,8,1,12
Dani,10,0,1,1,12
Valeria,8,0,4,0,12
Joey,6,0,6,0,12
Louise,7,0,4,1,12
Gabrielle,9,0,3,0,12
Jessie,5,0,7,0,12
Gabriella,10,0,2,0,12
Ann,9,0,3,0,12
Lucas,5,0,7,0,12
Sheryl,12,0,0,0,12
Eve,4,0,8,0,12
Valerie,9,0,3,0,12
Abby,9,0,3,0,12
May,5,0,7,0,12
Alyssa,10,0,2,0,12
Junior,6,0,6,0,12
Sarwara,1,0,5,6,12
Stefan,10,0,2,0,12
Lara,8,0,4,0,12
Keith,7,0,5,0,12
Incentra Village Guest House,0,11,1,0,12
Ahmet,7,0,4,1,12
Yvette,5,0,7,0,12
Alberto Fernando,12,0,0,0,12
Adeola,4,0,8,0,12
Wilson,4,0,8,0,12
Arthur,2,0,10,0,12
Eliana,5,0,7,0,12
Margaret,8,0,4,0,12
Hershey,12,0,0,0,12
María Fernanda,0,0,4,8,12
Lidia,5,0,7,0,12
Ny,12,0,0,0,12
Conor,7,0,5,0,12
Untitled,12,0,0,0,12
Henri,12,0,0,0,12
Miranda,6,0,6,0,12
Cassandra,8,0,4,0,12
Francesco,6,0,6,0,12
Debra,6,0,6,0,12
Jamal,6,0,6,0,12
Guy,8,0,3,0,11
Yoni,6,0,5,0,11
Dylan,6,3,2,0,11
Lea,6,0,5,0,11
Diane,9,0,2,0,11
Mikhail,10,0,1,0,11
Robin,6,0,5,0,11
C,5,3,3,0,11
Carly,6,0,5,0,11
Gloria,2,0,9,0,11
Amelia,5,0,5,1,11
Ari,7,0,4,0,11
Kenneth,6,0,5,0,11
Isabella,7,0,3,1,11
Pedro,6,0,5,0,11
Val,10,0,1,0,11
Ellie And Jeff,11,0,0,0,11
Lola,7,0,4,0,11
Marios,11,0,0,0,11
Hudson,2,0,9,0,11
Grant,5,0,6,0,11
Vera,6,0,5,0,11
Virginia,5,0,6,0,11
Yves,7,0,4,0,11
Catalina,5,0,5,1,11
Kylie,1,0,10,0,11
Brady,3,0,8,0,11
JEMGs Hostel,0,0,6,5,11
Shelley,6,0,5,0,11
Latisha,1,0,10,0,11
Sunny,6,0,5,0,11
Conrad,5,0,6,0,11
Hotel Belleclaire,0,0,11,0,11
Regina,5,0,5,1,11
Lorna,7,0,2,2,11
Jan,6,0,5,0,11
Leonardo,7,0,4,0,11
Pablo,4,0,6,1,11
Ayana,6,0,5,0,11
Elisabeth,4,0,5,2,11
Lin,6,0,5,0,11
Milton,7,0,4,0,11
Cristian,7,0,4,0,11
Lucky,5,0,5,1,11
Billy,7,0,4,0,11
Tayron,1,0,10,0,11
Gabriela,8,0,3,0,11
Tracy,7,0,4,0,11
Charlene,3,0,8,0,11
Ozzy,1,0,10,0,11
Aicha,1,0,10,0,11
Anita,8,0,3,0,11
Suzanne,6,0,4,0,10
Liliana,2,0,8,0,10
Ronnie,5,0,5,0,10
Paige,4,0,6,0,10
Arlo SoHo,0,10,0,0,10
Dominique,8,0,2,0,10
Chaim,10,0,0,0,10
Kathleen,6,0,4,0,10
Lionel,1,0,9,0,10
Blue Angel Hotel,0,0,10,0,10
Roman,6,0,4,0,10
Daria,7,0,3,0,10
Arlo NoMad,0,10,0,0,10
Washington Jefferson Hotel,0,0,10,0,10
Jerry & Lynn,10,0,0,0,10
Bruno,7,0,3,0,10
Tammy,9,0,1,0,10
Elise,7,0,3,0,10
Julien,7,0,2,1,10
Carrie,5,0,4,1,10
Leon,8,0,2,0,10
Brett,8,0,2,0,10
Lakisha,1,0,9,0,10
Lakshmee,0,0,7,3,10
Kris,8,0,2,0,10
Vladimir,6,0,3,1,10
Emilie,6,0,4,0,10
Sally,5,0,5,0,10
Edgar,7,0,3,0,10
Mackenzie,6,0,4,0,10
Spencer,3,0,7,0,10
Tori,4,0,6,0,10
Jess,6,0,4,0,10
Paris,3,0,7,0,10
Eduard,10,0,0,0,10
Liza,5,0,5,0,10
Sveta,9,0,1,0,10
Incentra,0,0,10,0,10
Aracelis,3,0,7,0,10
Gus,2,0,8,0,10
Antoine,5,0,5,0,10
Marcia,6,0,4,0,10
Andris,10,0,0,0,10
Meg,6,0,3,1,10
Hudson River,0,0,10,0,10
Hotel 32 32,0,0,10,0,10
Allen,4,0,6,0,10
Marlene,4,0,6,0,10
Giovanni,6,0,4,0,10
House Lynk,2,0,8,0,10
Melody,5,0,4,1,10
Monika,8,0,2,0,10
Noah,2,0,8,0,10
Hector,3,0,7,0,10
Alexa,6,0,4,0,10
Alana,7,0,3,0,10
Marissa,6,0,4,0,10
Gerardo,4,0,6,0,10
Micah,9,0,1,0,10
Nichole,2,0,8,0,10
Mauricio,6,0,4,0,10
Masud,4,0,5,1,10
Genevieve,5,0,5,0,10
Masaaki,0,0,10,0,10
Mauricio Mateo,4,0,6,0,10
Gustavo,4,0,6,0,10
Lucia,5,0,4,0,9
Fatima,5,0,3,1,9
Akiko & Cindy,0,0,8,1,9
Tj,2,0,7,0,9
Paolo,2,0,7,0,9
Kareem,8,0,1,0,9
Nat,7,0,2,0,9
Rachael,8,0,1,0,9
Ioannis,2,0,7,0,9
Sammy,5,0,4,0,9
Kerry,8,0,1,0,9
Akiko,2,0,4,3,9
Luis Enrique,0,0,9,0,9
Karim,5,0,4,0,9
Ociel,1,0,8,0,9
Nadine,7,0,2,0,9
Wanly,9,0,0,0,9
Claudio,2,0,7,0,9
Daisy,4,0,5,0,9
Marian,5,0,4,0,9
Mabel,0,0,9,0,9
Rogelia Jelyn,9,0,0,0,9
Agnes,5,0,4,0,9
Cory,6,0,3,0,9
The Wall Street Inn,0,1,8,0,9
Colleen,8,0,1,0,9
Outsite,1,0,8,0,9
Gal,6,0,3,0,9
Meredith,8,0,1,0,9
Ruben,6,0,3,0,9
Sheldon,4,0,5,0,9
Shelby,4,0,5,0,9
Pat,7,0,2,0,9
Aminul,0,0,9,0,9
Maura,4,0,5,0,9
Blanca,8,0,1,0,9
Ross,4,0,5,0,9
Rumena,4,0,5,0,9
Herman,3,0,6,0,9
Carlene,3,0,6,0,9
Rosario,7,0,2,0,9
Ty,2,0,7,0,9
Liqin,0,0,9,0,9
Phil,4,0,5,0,9
Troy,3,0,6,0,9
Rony,6,0,3,0,9
Celine,6,0,3,0,9
Howard,6,0,3,0,9
Lolita,0,0,9,0,9
Fabio,2,2,5,0,9
Chad,5,0,4,0,9
Alfredo,7,0,2,0,9
Sergi,0,0,6,3,9
Alexandre,7,0,2,0,9
Mercedes,4,0,5,0,9
Izi,9,0,0,0,9
Stacy,4,0,5,0,9
Nice Stay NYC,9,0,0,0,9
Jonatah,0,0,9,0,9
Abigail,4,0,5,0,9
Aron,9,0,0,0,9
Moshe,4,0,5,0,9
Arian,4,0,5,0,9
Renata,8,0,1,0,9
Desmond,2,0,7,0,9
Tal,6,0,3,0,9
Zuleyka,4,0,5,0,9
Deena,5,0,4,0,9
NoMo SoHo,0,0,9,0,9
Rina,8,0,1,0,9
T,4,0,5,0,9
Dean,7,0,2,0,9
Dena,8,0,1,0,9
Monique,7,0,2,0,9
Freddy,5,0,4,0,9
Donald,2,0,6,0,8
Gaby,7,0,1,0,8
Yuan,2,0,5,1,8
Medelene,2,0,6,0,8
Zain,7,0,1,0,8
Luz,2,0,6,0,8
Eden,4,0,4,0,8
Gerard,2,0,6,0,8
Ricky,3,0,5,0,8
Nissim,8,0,0,0,8
Lyn,0,0,8,0,8
Wei,4,0,4,0,8
Alvaro,4,0,4,0,8
Ahnaf,2,0,6,0,8
Laurence,4,0,4,0,8
Ava,7,0,1,0,8
Vic,1,0,7,0,8
Latoya,3,0,5,0,8
Nathalie,5,0,3,0,8
Kai,6,0,2,0,8
Glenn,7,0,1,0,8
Ming,3,0,5,0,8
Fei,8,0,0,0,8
Vickie,2,0,6,0,8
Sidney,5,0,3,0,8
Curtis,7,0,1,0,8
Rodney,6,0,2,0,8
Celina,3,0,3,2,8
Abraham,8,0,0,0,8
Churchill,8,0,0,0,8
Harry,4,0,4,0,8
Niki,3,0,3,2,8
Petra,3,0,5,0,8
Ruth And Fran,0,0,8,0,8
Elaine,7,0,1,0,8
John J.,0,0,0,8,8
JG Sohotel,0,0,8,0,8
Wanda,3,0,5,0,8
Guseyn,0,0,8,0,8
SharedEasy Coliving,0,0,4,4,8
Gillian,3,0,5,0,8
Ilya,5,0,3,0,8
Alisha,6,0,2,0,8
Piero,2,0,6,0,8
Pete,6,0,2,0,8
Don,5,0,3,0,8
JooltLuxe,8,0,0,0,8
Krzysztof,7,0,1,0,8
Millennium Broadway,0,0,8,0,8
Jasmin,7,0,1,0,8
G,4,0,4,0,8
Dimitri,5,0,3,0,8
Lu,4,0,4,0,8
Shay,3,0,5,0,8
Helena,3,0,5,0,8
Meghan,6,0,2,0,8
Kelsey,6,0,2,0,8
Olu,4,0,4,0,8
Marcos,3,1,4,0,8
Roland,1,0,7,0,8
Harold,6,0,2,0,8
Dina,6,0,2,0,8
Kieu,2,0,6,0,8
Marcus,4,0,4,0,8
Bing,1,0,7,0,8
Alessandro,1,0,7,0,8
Boris,3,0,5,0,8
Magda,3,0,5,0,8
Brendan,6,0,2,0,8
Krista,3,0,5,0,8
Joanne,7,0,1,0,8
Fiona,2,0,6,0,8
Xavier,1,0,5,2,8
Dane,4,0,4,0,8
Briana,6,0,2,0,8
Viviana,2,0,6,0,8
Zoe,3,0,5,0,8
Kalia,5,0,3,0,8
Reservations,8,0,0,0,8
Madison,6,0,2,0,8
Rebekah,4,0,4,0,8
Franklin,5,0,3,0,8
Gene,4,0,4,0,8
Ash,6,0,2,0,8
Telmo,8,0,0,0,8
Jocelyn,4,0,3,1,8
Ivy,3,0,5,0,8
Hamza,7,0,1,0,8
Dariia & Jacob,0,0,8,0,8
Noelle,5,0,3,0,8
Dario,1,0,6,1,8
Ruby,6,0,2,0,8
Antoinette,4,0,4,0,8
Priscilla,5,0,3,0,8
Brad And Sarah,8,0,0,0,8
Ted,7,0,1,0,8
Priscila,3,0,4,1,8
Hila,8,0,0,0,8
Lenny,7,0,1,0,8
Roy,5,0,3,0,8
April,2,0,6,0,8
Lilian,4,0,4,0,8
Janice,5,0,3,0,8
Adrien,4,0,4,0,8
Mac,2,0,6,0,8
Haffro,0,0,8,0,8
Katia,3,0,5,0,8
Xin,1,0,7,0,8
Kristina & Vlada,0,0,8,0,8
Alejandra,5,0,3,0,8
Amalia,6,0,2,0,8
The Frederick Hotel,0,0,8,0,8
Marisa,6,0,2,0,8
Ori,7,0,1,0,8
Kristy,2,0,6,0,8
Kaitlyn,7,0,1,0,8
Marjorie,4,0,4,0,8
Erik,5,0,3,0,8
Roberta,6,0,2,0,8
Alfred,7,0,1,0,8
Duane,7,0,1,0,8
Amiee,0,0,8,0,8
Jenn,5,0,3,0,8
Doris,5,0,3,0,8
Roberto,5,0,3,0,8
George Steven,8,0,0,0,8
Becky,4,0,4,0,8
Yuval,3,0,4,0,7
Dionne,2,0,5,0,7
Alexes,0,0,7,0,7
Placemakr Wall Street,7,0,0,0,7
Monzur,7,0,0,0,7
Lizeth,4,0,3,0,7
Markus,2,0,5,0,7
Frederick,3,0,4,0,7
Meraj,7,0,0,0,7
Shai,7,0,0,0,7
J.,5,0,2,0,7
Lloyd,2,0,4,1,7
Margot,4,0,3,0,7
Giana,0,0,7,0,7
Arielle,4,0,3,0,7
Dionisio & JC,7,0,0,0,7
Kristine,4,0,2,1,7
Elliot,4,0,3,0,7
Mónica,2,0,5,0,7
Alisa,5,0,2,0,7
Alissa,3,0,4,0,7
Juan Carlos,3,0,4,0,7
Maurice,7,0,0,0,7
Historic Blue Moon,7,0,0,0,7
Nicolas,5,0,2,0,7
Vadim,4,0,3,0,7
Erick,4,0,3,0,7
Eugenia,2,0,5,0,7
Brooke,5,0,2,0,7
Jovon,0,0,7,0,7
Patrice,2,0,5,0,7
Bridget,6,0,1,0,7
Marcell,1,0,6,0,7
Ervis,1,0,6,0,7
Liam,3,0,4,0,7
Lia,5,0,2,0,7
Brent,4,0,3,0,7
Park Central,0,0,7,0,7
Rhonda,4,0,3,0,7
Marcel,3,0,4,0,7
Esteban,2,0,5,0,7
Masha,6,0,1,0,7
Igor,6,0,1,0,7
James And Laureta,7,0,0,0,7
Uni-Inn Properties,3,0,4,0,7
Umme Salma,0,0,7,0,7
Amal,7,0,0,0,7
Tyrone,6,0,1,0,7
Tristan,5,0,1,1,7
Guillaume,2,0,5,0,7
Bernadette,4,0,3,0,7
Ilene And Paul,7,0,0,0,7
Berni,0,0,7,0,7
Allie,5,0,2,0,7
Oyo,0,0,7,0,7
Jaclyn,3,0,4,0,7
Carlton,1,0,6,0,7
Yulia,5,0,2,0,7
Vie,6,0,1,0,7
Veronika,5,0,2,0,7
Candice,2,0,5,0,7
Candace,3,0,4,0,7
Savannah,4,0,3,0,7
Bill,3,0,3,1,7
Maxine,3,0,4,0,7
Laurent,5,0,2,0,7
Cameron,2,0,5,0,7
Martina,5,0,2,0,7
Rosemarie,1,0,6,0,7
Caleb,3,0,4,0,7
Andrey,1,0,6,0,7
Gs Vacay Spots,1,0,6,0,7
Tonisha,0,0,7,0,7
Fatou,1,0,6,0,7
Sida,5,0,2,0,7
Audrey,5,0,2,0,7
Mira,6,0,1,0,7
Mir,0,0,0,7,7
Yan,3,0,4,0,7
The Manhattan Club,0,0,7,0,7
Jill,6,0,1,0,7
Yanelly,2,0,5,0,7
Agus,0,0,7,0,7
Rod,3,0,4,0,7
Jhoe,2,0,5,0,7
Shannon,4,0,3,0,7
Coco,6,0,1,0,7
Rahul,1,0,6,0,7
Edna,1,0,6,0,7
Kenny,4,0,3,0,7
Faye,4,0,3,0,7
Aj,4,0,3,0,7
Sacred Space Style,7,0,0,0,7
Harvin,7,0,0,0,7
Ismael,4,0,3,0,7
Fernanda,5,0,2,0,7
Dustin,3,0,4,0,7
Mona,6,0,1,0,7
Joann,5,0,2,0,7
TeamOneBaz,0,0,7,0,7
Doron,7,0,0,0,7
Darnell,3,0,3,1,7
Sergey,6,0,1,0,7
Ade,2,0,5,0,7
Said,0,0,7,0,7
Graham,4,0,3,0,7
Moe,6,0,1,0,7
Karin,4,0,3,0,7
Filiz,0,0,7,0,7
Wesley,2,0,5,0,7
Asia,3,0,3,1,7
Madeline,5,0,1,1,7
Siarhei & Kris,0,0,7,0,7
Shane,5,0,1,1,7
Iris,1,0,6,0,7
Suliman,0,0,7,0,7
Samir,4,0,2,1,7
Athena,4,0,3,0,7
Ofer,7,0,0,0,7
Justine,5,0,2,0,7
Mina,6,0,1,0,7
Chida,0,0,7,0,7
Gaia&Pietro,7,0,0,0,7
Elana,6,0,1,0,7
Sabina,5,0,2,0,7
Eleanor,5,0,2,0,7
Farah,4,0,3,0,7
Hugh,6,0,1,0,7
Louann,0,0,7,0,7
Simona,4,0,3,0,7
Dmitriy,6,0,1,0,7
Aleksandra,4,0,3,0,7
Lorraine,3,0,4,0,7
Sinan,3,0,4,0,7
Lori,5,0,2,0,7
Lorenzo,2,0,5,0,7
Prince,2,0,5,0,7
Ekta,0,0,7,0,7
Jermaine,4,0,3,0,7
Carol Gloria,0,0,6,0,6
Shana,5,0,1,0,6
Mathew,3,0,3,0,6
Danica,1,0,5,0,6
Geoffrey,3,0,3,0,6
Kasa,1,0,5,0,6
Raul,5,0,1,0,6
Emanuele,2,0,4,0,6
Tessa,2,0,4,0,6
Brooklyn,6,0,0,0,6
Damien,3,0,3,0,6
Cherry-Ann,0,0,6,0,6
Yotel New York,0,0,6,0,6
Johan,3,0,3,0,6
Jing,5,0,0,1,6
Katharine,2,0,4,0,6
Christie,3,0,3,0,6
V,5,0,1,0,6
Mighty Tree Properties,6,0,0,0,6
Jp,1,0,5,0,6
Deirdre,4,0,2,0,6
Allan,5,0,1,0,6
Roxanne,5,0,1,0,6
Usquire,4,0,2,0,6
Chi,2,0,3,1,6
Julianna,3,0,3,0,6
Stavros,6,0,0,0,6
Cherie,5,0,1,0,6
Jotham,2,0,4,0,6
Kathy,3,0,3,0,6
Kiara,2,0,4,0,6
Susanna,6,0,0,0,6
James&Laureta,6,0,0,0,6
Steph,3,0,3,0,6
Stefany,1,0,5,0,6
Zsofia,0,0,6,0,6
Tee,2,0,4,0,6
Sharon Nancy Chano,0,0,6,0,6
Jodi,3,0,3,0,6
Chaya,4,0,2,0,6
Abeer,3,0,3,0,6
Zoraida,5,0,1,0,6
Rory,3,0,3,0,6
Tommy,6,0,0,0,6
Alessandra,5,0,1,0,6
Jampa,6,0,0,0,6
Tatyana,2,0,4,0,6
Daphne,3,0,3,0,6
Zack,2,0,4,0,6
Chelsea Inn Hotel,2,0,4,0,6
Vangelis,5,0,1,0,6
Karla,3,0,3,0,6
Danilo,6,0,0,0,6
Adeyemi,0,0,6,0,6
Dream,5,0,1,0,6
Bridgette,5,0,1,0,6
Pavel,4,0,2,0,6
Sylvia,4,0,2,0,6
Haley,5,0,1,0,6
Emmie,1,0,5,0,6
Larissa,3,0,3,0,6
Deniz,0,0,5,1,6
Toni,2,0,4,0,6
Aidan,2,0,4,0,6
Quentin,2,0,4,0,6
Keisha,5,0,1,0,6
Millennium Premier,0,0,6,0,6
Millennium Downtown,0,0,6,0,6
Edith,4,0,2,0,6
Lane,3,0,3,0,6
Carlo,4,0,2,0,6
Cecilia,4,0,2,0,6
Dmitri,3,0,3,0,6
Meela,0,0,6,0,6
Rohan,4,0,2,0,6
Kells,1,0,5,0,6
Desiree,3,0,3,0,6
Rohit,5,0,1,0,6
Aimee,6,0,0,0,6
Kurt,4,0,2,0,6
Kaela,2,0,4,0,6
Meir,6,0,0,0,6
Jazmin,5,0,1,0,6
Tricia,5,0,1,0,6
Elvira,3,0,3,0,6
Penny,3,0,3,0,6
Ramiro,5,0,1,0,6
Uri,6,0,0,0,6
Elan,5,0,1,0,6
Chiara,5,0,1,0,6
Enrique,1,0,5,0,6
Kyla,1,0,5,0,6
The Blakely,0,0,6,0,6
The Collective Paper Factory Hotel,0,0,6,0,6
The Condor Hotel,0,1,5,0,6
Allan C.,0,0,6,0,6
Kyra,2,0,4,0,6
Katrina,6,0,0,0,6
Shanie,6,0,0,0,6
Alec,4,0,2,0,6
Guillermo,4,0,2,0,6
Jules,0,0,6,0,6
Suzan,0,0,6,0,6
Jc,1,0,5,0,6
Hayley,3,0,3,0,6
Robyn,5,0,1,0,6
Jie,2,0,3,1,6
Jian Yan,0,0,6,0,6
Kimberley,6,0,0,0,6
Maxwell,1,0,5,0,6
Cj,3,0,3,0,6
The Williamsburg Apartment,0,0,6,0,6
Tash,1,0,5,0,6
Sonya,2,0,4,0,6
Eileen,3,0,3,0,6
Mei,3,0,3,0,6
Yang,1,0,4,1,6
Andrzej,3,0,3,0,6
Israel,4,0,1,1,6
Nicky,3,0,3,0,6
Asad,1,0,5,0,6
Ivana,5,0,0,1,6
Lourdes,5,0,1,0,6
Shera,0,0,6,0,6
Ines,4,0,2,0,6
Sal,5,0,1,0,6
Nyota,6,0,0,0,6
Marisol,1,0,5,0,6
Imani,2,0,4,0,6
Winston,5,0,1,0,6
Anton,2,0,4,0,6
Gail,6,0,0,0,6
Bobbi,1,0,5,0,6
Faith,4,0,2,0,6
Yahaira,4,0,2,0,6
Lorena,2,0,4,0,6
Imrul,5,0,1,0,6
Gen,0,0,6,0,6
Jada,2,0,4,0,6
Nico,1,0,5,0,6
Beverly,5,0,1,0,6
Jade,6,0,0,0,6
Jae,6,0,0,0,6
Federico,3,0,3,0,6
Weifeng(Daniel),6,0,0,0,6
Fay,1,0,5,0,6
Walter,4,0,2,0,6
Luisa,2,0,4,0,6
Lillian,2,0,3,1,6
Ola,3,0,3,0,6
B,6,0,0,0,6
Gabi,5,0,1,0,6
WestHouse,0,0,6,0,6
Yao & Rain,1,0,5,0,6
Mariam,2,0,3,1,6
Gee,3,0,3,0,6
Siarhei & Kristina,0,0,6,0,6
Blair,3,0,3,0,6
Madeleine,4,0,2,0,6
Mariela,3,0,3,0,6
Bi,0,0,6,0,6
Loren,2,0,4,0,6
Yi,2,0,4,0,6
Angelina,4,0,2,0,6
Nomam,1,0,5,0,6
Pankaj,0,0,6,0,6
Francesca,6,0,0,0,6
Arlene,2,0,4,0,6
Sirikarn,0,0,6,0,6
Vincenzo,0,0,6,0,6
Arlo,0,0,6,0,6
Ikkyukim,0,0,6,0,6
Orlando,2,0,4,0,6
Ike,6,0,0,0,6
Gamze,0,0,6,0,6
Belisa,0,0,6,0,6
Marek,4,0,2,0,6
Armande,2,0,4,0,6
María,2,0,4,0,6
Fabian,2,0,4,0,6
Armando,2,0,4,0,6
Smyth Tribeca,0,0,6,0,6
Apollo,0,0,6,0,6
Sheri,4,0,1,0,5
Christophe,3,0,2,0,5
Marko,4,0,1,0,5
Genesis,5,0,0,0,5
Nassy,5,0,0,0,5
Sharif,2,0,3,0,5
Oscar & Rossanna,5,0,0,0,5
R.J,5,0,0,0,5
Elsie,4,0,1,0,5
Chuck,2,0,3,0,5
Jeannie,2,0,3,0,5
Aline,1,0,4,0,5
R,4,0,1,0,5
Ezra,2,0,3,0,5
Beatrice,5,0,0,0,5
Migdalia,3,0,2,0,5
Radhames,5,0,0,0,5
Benny,4,0,1,0,5
Gladwyn,1,0,4,0,5
Jfk,0,0,5,0,5
Connie,3,0,2,0,5
Tiana,1,0,4,0,5
Jewel,1,0,4,0,5
Livia,4,0,1,0,5
Fazia,1,0,4,0,5
Milena,3,0,2,0,5
Milan,4,0,1,0,5
Benjasmin,5,0,0,0,5
Kennedy,3,0,2,0,5
Nir,5,0,0,0,5
Giselle,1,0,4,0,5
Stephon,1,0,4,0,5
Ajmol,0,0,4,1,5
Haruhisa,0,0,5,0,5
Shauna,2,0,3,0,5
Trey,3,0,2,0,5
Ismail,2,0,3,0,5
Hayden,1,0,4,0,5
Stefano,5,0,0,0,5
Chantal,2,0,3,0,5
Lotay,5,0,0,0,5
Shaun,4,0,0,1,5
Neal,2,0,3,0,5
Pod,5,0,0,0,5
Elias,2,0,3,0,5
KnightTime,2,0,2,1,5
Jenifer,2,0,3,0,5
Navid,0,0,5,0,5
Niko,3,0,2,0,5
Funda,1,0,4,0,5
Gil,4,0,1,0,5
Alexandria,0,0,5,0,5
Prime,5,0,0,0,5
Lord Daniel,1,0,4,0,5
Beatriz,3,0,2,0,5
Sebastien,4,0,1,0,5
Alex And Vlada,0,0,5,0,5
Ani,2,0,3,0,5
Gilbert,1,0,4,0,5
Fanny,4,0,1,0,5
Kumar,3,0,2,0,5
Steed,2,0,3,0,5
Trevis,0,0,3,2,5
Lucie,3,0,2,0,5
Ekaterina,3,0,2,0,5
Giani,0,0,5,0,5
Michaela,3,0,2,0,5
Alba,5,0,0,0,5
Quality,5,0,0,0,5
Qiulan,0,0,5,0,5
Qingming,0,0,5,0,5
Yasmin,4,0,1,0,5
Kin,0,0,5,0,5
Nathalia,4,0,1,0,5
Krystle,5,0,0,0,5
J-,1,0,4,0,5
Ellis,4,0,1,0,5
King,0,0,5,0,5
Hazel,1,0,4,0,5
Ivanna,5,0,0,0,5
Vlad,4,0,1,0,5
Estefania,2,0,3,0,5
Gladys,3,0,2,0,5
Majar,0,0,5,0,5
Abdul,3,0,2,0,5
Riena Joy,0,0,5,0,5
Abe,3,0,2,0,5
Johny,5,0,0,0,5
Deb,4,0,1,0,5
Reginald,4,0,1,0,5
Myles,5,0,0,0,5
Abigael,5,0,0,0,5
Nova & Marianne,0,0,5,0,5
Dominic,1,0,4,0,5
Sergii And Vlada,0,0,4,1,5
Art,2,0,3,0,5
Jun,1,0,4,0,5
Maia,3,0,2,0,5
Gretchen,3,0,2,0,5
Donovan,3,0,2,0,5
Maria Fernanda,4,0,1,0,5
Arthouse Hotel,0,5,0,0,5
Dora,4,0,1,0,5
Zuleide,0,0,5,0,5
Ada,1,0,4,0,5
Sergii,2,0,3,0,5
Taz,0,0,5,0,5
Moises,2,0,3,0,5
Monty,5,0,0,0,5
NoVu,5,0,0,0,5
Constantin,5,0,0,0,5
Manuela,2,0,3,0,5
Josie,3,0,2,0,5
Mova,5,0,0,0,5
475,0,0,5,0,5
Diamond,4,0,1,0,5
José,3,0,2,0,5
Di,2,0,3,0,5
Reubena,2,0,3,0,5
Rian,2,0,3,0,5
Reservation Desk,0,0,5,0,5
Morshed,0,0,5,0,5
Dillon,2,0,3,0,5
Xie,0,0,5,0,5
Ridgewood,0,0,5,0,5
Murat,1,0,4,0,5
Ariana,4,0,1,0,5
Rene,3,0,2,0,5
Dinara,3,0,2,0,5
Manny,3,0,2,0,5
Denis,3,0,2,0,5
Talia,5,0,0,0,5
Mani,2,0,3,0,5
Norbert,1,0,4,0,5
Haijiao,0,0,5,0,5
Mari,3,0,2,0,5
Kamil,2,0,3,0,5
Dorit,4,0,1,0,5
Darren,2,0,3,0,5
Minee,0,0,5,0,5
Dahiana,4,0,1,0,5
The Evelyn Hotel,0,0,5,0,5
Randy,4,0,1,0,5
Oleg,3,1,1,0,5
The Michelangelo,0,5,0,0,5
Iain,2,0,2,1,5
Annmarie,5,0,0,0,5
Cristy,2,0,3,0,5
Kayla,2,0,3,0,5
Auset,1,0,4,0,5
Ghazal,3,0,2,0,5
Maribel,3,0,2,0,5
Shully'S,5,0,0,0,5
Autumn,2,0,3,0,5
Cornelius,0,0,4,1,5
Ramona,3,0,2,0,5
Ahmad,3,0,2,0,5
Ramon,2,0,3,0,5
Ramneet,0,0,5,0,5
Safain,5,0,0,0,5
Jhon,0,0,5,0,5
Min,1,0,3,1,5
Shanna,3,0,2,0,5
Mimi,4,0,1,0,5
Sagee,3,0,2,0,5
Dali,1,0,4,0,5
Katelyn,5,0,0,0,5
Katarina,3,0,2,0,5
Shuly,0,0,5,0,5
Win,1,0,4,0,5
Darius,4,0,1,0,5
Yahira,5,0,0,0,5
Asaf,4,0,1,0,5
Karan,0,0,5,0,5
Magdalena,3,0,2,0,5
Joaquin,1,0,4,0,5
Freehand,0,3,2,0,5
Serena,2,0,3,0,5
Ira,4,0,1,0,5
Magali,5,0,0,0,5
Ant,4,0,1,0,5
Zoey,1,0,4,0,5
Tenzin,1,0,4,0,5
Adi,4,0,1,0,5
Mizue,1,0,0,4,5
Shira,3,0,2,0,5
Gonzalo,2,0,3,0,5
Jj,4,0,1,0,5
Summer,1,0,4,0,5
Gona,1,0,4,0,5
Shandor,5,0,0,0,5
Melinda,1,0,4,0,5
Luis & Ana,5,0,0,0,5
Britton,3,0,2,0,5
Pao,4,0,1,0,5
Jacques,0,0,5,0,5
Emilio,1,0,4,0,5
Son-Ya,0,0,5,0,5
Ephraim,5,0,0,0,5
Venelina,5,0,0,0,5
Lamar,5,0,0,0,5
Georgina,1,0,4,0,5
Maureen,3,0,1,1,5
Byron,1,0,4,0,5
Bushra,5,0,0,0,5
Jacqui,2,0,3,0,5
Lee And Lu,0,0,1,4,5
Bravo,0,0,0,5,5
Janelle,4,0,1,0,5
Lee And Teri,4,0,1,0,5
Anders,2,0,3,0,5
Carole,2,0,3,0,5
Emi,0,0,5,0,5
Bertie,2,0,3,0,5
Jakob,0,0,5,0,5
Yesica,1,0,4,0,5
Betty,1,0,4,0,5
Lei,1,0,4,0,5
Mayra,2,0,3,0,5
Pascal,5,0,0,0,5
Rudy,5,0,0,0,5
Match,0,0,5,0,5
Gerald,4,0,1,0,5
Martial Loft,0,0,5,0,5
Mateo,2,0,3,0,5
Bibi,4,0,1,0,5
Vicente,2,0,3,0,5
Runa & Tusher,5,0,0,0,5
Laurie,3,0,2,0,5
Youssef,2,0,3,0,5
Lina Jie,2,0,3,0,5
Emmory,0,0,5,0,5
Uchenna,1,0,4,0,5
Martine,4,0,1,0,5
Sky,3,0,2,0,5
Alvin,5,0,0,0,5
Unknown,2,0,3,0,5
Saul,5,0,0,0,5
Hernan,2,0,3,0,5
Bryant,2,0,3,0,5
Bodrul,0,0,5,0,5
Yemi,1,0,4,0,5
Maryam,1,0,4,0,5
Neha,1,0,4,0,5
Bernard,1,0,4,0,5
Blue House,0,0,5,0,5
Brad & Rachel,2,0,3,0,5
Yinka,1,0,3,1,5
Aliza,3,0,2,0,5
Valentine,1,0,4,0,5
Brittney,4,0,1,0,5
Massiel,0,0,5,0,5
Marlyn,2,0,3,0,5
Boyer Partners,5,0,0,0,5
Emanuel,3,0,2,0,5
Crispy,1,0,3,0,4
Cris,3,0,1,0,4
Annika,2,0,2,0,4
Jian,1,0,3,0,4
Lilly,2,0,2,0,4
Felisha,1,0,3,0,4
Magdiel,0,0,4,0,4
The Working Rich,1,0,3,0,4
Jana,4,0,0,0,4
Neusa,0,0,4,0,4
Theodore,3,0,1,0,4
Gayle,2,0,0,2,4
Rosie,1,0,3,0,4
Reid,3,0,1,0,4
Ilona,3,0,1,0,4
Winnie & Andy,0,0,4,0,4
Hansem Stay,4,0,0,0,4
Earl,4,0,0,0,4
Andrada,0,0,4,0,4
Cyn,1,0,3,0,4
The Knickerbocker,0,4,0,0,4
M Mainul,0,0,4,0,4
Lyuda,1,0,3,0,4
Anny And Cesar,0,0,4,0,4
Leana,0,0,4,0,4
Bisnelly,0,0,4,0,4
Kamilla,4,0,0,0,4
Marianne,0,0,4,0,4
Hans,2,0,2,0,4
Malik,3,0,1,0,4
Holly,2,0,2,0,4
Bright,3,0,0,1,4
Mineva,1,0,3,0,4
The Ridge,0,0,4,0,4
Rochelle,3,0,1,0,4
Kaye,1,0,3,0,4
Pau,0,0,4,0,4
Genae,0,0,4,0,4
Brooklyn P,0,0,4,0,4
Ampere,0,0,4,0,4
Justa,3,0,1,0,4
Layla,3,0,1,0,4
Andreas,3,0,1,0,4
Sheena,2,0,2,0,4
Haim Shlomo,3,0,1,0,4
Collin,3,0,1,0,4
Avraham,4,0,0,0,4
Raisa,3,0,1,0,4
Gizelle,0,0,4,0,4
Hyacinth,1,0,3,0,4
Luux,4,0,0,0,4
Olivier,4,0,0,0,4
Cody,2,0,2,0,4
Lupi,0,0,4,0,4
Sonia And Nadine,0,0,4,0,4
Dasha,2,0,2,0,4
Dorian,0,0,4,0,4
Kam,4,0,0,0,4
Pascale,3,0,1,0,4
Aya,3,0,1,0,4
Luna,1,0,3,0,4
Jesus,1,0,3,0,4
Clint,4,0,0,0,4
Julissa,3,0,1,0,4
Gabe,1,0,3,0,4
Marzena,4,0,0,0,4
Velma,4,0,0,0,4
Norman,2,0,1,1,4
Lincie,0,0,4,0,4
Maxime,2,0,2,0,4
Rodolfo,2,0,2,0,4
"Isaac, Linda & Noelia",0,0,4,0,4
Rejvi,4,0,0,0,4
Kdn,0,0,4,0,4
Davica,0,0,4,0,4
Annick,2,0,2,0,4
Sigfus,1,0,3,0,4
Nesty Slumbers,4,0,0,0,4
Lihi,4,0,0,0,4
Zubia,4,0,0,0,4
Amine,4,0,0,0,4
Yhc,4,0,0,0,4
Eddy,2,0,2,0,4
Maximo,1,0,3,0,4
Nalani,2,0,2,0,4
Susana,1,0,3,0,4
Connor,3,0,1,0,4
Dlb,0,0,4,0,4
Edelmira,1,0,3,0,4
Augustine,1,0,3,0,4
Shanice,1,0,3,0,4
Marylyn Palmer,2,0,2,0,4
Daniele,1,0,3,0,4
Mj,1,0,3,0,4
Nabil,4,0,0,0,4
Teri,1,0,3,0,4
Nickie,1,0,3,0,4
Oceanhill,1,0,3,0,4
Young,2,0,2,0,4
Yair,3,0,1,0,4
Aditya,1,0,3,0,4
Gelen,0,0,4,0,4
Terrance,1,0,3,0,4
Hana,2,0,2,0,4
Ina,2,0,2,0,4
Arnulfo,1,0,3,0,4
Asif,2,0,2,0,4
Asaad,0,0,4,0,4
Leila,2,0,2,0,4
Miss. G.,0,0,4,0,4
Filip,1,0,3,0,4
Leidy,2,0,2,0,4
Rio And Tavion,0,0,4,0,4
Fifty Hotel & Suites,0,4,0,0,4
Gordon M,0,0,4,0,4
Maegan,1,0,3,0,4
Aspen,4,0,0,0,4
Irena,2,0,2,0,4
Samita,1,0,3,0,4
Dara,3,0,1,0,4
Willie,2,0,2,0,4
Amit,4,0,0,0,4
Grencies Fe,0,0,4,0,4
Asher,1,0,3,0,4
Davis,2,0,2,0,4
Bryce,3,0,1,0,4
Modupe,0,0,4,0,4
Ro,3,0,1,0,4
Sergii & Nika,0,0,4,0,4
Karl,4,0,0,0,4
Artem,4,0,0,0,4
Smith,2,0,2,0,4
Anthony And Elle,4,0,0,0,4
Myriam,3,0,1,0,4
Karlene,1,0,3,0,4
Buddy,2,0,2,0,4
Nickesha,0,0,4,0,4
Tenzing,4,0,0,0,4
Yotlaire,3,0,1,0,4
Kaptan,0,0,4,0,4
Rashida,4,0,0,0,4
Johnson,2,0,2,0,4
Florence,4,0,0,0,4
Paloma,2,0,2,0,4
Fernando Alberto,4,0,0,0,4
Haniel,1,0,3,0,4
Myla,1,0,3,0,4
Hakim,2,0,2,0,4
Abena,2,0,2,0,4
Ibrahim,1,0,3,0,4
Maleeha,4,0,0,0,4
Dean&Paula,0,0,4,0,4
Inez,2,0,2,0,4
Fern,0,0,4,0,4
Fredrick,0,0,4,0,4
Aeysha B And Blas-Off,0,0,4,0,4
Dwayne,1,0,3,0,4
Gloria Lopez,0,0,4,0,4
Teddy,2,0,2,0,4
Darryl,4,0,0,0,4
Oksana,2,0,2,0,4
Skylar,3,0,1,0,4
Brigid,3,0,1,0,4
Willy,3,0,1,0,4
Royalton Park Avenue,0,4,0,0,4
Salome,3,0,1,0,4
Erfan,4,0,0,0,4
Shola,3,0,1,0,4
Shelly,3,0,1,0,4
Damian,3,0,1,0,4
Rashid,1,0,0,3,4
Wil,2,0,2,0,4
Dominick,1,0,3,0,4
Van,3,0,1,0,4
Misha,2,0,2,0,4
Rivka,2,0,2,0,4
Idan,3,0,1,0,4
Jinjie,0,0,4,0,4
Regalia,4,0,0,0,4
Maddie,1,0,3,0,4
Matteo,2,0,2,0,4
Dalia,4,0,0,0,4
Darlene,1,0,3,0,4
Dale,4,0,0,0,4
Adrianna,4,0,0,0,4
Soledad,0,0,3,1,4
Amaya,0,0,4,0,4
Realty Group,4,0,0,0,4
Nadya,1,0,3,0,4
Sway And Tash,0,0,3,1,4
Noel,2,0,2,0,4
Nana,4,0,0,0,4
Elijah,2,0,2,0,4
Koffi,2,0,2,0,4
Samanta,4,0,0,0,4
Nikolai,4,0,0,0,4
Basia,1,0,3,0,4
Li,2,0,2,0,4
Ivo,3,0,1,0,4
Manuel Ricardo,4,0,0,0,4
Sincere,0,0,4,0,4
Santina,2,0,2,0,4
Bayard Robert,4,0,0,0,4
René,0,1,3,0,4
Jazz,4,0,0,0,4
Charmine,4,0,0,0,4
Elite Services By G&G,4,0,0,0,4
Gulcin,1,0,3,0,4
Emil,4,0,0,0,4
Sinem,2,0,2,0,4
Mukaram,4,0,0,0,4
Mara,2,0,2,0,4
Kourosh,3,0,1,0,4
Bear,0,0,4,0,4
Marcela,1,0,3,0,4
Alli,4,0,0,0,4
Chemaly,0,0,4,0,4
Priya,3,0,1,0,4
Sj,4,0,0,0,4
Meryl,3,0,1,0,4
Marilyn,1,0,3,0,4
Jayson,1,0,3,0,4
S,3,0,1,0,4
Garth,3,0,1,0,4
Aaliyah,2,0,2,0,4
Jude,3,0,1,0,4
Jammie,1,0,2,1,4
Juber,0,0,4,0,4
Garrett,3,0,1,0,4
Vlada And Alex,0,0,4,0,4
Derrick,4,0,0,0,4
Mich,1,0,3,0,4
Tomas,1,0,3,0,4
Aleks,3,0,1,0,4
Leigh,2,0,2,0,4
Aleksandr,2,0,2,0,4
Emiliano,3,0,1,0,4
German A,0,0,4,0,4
Parmenides/Carlo,4,0,0,0,4
Eskander,4,0,0,0,4
Dimitry,3,0,1,0,4
Alen,0,0,4,0,4
Ally,2,0,2,0,4
Rich,3,0,1,0,4
Tulio,0,0,4,0,4
Muhammad,2,0,2,0,4
Fabrizio,0,0,4,0,4
Belkis,0,0,4,0,4
JT And Tiziana,0,0,4,0,4
Belle,0,0,4,0,4
Jamila,2,0,2,0,4
Celestine,0,0,4,0,4
Celeste,0,0,4,0,4
Ghenadie,2,0,2,0,4
Yusuf,3,0,1,0,4
Casimar,0,0,4,0,4
Philippe,3,0,1,0,4
Phillip,1,0,3,0,4
Cecile,2,0,2,0,4
Hillary,2,0,2,0,4
Alinca,1,0,3,0,4
L,2,0,2,0,4
Yoav,3,0,1,0,4
Lexia,4,0,0,0,4
Cat,3,0,1,0,4
Bradley,4,0,0,0,4
Aquila,0,0,4,0,4
Yelle,1,0,3,0,4
Roosi,3,0,1,0,4
Jeanette,0,0,4,0,4
Cem,2,0,2,0,4
Pharo,0,0,4,0,4
Central,1,0,3,0,4
Chana,4,0,0,0,4
Emerson & Thelma,4,0,0,0,4
Virginie,4,0,0,0,4
SoCo Property,4,0,0,0,4
Kristin Page,1,0,3,0,4
A & Faye Bed Anfd Breakfast Inc,0,0,4,0,4
Yvens,0,0,4,0,4
Kristina & Evans,4,0,0,0,4
Chandle,0,0,4,0,4
Hubert,1,0,3,0,4
Bee,3,0,1,0,4
Loraine,4,0,0,0,4
Belinda,4,0,0,0,4
Galina,3,0,1,0,4
Kristopher,4,0,0,0,4
Memo & Iso,0,0,4,0,4
Sameer,4,0,0,0,4
Sanja,2,0,2,0,4
Ellie,4,0,0,0,4
Alia,3,0,1,0,4
Pol,4,0,0,0,4
Carsandra,0,0,4,0,4
Marley,0,0,4,0,4
Judie And Steven,0,0,4,0,4
Yenys,0,0,4,0,4
Seeranie,0,0,4,0,4
Morales,1,0,3,0,4
Citadines,0,0,4,0,4
Azeez,1,0,3,0,4
Emmy,0,0,4,0,4
Dino,4,0,0,0,4
Hasan,1,0,3,0,4
Annabel,3,0,1,0,4
Hady,1,0,3,0,4
Manhattan House Studios,4,0,0,0,4
Hadrien,1,0,3,0,4
Amy And Yasha,1,0,3,0,4
Ervita,0,0,4,0,4
Walker Hotel Tribeca,0,0,4,0,4
Yonatan,3,0,1,0,4
Andrew And Sophia,0,0,4,0,4
Stephan,1,0,2,1,4
Sofia & Leah,0,0,4,0,4
Aly,2,0,2,0,4
Carina,3,0,1,0,4
Shari,4,0,0,0,4
Omer,1,0,3,0,4
Book It,4,0,0,0,4
Md,4,0,0,0,4
Abayomi,0,0,4,0,4
Margo,3,0,1,0,4
Michel,2,0,2,0,4
Sapna,1,0,2,1,4
Harlem,3,0,1,0,4
Miles,2,0,2,0,4
Faysal,3,0,0,1,4
Mamadou,2,0,2,0,4
Clayton,3,0,1,0,4
Vick,0,0,4,0,4
Giulia,2,0,2,0,4
Sandrine,1,0,3,0,4
Claudina,0,0,4,0,4
Juliet,1,0,3,0,4
Kent,2,0,2,0,4
Syed,4,0,0,0,4
Mike @ New Age Tech,2,0,2,0,4
Zee,2,0,2,0,4
Claude,3,0,1,0,4
Andrew & Lisa,4,0,0,0,4
Neriya,2,0,2,0,4
P,2,0,2,0,4
Clarence,3,0,1,0,4
Sydney,3,0,1,0,4
Jerry And Susan,4,0,0,0,4
Mika,2,0,2,0,4
Anna Chiara,0,0,4,0,4
Uche,1,0,3,0,4
Hope,3,0,1,0,4
Tzvi,3,0,0,1,4
Christiana,4,0,0,0,4
Wahid,0,0,4,0,4
Nima,3,0,1,0,4
Stefanie,0,0,3,1,4
Kiki,2,0,2,0,4
Mariette,1,0,3,0,4
Yona,4,0,0,0,4
Yaron,4,0,0,0,4
"Aarron, Scott And Michael",0,0,4,0,4
Lucas And Natasha,0,0,4,0,4
Jeremiah,3,0,1,0,4
Tny,4,0,0,0,4
Nigel,2,0,2,0,4
Alanna,3,0,1,0,4
Manolo Zaldua,1,0,3,0,4
Gabriele,2,0,2,0,4
Qudsia,0,0,4,0,4
Luca,2,0,2,0,4
Manon,2,0,2,0,4
Alpha,3,0,1,0,4
Perry,3,0,1,0,4
Simcha,4,0,0,0,4
Lp,2,0,2,0,4
Natalya,1,0,3,0,4
Chip,1,0,3,0,4
Nic,2,0,2,0,4
Landing,4,0,0,0,4
Lara Nicole,0,0,4,0,4
Amro,1,0,3,0,4
Althea,4,0,0,0,4
Nataliya,4,0,0,0,4
Ala,1,0,3,0,4
Lucio,1,0,3,0,4
"Christine,",4,0,0,0,4
Doreen,2,0,1,0,3
Ero,1,0,2,0,3
Jolie,3,0,0,0,3
Frankie,3,0,0,0,3
Dominik,2,0,1,0,3
Jordan And Kiara,1,0,2,0,3
Imran,2,0,1,0,3
Sarkis,1,0,2,0,3
Josefina,0,0,3,0,3
Hilda,1,0,2,0,3
Joel And Jamila,1,0,2,0,3
Esmeralda,0,0,3,0,3
Grisel,1,0,2,0,3
Dmitrij,3,0,0,0,3
Joie,1,0,2,0,3
Shahla,3,0,0,0,3
Ester,0,0,3,0,3
Sha,3,0,0,0,3
Shondelle,1,0,2,0,3
Gurpinder,3,0,0,0,3
Jonathon,0,0,3,0,3
Disney,3,0,0,0,3
Samara,3,0,0,0,3
Sergo,3,0,0,0,3
Hilarion,0,0,3,0,3
Esmé,3,0,0,0,3
Esra,3,0,0,0,3
Suzy,2,0,1,0,3
Svjetlana,1,0,2,0,3
H Two E,0,0,3,0,3
Shehzad,3,0,0,0,3
Smatha,0,0,3,0,3
Synergy Global,3,0,0,0,3
Johari,0,0,3,0,3
Shahar,3,0,0,0,3
Frederick And Jessy,0,0,3,0,3
Shabd,1,0,2,0,3
Ric,2,0,1,0,3
Francine,2,0,1,0,3
Donald And Isha,0,0,3,0,3
Imri,3,0,0,0,3
Dimitrios,3,0,0,0,3
Jonny,2,0,1,0,3
Sami,2,0,1,0,3
Salma,2,0,1,0,3
Johnny & Hala,3,0,0,0,3
Sascha,3,0,0,0,3
Digitcipher,3,0,0,0,3
Sevil,0,0,3,0,3
Dor,0,0,3,0,3
Rudolph,1,0,2,0,3
Shae,3,0,0,0,3
Grover,3,0,0,0,3
Genny,0,0,3,0,3
Rick,2,0,1,0,3
Jeanine,1,0,2,0,3
Sash,1,0,2,0,3
Shervin,3,0,0,0,3
Javier Fernando,0,0,3,0,3
Silvana,2,0,1,0,3
El,1,0,2,0,3
Sabitrie,0,0,3,0,3
Rommana,0,0,3,0,3
Skarly & Ming,0,0,3,0,3
Jennyfer,0,0,3,0,3
Sayra,0,0,3,0,3
Jacopo,2,0,1,0,3
Indiana,0,0,3,0,3
Rosana,2,0,1,0,3
Elelia,3,0,0,0,3
Germaine,1,0,2,0,3
Eleni,0,0,3,0,3
Elia,1,0,2,0,3
Seda,2,0,1,0,3
Fan,1,0,2,0,3
Ivey,2,0,1,0,3
Ismene,2,0,1,0,3
Egor,3,0,0,0,3
Fatoumata,0,0,3,0,3
Jerrell,1,0,2,0,3
Emy,2,0,1,0,3
Sade,1,0,2,0,3
Shanti,1,0,2,0,3
Harriet,0,0,3,0,3
Jesper,3,0,0,0,3
Emon,2,0,1,0,3
Sacha,3,0,0,0,3
Edythe,1,0,2,0,3
Giovanna,3,0,0,0,3
Eej,3,0,0,0,3
Jasvir,1,0,2,0,3
Stephany,3,0,0,0,3
Jerri,1,0,2,0,3
Gio,2,0,1,0,3
Hongzhi,0,0,3,0,3
Say,2,0,1,0,3
Ginny,2,0,1,0,3
Jackson,1,0,2,0,3
Ronald And Cookie,0,0,3,0,3
Jen Supang,0,0,3,0,3
Hector Sr,3,0,0,0,3
Seana,3,0,0,0,3
GiGGi,1,0,2,0,3
Ronny,3,0,0,0,3
Shawn(Ta),0,0,3,0,3
Rosalia,2,0,1,0,3
Eynat,3,0,0,0,3
Fabiana,3,0,0,0,3
Gerry,0,0,3,0,3
Hello,0,0,3,0,3
Elsa,1,0,2,0,3
Helga,1,0,2,0,3
Jeannette,1,0,2,0,3
Ez,3,0,0,0,3
Elvis,2,0,0,1,3
Sankofa,0,0,3,0,3
Shawana,0,0,3,0,3
Hotel Shocard Broadway Times Square,3,0,0,0,3
Search Stays,3,0,0,0,3
Geronimo,0,0,3,0,3
Shawnee,1,0,2,0,3
Jehan,2,0,1,0,3
Scarlett,0,0,2,1,3
Jazmine,2,0,1,0,3
Fahim S,0,0,3,0,3
Ronan,2,0,1,0,3
Elisha,2,0,1,0,3
Elissa,2,0,1,0,3
Sheree,2,0,1,0,3
Fahim,3,0,0,0,3
Stanton,3,0,0,0,3
Gigi,3,0,0,0,3
Extra Holidays®,0,0,3,0,3
Gideon,3,0,0,0,3
Gichard,0,0,3,0,3
Rosan,3,0,0,0,3
Jelena,2,0,1,0,3
Ryad,1,0,1,1,3
Izzy,3,0,0,0,3
Stewart,3,0,0,0,3
Edoardo,3,0,0,0,3
Selina Chelsea,0,0,3,0,3
Sahel,3,0,0,0,3
Georgi,3,0,0,0,3
Robbin,3,0,0,0,3
Gonzalo And Nora,3,0,0,0,3
Jo,2,0,1,0,3
Jk,1,0,2,0,3
Janna,2,0,1,0,3
Jiyoun,0,0,3,0,3
Sumeyye,0,0,3,0,3
Jinyun,0,0,3,0,3
Irie,1,0,2,0,3
Fideral,1,0,2,0,3
Shea,3,0,0,0,3
Robertina,0,0,3,0,3
Jingyi,0,0,3,0,3
Goldie,2,0,1,0,3
Suleidy,3,0,0,0,3
Iryna,2,0,1,0,3
Joana,1,0,2,0,3
Somaya,3,0,0,0,3
Sonali,3,0,0,0,3
Saskia,3,0,0,0,3
Indie,2,0,1,0,3
Florencia,0,0,3,0,3
Hi-Happy,0,0,0,3,3
Dorothy,1,1,1,0,3
Jody,1,0,2,0,3
Jodie,2,0,1,0,3
Ericka,2,0,1,0,3
Hamish,2,0,1,0,3
Jocelyne,3,0,0,0,3
Janie,1,0,2,0,3
Rj,3,0,0,0,3
Shweta,0,0,3,0,3
Shamel,1,0,2,0,3
Rui,3,0,0,0,3
Janine,2,0,0,1,3
Goziev,0,0,1,2,3
Shan,2,0,1,0,3
Shane & Nicole,3,0,0,0,3
Isa,2,0,1,0,3
Isiah,2,0,0,1,3
Glen,0,0,3,0,3
Subrina,0,0,3,0,3
I.D,0,0,3,0,3
Sonia & Jhon,1,0,2,0,3
Jasmina,0,0,3,0,3
Feige,3,0,0,0,3
Sander,2,0,1,0,3
Shilpa,3,0,0,0,3
Enen,0,0,3,0,3
Sigi,1,0,2,0,3
Jewell,0,0,3,0,3
Endless Homes,1,0,2,0,3
Ishmael,3,0,0,0,3
Sonja,2,0,1,0,3
Hupeto,3,0,0,0,3
Stormy,3,0,0,0,3
Edmund,3,0,0,0,3
Jessy,2,0,1,0,3
Enock,1,0,2,0,3
Ebbie,0,0,3,0,3
Septina,0,0,2,1,3
Sen,3,0,0,0,3
Durrell,3,0,0,0,3
Hanna,1,0,2,0,3
Duval,0,0,3,0,3
Robin LaVerne,0,0,3,0,3
Shaneice,2,0,1,0,3
Sid,1,0,2,0,3
Shinran,1,0,2,0,3
Evan Carl,0,0,3,0,3
Holiday Inn Express,3,0,0,0,3
Dylana,0,0,3,0,3
Ibi,0,0,3,0,3
E And M,0,0,3,0,3
Jeanne,3,0,0,0,3
E...,3,0,0,0,3
Rocky,2,0,1,0,3
Safin,3,0,0,0,3
Easton,3,0,0,0,3
Rocelly,0,0,3,0,3
Christ,2,0,1,0,3
Polly,3,0,0,0,3
Cando,0,0,3,0,3
Tylor,0,0,3,0,3
Nicola,3,0,0,0,3
Mary Ann,1,0,2,0,3
U P,3,0,0,0,3
Anderson,1,0,2,0,3
Yijun,1,0,2,0,3
Pengfei,1,0,2,0,3
Nikolay,3,0,0,0,3
Marvet,0,0,3,0,3
Penelope,3,0,0,0,3
Laura Adriana,2,0,1,0,3
Camorine,2,0,1,0,3
Camilo,1,0,2,0,3
Laurel,2,0,1,0,3
Lance,3,0,0,0,3
Lamia,3,0,0,0,3
Lamee,3,0,0,0,3
Carmel,1,0,2,0,3
Carmela,2,0,1,0,3
Carmelita,3,0,0,0,3
Laila,1,0,2,0,3
Laetitia,1,0,2,0,3
Lady,1,0,2,0,3
Anais,3,0,0,0,3
Yngrid And Jiovanni,3,0,0,0,3
Pettrina,0,0,3,0,3
Tucker,1,0,2,0,3
Phoebe,2,0,1,0,3
Pia,2,0,1,0,3
Amr,3,0,0,0,3
Amoyiem,1,0,2,0,3
Ulises,2,0,1,0,3
Yetunde,1,0,2,0,3
Paz,2,0,1,0,3
Brynda,1,0,2,0,3
Nikolas,2,0,1,0,3
Brigitte,1,0,2,0,3
Marisela,2,0,1,0,3
Anibal,0,0,3,0,3
Brinton,3,0,0,0,3
Britney,1,0,2,0,3
Mariya,3,0,0,0,3
Lemant,1,0,2,0,3
Patricio,0,0,3,0,3
Angus,1,0,2,0,3
Leisha,0,0,3,0,3
Brooks,2,0,1,0,3
Bruce & Cyrina,0,0,3,0,3
Bruna,1,0,2,0,3
Yelena,3,0,0,0,3
Andrew And Talia,1,0,2,0,3
Leela,1,0,2,0,3
Paulette,0,0,3,0,3
Aneseh,1,0,2,0,3
Bushwick Art Studios,0,0,3,0,3
Marni,3,0,0,0,3
Marquiese,2,0,0,1,3
Ursula,1,0,2,0,3
Paulo,0,0,3,0,3
Leanne,1,0,2,0,3
Yerddy,3,0,0,0,3
Leandro,0,0,3,0,3
Uriel,0,0,3,0,3
CMBRentals,3,0,0,0,3
Yesenia,2,0,1,0,3
Kyoko,0,0,3,0,3
Ni,2,0,1,0,3
Tripp,2,0,1,0,3
Kirill,2,0,1,0,3
Chello,1,0,2,0,3
Nen,3,0,0,0,3
Chelsea Pines Inn,0,3,0,0,3
Meagan,1,0,2,0,3
Chen,1,0,2,0,3
Kobi,3,0,0,0,3
Tomer,3,0,0,0,3
Klara,0,0,3,0,3
Cherry,2,0,1,0,3
Chester,2,0,1,0,3
Aloe,0,0,3,0,3
Kirsten,3,0,0,0,3
Kirk,1,0,2,0,3
Neilson,0,0,3,0,3
Mehmet,1,0,2,0,3
Chavisa,1,0,2,0,3
Chian-TiLung,0,0,3,0,3
Tom & Lily,0,0,3,0,3
Meital,2,0,1,0,3
Allegra,3,0,0,0,3
Alla,2,0,1,0,3
Tolga,1,0,2,0,3
Chioma,0,0,3,0,3
Tochi,2,0,1,0,3
Toby,1,0,2,0,3
Tobias,2,0,1,0,3
Tobi,1,0,2,0,3
Negra,3,0,0,0,3
Queen,2,0,1,0,3
Christa,1,0,2,0,3
Tommie,0,0,3,0,3
Chava,1,0,2,0,3
Pierce,3,0,0,0,3
Matt & Crutch,2,0,1,0,3
Kyeong Il,1,0,2,0,3
Kwab,3,0,0,0,3
Pilar,2,0,1,0,3
Cazzie,2,0,1,0,3
Cc,1,0,2,0,3
Mathias,3,0,0,0,3
Mathieu,3,0,0,0,3
Mathilde,2,0,1,0,3
Yoo MI,0,0,3,0,3
Yoon,2,0,1,0,3
Yordanos,2,0,1,0,3
Yosef,1,0,2,0,3
Ksenia,3,0,0,0,3
Krystal,3,0,0,0,3
Mattan,1,0,2,0,3
Chase,2,0,1,0,3
Chadanut,0,0,3,0,3
Kristina And Sasha,3,0,0,0,3
Kristian,2,0,1,0,3
Torris,0,0,3,0,3
Amedeo,3,0,0,0,3
Ame,0,0,3,0,3
Ambar,2,0,1,0,3
Neville,3,0,0,0,3
Too Much Management,0,0,3,0,3
Krasimir,0,0,3,0,3
Kosmopolitan,2,0,1,0,3
Kory,2,0,1,0,3
Maxim,1,0,2,0,3
Charmaine,2,0,1,0,3
Pasang,1,0,2,0,3
Brendon,3,0,0,0,3
Alix,2,0,1,0,3
Arianna,1,0,2,0,3
Arash,0,0,3,0,3
Onur,3,0,0,0,3
Luba,2,0,1,0,3
Mar,2,0,1,0,3
Onoriode,1,0,2,0,3
Nolitan,0,0,3,0,3
Lucija,1,0,2,0,3
Marion,1,0,2,0,3
Arie,1,0,2,0,3
Waleed,2,0,1,0,3
Xenia,0,0,3,0,3
Olufemi,0,0,3,0,3
Lukas,2,0,1,0,3
Lukasz,2,0,1,0,3
Banty,0,0,3,0,3
Aram,2,0,1,0,3
Louiza,2,0,1,0,3
Louie,2,0,1,0,3
Barbi,2,0,1,0,3
Opulence,1,0,2,0,3
Marcella,2,0,1,0,3
Viviana And Fred,3,0,0,0,3
Vivek,2,0,1,0,3
Basma,3,0,0,0,3
BassGal,0,0,3,0,3
Or,3,0,0,0,3
Loretta,2,0,1,0,3
Oran,2,0,1,0,3
Vitaliy,3,0,0,0,3
Bea,3,0,0,0,3
Anya,2,0,1,0,3
Noralyn,0,0,3,0,3
Ayesha,2,0,1,0,3
Norma,1,0,2,0,3
Atif,1,0,1,1,3
Aryeh,2,0,1,0,3
Ashleigh,1,0,2,0,3
Maha,1,0,2,0,3
Ashlie,0,0,3,0,3
Winie,1,0,2,0,3
Wilfredo,3,0,0,0,3
Oda,2,0,1,0,3
O,3,0,0,0,3
Mahesh,2,0,1,0,3
Ode,0,0,3,0,3
Arty,0,0,3,0,3
Astrid,3,0,0,0,3
Asumoh,0,0,3,0,3
Asya,2,0,1,0,3
MaVi,3,0,0,0,3
Malin,2,0,1,0,3
Aubrey,3,0,0,0,3
Ohad,3,0,0,0,3
Audra,1,0,2,0,3
Olabimpe,0,0,3,0,3
Nyoh,0,0,3,0,3
Aura,2,0,1,0,3
Wirdis,1,0,2,0,3
Aurgho,0,0,3,0,3
Nowme And Ra,3,0,0,0,3
Weimin,0,0,3,0,3
Noura,0,0,3,0,3
Nour,0,0,3,0,3
Avon,2,0,1,0,3
Awilda,2,0,1,0,3
Beautiful,2,0,1,0,3
Oren,2,0,1,0,3
Beauty,0,0,3,0,3
Liana,2,0,1,0,3
Blandine,3,0,0,0,3
Verena Vogelbacher,3,0,0,0,3
Lila,1,0,2,0,3
Yaniv,0,0,3,0,3
Yaniv And Vanessa,3,0,0,0,3
Vered,3,0,0,0,3
Blu,2,0,1,0,3
Bob,1,0,2,0,3
Venessa,2,0,1,0,3
Yann,3,0,0,0,3
Liesha,3,0,0,0,3
Vena,0,0,3,0,3
Pam,3,0,0,0,3
Yara,3,0,0,0,3
Leyssa,0,0,3,0,3
Page,3,0,0,0,3
Leyland,0,0,3,0,3
Ann Marie,2,0,1,0,3
Pardeep,0,0,3,0,3
Lev,3,0,0,0,3
Brandi,2,0,1,0,3
Pari,3,0,0,0,3
Leticia,2,0,1,0,3
Mariluz,0,0,2,1,3
Lester,1,0,2,0,3
Lesli,0,0,3,0,3
Lesa,1,0,2,0,3
Vas,0,0,3,0,3
Yasha,0,0,3,0,3
Bree,2,0,1,0,3
Lilia,0,0,3,0,3
Bk,3,0,0,0,3
Antonia,1,0,2,0,3
Viktoria,0,0,3,0,3
Maria C,0,0,3,0,3
London,1,0,0,2,3
Violeta,0,0,3,0,3
Logan,2,0,1,0,3
Nneka,2,0,1,0,3
Orly,1,0,2,0,3
Liv,3,0,0,0,3
Liudmila,1,0,2,0,3
Vilma,2,0,1,0,3
Bernardo,3,0,0,0,3
Lise,0,0,3,0,3
Yakima,0,0,3,0,3
Viktorija,3,0,0,0,3
Anowara,3,0,0,0,3
Viktor,3,0,0,0,3
Vernise,0,0,3,0,3
Vikas,3,0,0,0,3
Marianna,2,0,1,0,3
Anny,1,0,1,1,3
Nitin,1,0,2,0,3
Ling,0,0,3,0,3
Better Home,3,0,0,0,3
Vigil,0,0,3,0,3
Vienna,2,0,1,0,3
Annie & Lee,0,0,3,0,3
Beverley,1,0,2,0,3
Lincoln Suites,3,0,0,0,3
Lincoln,1,0,2,0,3
Lily-Thuy,3,0,0,0,3
Nisha,3,0,0,0,3
Melina,1,0,2,0,3
Asha,3,0,0,0,3
Karlyle,3,0,0,0,3
Keegan,2,0,1,0,3
Julio F.,0,0,3,0,3
Ajay,1,0,1,1,3
Abel,0,0,3,0,3
Abhi,1,0,2,0,3
Tamika,1,0,2,0,3
The Beekman,0,0,3,0,3
Jullett,0,0,3,0,3
The Allen Hotel,0,3,0,0,3
Dabelle,0,0,3,0,3
Rani,0,0,3,0,3
Rei,0,0,3,0,3
Raphael,3,0,0,0,3
Kathleen R.,0,0,3,0,3
Rehim,3,0,0,0,3
Thanaphat,0,0,3,0,3
Thai,1,0,2,0,3
Tanner,3,0,0,0,3
Acclaimed,1,0,2,0,3
Ainsley,3,0,0,0,3
Katerina,1,0,1,1,3
Dalton,3,0,0,0,3
Kaveh,0,0,3,0,3
The Morency Group,3,0,0,0,3
Delgroup Management,3,0,0,0,3
Demetrio,0,0,3,0,3
Cordelia,3,0,0,0,3
Deneesha,3,0,0,0,3
Nastassia,1,0,2,0,3
Midtown West,0,0,3,0,3
Rena,0,0,3,0,3
Theodora,1,0,2,0,3
The Wrights,0,0,3,0,3
Cristal,2,0,1,0,3
Demetrius,2,0,1,0,3
Zarif,1,0,2,0,3
Delia,2,0,1,0,3
The Sunrise,3,0,0,0,3
Ramy,2,0,0,1,3
Miho,1,0,2,0,3
Cristine,0,0,3,0,3
Akash,2,0,1,0,3
Aka Times Square,3,0,0,0,3
The Shelburne Sonesta,0,3,0,0,3
Kayan,2,0,1,0,3
Tami,2,0,1,0,3
Debdorkdave,2,0,1,0,3
Rashadul,3,0,0,0,3
Tess,1,0,2,0,3
Kahdeja,0,0,3,0,3
Daren,0,0,3,0,3
Darko,0,0,3,0,3
Raz F,0,0,3,0,3
Mireya,2,0,1,0,3
ReRent,3,0,0,0,3
Adelma,0,0,3,0,3
Rebeca,3,0,0,0,3
TeamOneBazNY,0,0,3,0,3
Tc,0,0,3,0,3
Kaila,1,0,2,0,3
Kady,3,0,0,0,3
Daryl,3,0,0,0,3
Kaitlin,0,0,3,0,3
Nadir,0,0,3,0,3
Mishelly,0,0,3,0,3
Davey,1,0,2,0,3
Tawhid,3,0,0,0,3
Adetunji,3,0,0,0,3
Nader,2,0,1,0,3
Adil,2,0,1,0,3
Telia,0,0,3,0,3
Mohamed,1,0,2,0,3
Debbi,3,0,0,0,3
Rawn,0,0,3,0,3
Justina,3,0,0,0,3
Deacon,0,0,3,0,3
Justyna,2,0,1,0,3
Najah,3,0,0,0,3
Ace,3,0,0,0,3
Aida,1,0,2,0,3
Terri,1,0,2,0,3
Ahu,0,0,0,3,3
Mindy,3,0,0,0,3
Agustina,0,0,3,0,3
Zhenya,1,0,2,0,3
Minerva,2,0,1,0,3
Agnieszka,3,0,0,0,3
Agata,0,0,3,0,3
Danna,2,0,1,0,3
Adel,1,0,2,0,3
Dannille,2,0,1,0,3
Mira And DJ,0,0,3,0,3
Tena,2,0,1,0,3
Karine,2,0,1,0,3
Thierry,1,0,2,0,3
Aditi,1,0,2,0,3
Thikshan,2,0,1,0,3
Juan Luis,1,0,2,0,3
Tai,1,0,2,0,3
Z,3,0,0,0,3
Cihan,2,0,1,0,3
Reon,2,0,1,0,3
Cliff,1,0,1,1,3
Clifton,2,0,1,0,3
Yvonne & Kathy,0,0,3,0,3
Dewayne,3,0,0,0,3
Raheem,1,0,2,0,3
Clive,3,0,0,0,3
Khaled,3,0,0,0,3
Moti,3,0,0,0,3
Mercy,1,0,2,0,3
Khalid,0,0,3,0,3
Tiff,2,0,1,0,3
Nazeer,2,0,1,0,3
Mostafa,3,0,0,0,3
Kemar,1,0,2,0,3
Michael And Carrol,0,0,3,0,3
Tain,3,0,0,0,3
Zac,1,0,2,0,3
Moses,2,0,1,0,3
Mert,2,0,1,0,3
Clarissa,2,0,1,0,3
Raffi,1,0,1,1,3
Mesha,1,0,2,0,3
Naz,2,0,1,0,3
Claudette,1,0,2,0,3
Clement & Rose,3,0,0,0,3
Kenna,3,0,0,0,3
Michelle & Evelyn,1,0,2,0,3
Taio,1,0,2,0,3
Clay,1,0,2,0,3
Kendra,1,0,2,0,3
Juan And Raquel,0,0,3,0,3
Kerri & Andrae,0,0,3,0,3
Kelli,1,0,2,0,3
Devika,0,0,3,0,3
Alexia,1,0,2,0,3
Ned,2,0,1,0,3
Morais,3,0,0,0,3
Mp,3,0,0,0,3
Kian,3,0,0,0,3
Yvener,3,0,0,0,3
Abass,3,0,0,0,3
Tianna,1,0,2,0,3
Akshay,2,0,1,0,3
Raj,1,0,2,0,3
Keiko,1,0,2,0,3
Rain,2,0,1,0,3
Christy,3,0,0,0,3
Qusuquzah,1,0,2,0,3
Zander,2,0,1,0,3
Alexi Javier,3,0,0,0,3
Thor,2,0,1,0,3
Colette,2,0,1,0,3
Nma,1,0,1,0,2
Maria Daniela,1,0,1,0,2
ModernHaus SoHo,0,2,0,0,2
N.Y.,1,0,1,0,2
NYC Host,0,0,2,0,2
Salim,2,0,0,0,2
Mk,1,0,1,0,2
Sanchit,1,0,1,0,2
Saint,1,0,1,0,2
O.T.,0,0,1,1,2
Sakina,2,0,0,0,2
Oakwood,2,0,0,0,2
Sergei&Yana,0,0,2,0,2
Muhammed,0,0,2,0,2
Mohan,2,0,0,0,2
H Susan,2,0,0,0,2
Mohamad,1,0,1,0,2
Maria Teresa,1,0,1,0,2
Iddelee,0,0,2,0,2
Marianella,0,0,2,0,2
Ibrahim Maiga,0,0,2,0,2
Ida,2,0,0,0,2
Shadi,1,0,1,0,2
NY Host,1,0,1,0,2
Mariangelica,1,0,1,0,2
Moza,0,0,2,0,2
Han,0,0,2,0,2
Sammi,1,0,1,0,2
Ms. Edith,0,0,2,0,2
Nitzan,1,0,1,0,2
Hampton Inn Madison Square,2,0,0,0,2
Han And Denyce,2,0,0,0,2
Marianny,2,0,0,0,2
Hampton,2,0,0,0,2
Nzinga,1,0,1,0,2
Ingrite,2,0,0,0,2
Shadae’,2,0,0,0,2
Serenity,0,0,1,1,2
Modesta,0,0,2,0,2
Motty,2,0,0,0,2
Serene,2,0,0,0,2
Ifi,1,0,1,0,2
Mohsin,1,0,1,0,2
Serra,1,0,1,0,2
Marabelle,1,0,1,0,2
Hadeel,0,0,2,0,2
Nolan,1,0,1,0,2
Monte,1,0,1,0,2
Mansi,1,0,1,0,2
Marie / Antoni Perez,1,0,1,0,2
Monzona,1,0,1,0,2
Mutaz,0,0,2,0,2
Musa,2,0,0,0,2
Ilka & Dave,2,0,0,0,2
Maneh,1,0,1,0,2
Mordechai,2,0,0,0,2
Malak,1,0,1,0,2
Malca,0,0,2,0,2
Moran& Ori,2,0,0,0,2
Mutale,2,0,0,0,2
Mandy,0,0,2,0,2
Haifang,2,0,0,0,2
Saly,0,0,2,0,2
Ima,2,0,0,0,2
Im,0,0,2,0,2
Malika,1,0,1,0,2
Hai-Hsin,0,0,2,0,2
Mor,1,0,1,0,2
Manav,2,0,0,0,2
Mamiko,0,0,2,0,2
Haeem,2,0,0,0,2
Mallory,1,0,1,0,2
Mora,0,0,2,0,2
Makeda,2,0,0,0,2
Maka,1,0,1,0,2
Myung,1,0,1,0,2
Majsan,0,0,2,0,2
Ido,1,0,1,0,2
Nytavia,2,0,0,0,2
Momo,1,0,1,0,2
Samia,2,0,0,0,2
Margareth,2,0,0,0,2
Mahmoud,1,0,1,0,2
Indhira & Alex,0,0,2,0,2
Marcin,1,0,1,0,2
Seymur,2,0,0,0,2
Mahogany Private Studio Apartment,1,0,1,0,2
Mungyu,0,0,2,0,2
Myrna,1,0,1,0,2
Halima,2,0,0,0,2
Myrdith,1,0,1,0,2
Halil,0,0,2,0,2
Marcello,2,0,0,0,2
Seyi,0,0,2,0,2
Moriah,2,0,0,0,2
Mondy,0,0,2,0,2
Marceline,2,0,0,0,2
Noelani,0,0,2,0,2
Monet&Greg,2,0,0,0,2
Ihab,2,0,0,0,2
Nusrat,1,0,1,0,2
Ihsane,0,0,2,0,2
Marca,2,0,0,0,2
Inacio,0,0,2,0,2
Noelva,2,0,0,0,2
Monisha,0,0,2,0,2
Muthanna,2,0,0,0,2
Neel,1,0,1,0,2
Nadege,2,0,0,0,2
Haya,0,0,2,0,2
Matan,0,0,2,0,2
Niamh,2,0,0,0,2
Hattie,1,0,1,0,2
Hilary,2,0,0,0,2
Natali,1,0,1,0,2
Micheline,2,0,0,0,2
Hilal & Maryam,2,0,0,0,2
Michela,1,0,1,0,2
Ioanna,1,0,1,0,2
Haydee,2,0,0,0,2
Natallia,2,0,0,0,2
Matias,2,0,0,0,2
Nataly,0,0,2,0,2
Matilda,0,0,2,0,2
Matilde,0,0,1,1,2
Nathaly,1,0,1,0,2
Seira,0,0,2,0,2
Massiel Peguero,1,0,1,0,2
Mason,1,0,1,0,2
Masaki,0,0,2,0,2
Hoda,2,0,0,0,2
Marvis,0,0,2,0,2
Mikaela,0,0,2,0,2
Historic Harlem,2,0,0,0,2
Marwa,2,0,0,0,2
Mikael,2,0,0,0,2
Hiro,0,0,2,0,2
MaryEllen,1,0,1,0,2
Hippolyte,1,0,1,0,2
Sarbjit,0,0,2,0,2
Maryjoan,2,0,0,0,2
Seith,2,0,0,0,2
Sari,2,0,0,0,2
Mifan,0,0,2,0,2
Marysia,0,0,2,0,2
Matthew & Marilyn,0,0,2,0,2
Matthew H.,2,0,0,0,2
Mitch,0,0,2,0,2
Mekkie,1,0,1,0,2
Merald,0,0,2,0,2
Megan E,0,0,2,0,2
Meng,1,0,1,0,2
Henderson,2,0,0,0,2
Hector Fabián,2,0,0,0,2
Mehmet S,0,0,2,0,2
Mendel,2,0,0,0,2
Mela,2,0,0,0,2
Hezekiah,2,0,0,0,2
Hellen,1,0,0,1,2
Melani,1,0,1,0,2
Melek,0,0,2,0,2
HeleNa,0,0,2,0,2
Melvin,2,0,0,0,2
Ndive,2,0,0,0,2
Neda,2,0,0,0,2
Meena,2,0,0,0,2
Meeks,0,0,2,0,2
Henriette,0,0,2,0,2
Nellie,2,0,0,0,2
Hazira,2,0,0,0,2
Matthias,2,0,0,0,2
Nevo,2,0,0,0,2
Hb,2,0,0,0,2
Maurizio,1,0,1,0,2
Sedef,1,0,1,0,2
Natia,1,0,1,0,2
Natiesha,2,0,0,0,2
Nesrine,2,0,0,0,2
National Corporate Housing,2,0,0,0,2
Nerlly,1,0,1,0,2
Nepreil,2,0,0,0,2
Nayef,2,0,0,0,2
Meaghan,1,0,1,0,2
Sebastiane,2,0,0,0,2
Harrlem,1,0,1,0,2
Marvic Donfree,2,0,0,0,2
Holiday Inn Express New York City,2,0,0,0,2
Marinez,0,0,2,0,2
Nilufer,0,0,2,0,2
Mariko,2,0,0,0,2
Mireille,1,0,1,0,2
Marilenis,1,0,1,0,2
Sentite Como En Casa,0,0,2,0,2
Mirco,2,0,0,0,2
Nahid,2,0,0,0,2
Marino,1,0,1,0,2
Holiday Inn Express Times Square,2,0,0,0,2
Mario & Maria,0,0,2,0,2
Mio,1,0,1,0,2
Melitsa,0,0,2,0,2
Naima,1,0,1,0,2
Minetta,1,0,1,0,2
Maristela,2,0,0,0,2
Maritza,2,0,0,0,2
Mariel,2,0,0,0,2
Sepi,2,0,0,0,2
Mirjam,0,0,2,0,2
Ninell,0,0,2,0,2
Missy,2,0,0,0,2
Marie And Seun,2,0,0,0,2
Serdar,0,0,2,0,2
Sandia,0,0,2,0,2
Hanan,2,0,0,0,2
Nis,2,0,0,0,2
Nadria,2,0,0,0,2
Hang,1,0,1,0,2
Husain,2,0,0,0,2
Marie Salomé,0,0,2,0,2
Hunter,1,0,1,0,2
Miroslaw,2,0,0,0,2
Mirlet,1,0,1,0,2
Nael,2,0,0,0,2
Nirajan,2,0,0,0,2
Happy,2,0,0,0,2
Hsiang Wei,0,0,2,0,2
Mark & Will,0,0,2,0,2
Nanda,1,0,1,0,2
Horacio,1,0,1,0,2
Miki,0,0,2,0,2
Sanya,2,0,0,0,2
Honora,2,0,0,0,2
Sanyika,0,0,2,0,2
Nicolo,1,0,1,0,2
Sappheira,0,0,2,0,2
Mike And Ollie,1,0,1,0,2
Mikayla,1,0,1,0,2
Honey,2,0,0,0,2
Mikala,2,0,0,0,2
Nicolette,1,0,1,0,2
Harris,1,0,1,0,2
Homero,2,0,0,0,2
Harrison,1,0,1,0,2
Haroon,2,0,0,0,2
Marshall,2,0,0,0,2
Hp,1,0,1,0,2
Marsha,2,0,0,0,2
Mark And Josephine,2,0,0,0,2
Sanjay,2,0,0,0,2
Hardy,2,0,0,0,2
Milo,1,0,1,0,2
Mark Anthony,2,0,0,0,2
Nikita,2,0,0,0,2
Marla,1,0,1,0,2
Harjinder,0,0,2,0,2
Marlene & Errol,2,0,0,0,2
Miller,1,0,1,0,2
Nika,0,0,2,0,2
Santiago & Maira,2,0,0,0,2
Mili,2,0,0,0,2
Nihad,2,0,0,0,2
Selin,2,0,0,0,2
Rez,1,0,1,0,2
Linh,1,0,1,0,2
Magda Agata,2,0,0,0,2
Keino,0,0,2,0,2
Ramon Reynaldo,2,0,0,0,2
Jhondi,2,0,0,0,2
Kazem,1,0,1,0,2
Jhoan,0,0,2,0,2
Jhasfer,2,0,0,0,2
Keene,1,0,1,0,2
Raju,1,0,1,0,2
Keila,2,0,0,0,2
Rajesh,1,0,1,0,2
Rajen,1,0,1,0,2
Jey,2,0,0,0,2
Keren,2,0,0,0,2
Keithan,0,0,2,0,2
Jett,1,0,1,0,2
Raimundo,0,0,2,0,2
Rahim,1,0,1,0,2
Kelvin,1,0,1,0,2
Kendall,1,0,1,0,2
Rolando,2,0,0,0,2
Kenday,0,0,2,0,2
Kenesha,1,0,1,0,2
Kenth,2,0,0,0,2
Kayleigh,1,0,1,0,2
Jiale,2,0,0,0,2
Ramsey,2,0,0,0,2
Jian Xin,2,0,0,0,2
Ravanna,2,0,0,0,2
Kass,2,0,0,0,2
Rasha,2,0,0,0,2
Jinha,0,0,2,0,2
Kateryna,0,0,2,0,2
Jinfa,2,0,0,0,2
Jin Li,2,0,0,0,2
Kathrine,1,0,1,0,2
Jimena,1,0,1,0,2
Katira,0,0,2,0,2
Katja,2,0,0,0,2
Katja And Jermaine,2,0,0,0,2
Jilly,1,0,1,0,2
Katrin,2,0,0,0,2
Randi,1,0,1,0,2
Kavita,1,0,1,0,2
Kaya,2,0,0,0,2
Rana,1,0,1,0,2
Rocio,2,0,0,0,2
Ran,2,0,0,0,2
Jianfeng,1,0,0,1,2
Rafe,1,0,1,0,2
Rafa,0,0,2,0,2
Jixian,0,0,2,0,2
Jennaya,2,0,0,0,2
Kimmy,0,0,2,0,2
Jennis,2,0,0,0,2
Kindra,0,0,2,0,2
Kiney,2,0,0,0,2
Jenniffer,2,0,0,0,2
Kip,0,0,2,0,2
Kira,0,0,2,0,2
Jennie,1,0,1,0,2
Jenni,2,0,0,0,2
Kirstie,0,0,2,0,2
Kisha,0,0,2,0,2
Kerlly,2,0,0,0,2
Kit,0,0,2,0,2
Kito,2,0,0,0,2
Kiyeon,1,0,1,0,2
Priyanka,1,0,1,0,2
Jenia,1,0,1,0,2
Jena,2,0,0,0,2
Jen & Jay,2,0,0,0,2
Kofi,2,0,0,0,2
Konchok,0,0,2,0,2
Konstantino,1,0,1,0,2
Jenny & Jose,0,0,2,0,2
Quamia,2,0,0,0,2
Jensen,1,0,1,0,2
Romina,0,0,2,0,2
Kern,1,0,1,0,2
Kerri,2,0,0,0,2
Radu,1,0,1,0,2
Racquel,1,0,1,0,2
Keturah,0,0,2,0,2
Kev,1,0,0,1,2
Khadija,0,0,2,0,2
Khalijah,2,0,0,0,2
R. J.,2,0,0,0,2
R Demetre,1,0,1,0,2
Kia,1,0,1,0,2
Romario,2,0,0,0,2
Romel,2,0,0,0,2
Kiana,2,0,0,0,2
Kiante,2,0,0,0,2
Jeremie,2,0,0,0,2
Kieran,0,0,2,0,2
Quinn,1,0,1,0,2
Romil,2,0,0,0,2
Quili (Sounds Keelee),1,0,1,0,2
Kila,1,0,1,0,2
Kasey,2,0,0,0,2
Ravi,1,0,1,0,2
Iosif,2,0,0,0,2
Remi,1,0,1,0,2
Remy,0,0,1,1,2
Julieta,2,0,0,0,2
Joni,2,0,0,0,2
Jonelle,2,0,0,0,2
Juliette,0,0,2,0,2
Jonathan And Jackeline,0,0,2,0,2
Jonah,2,0,0,0,2
Jona,2,0,0,0,2
Remo,2,0,0,0,2
Jon & Hui,2,0,0,0,2
July,1,0,1,0,2
Rinat,2,0,0,0,2
Ridhima,1,0,1,0,2
Reka,0,0,2,0,2
Reine,1,0,1,0,2
Jusham,0,0,2,0,2
Rehan,0,0,2,0,2
Johnnie,1,0,1,0,2
Riki,2,0,0,0,2
Johnathan,1,0,1,0,2
JohnP,1,0,1,0,2
Reggie,1,0,1,0,2
Richie,2,0,0,0,2
Renae,0,0,2,0,2
Richelle And Pela,2,0,0,0,2
Richelle,0,0,1,1,2
Josua,2,0,0,0,2
Reuven,2,0,0,0,2
Journey,1,0,1,0,2
Jovanna,2,0,0,0,2
Jose Vicente,0,0,2,0,2
Resham,2,0,0,0,2
Jozef,2,0,0,0,2
Jos,2,0,0,0,2
João,0,0,2,0,2
Renée,2,0,0,0,2
Jordon,2,0,0,0,2
Juan Camilo,1,0,1,0,2
Joon,0,0,2,0,2
Juan Eduardo,2,0,0,0,2
Juan Felipe,1,0,1,0,2
Joo,1,0,1,0,2
Juana,0,0,2,0,2
Juanita,1,0,1,0,2
Rental,1,0,1,0,2
Rennie,0,0,2,0,2
Julene,2,0,0,0,2
Regelen,2,0,0,0,2
John Conor,0,0,2,0,2
Kary,0,0,2,0,2
Joaquín,2,0,0,0,2
Joe Dimitri,2,0,0,0,2
Riva,2,0,0,0,2
Kamilah,1,0,1,0,2
Kamilia,2,0,0,0,2
Reah,1,0,1,0,2
Kandi,0,0,2,0,2
Razia,2,0,0,0,2
Raz,2,0,0,0,2
Karen And Kevin,2,0,0,0,2
Kari,2,0,0,0,2
Karilyn,2,0,0,0,2
Kabak,1,0,1,0,2
Karl & Catherine,0,0,2,0,2
Karlos,0,0,2,0,2
Robbie,1,0,1,0,2
Joa,0,0,2,0,2
Karma,0,0,2,0,2
Raychelle,2,0,0,0,2
Jo-Ann,2,0,0,0,2
Karol,2,0,0,0,2
Karthik,1,0,1,0,2
Rawan,1,0,1,0,2
Kami,2,0,0,0,2
Kamelia,2,0,0,0,2
Kamar,0,0,2,0,2
Joel & Donna,2,0,0,0,2
Kacy,2,0,0,0,2
Reesee,0,0,2,0,2
Kadisha,1,0,1,0,2
Kae,0,0,2,0,2
John & Catherine,1,0,1,0,2
Reema,2,0,0,0,2
Kafayat,0,0,2,0,2
Reem,1,0,1,0,2
Reed,2,0,0,0,2
Kaina,0,0,2,0,2
Johann,1,0,1,0,2
Kalana,1,0,0,1,2
RedAwning,2,0,0,0,2
Joga,2,0,0,0,2
Kaley,1,0,1,0,2
Kali,2,0,0,0,2
Kalife,2,0,0,0,2
Red,1,0,1,0,2
Joerg,0,0,2,0,2
Joelle,0,0,2,0,2
Kallie,0,0,2,0,2
Rong,0,0,2,0,2
Jem,2,0,0,0,2
Kris & Di,1,0,1,0,2
Lordan,2,0,0,0,2
Lisaret,0,0,2,0,2
Lizzie,2,0,0,0,2
Ornella,1,0,1,0,2
J.D. & Stephanie,0,0,2,0,2
Lo,2,0,0,0,2
Lokman,0,0,2,0,2
Long,0,0,2,0,2
Lora,1,0,1,0,2
Ruwaydah,0,0,2,0,2
Orestes,0,0,2,0,2
Lore,2,0,0,0,2
Sa,1,0,1,0,2
Orchard Street,2,0,0,0,2
Izaac,1,0,1,0,2
Rémi,1,0,1,0,2
Lorrie,2,0,0,0,2
Ivette,1,0,1,0,2
Opulence Oasis,2,0,0,0,2
Ivanna And Emmanuel,1,0,1,0,2
Louisa,1,0,1,0,2
Love,0,0,2,0,2
S & G,2,0,0,0,2
Jabari,1,0,1,0,2
Liron,2,0,0,0,2
Jacintha,0,0,1,1,2
Oxana,2,0,0,0,2
Jameelah,2,0,0,0,2
Jamar,1,0,1,0,2
Ligia,1,0,1,0,2
Jamaal,2,0,0,0,2
Lika,0,0,2,0,2
Jallal,0,0,2,0,2
Jalen,2,0,0,0,2
Jaleh,0,0,2,0,2
Jaison,1,0,1,0,2
Jaimie,0,0,2,0,2
Paddy,2,0,0,0,2
PIMG Housing,2,0,0,0,2
Lindsay Daniela,1,0,1,0,2
Ozvaldo,0,0,2,0,2
Jacqueline Beverly,1,0,1,0,2
Ozlem,1,0,1,0,2
Joseph & Teresa,2,0,0,0,2
Ozigbe,2,0,0,0,2
Russ,2,0,0,0,2
Lion,0,0,2,0,2
Rusty,0,0,1,1,2
Lovelynn,2,0,0,0,2
Luc,2,0,0,0,2
Krissy,1,0,1,0,2
Odelia,2,0,0,0,2
Isainer,2,0,0,0,2
Isaiah,2,0,0,0,2
Lynne,0,0,2,0,2
Lynsey,2,0,0,0,2
Olan,0,0,2,0,2
M Mostagir,2,0,0,0,2
M. Elizabeth,2,0,0,0,2
MaElena,1,0,1,0,2
Maamoun,0,0,2,0,2
Machel,2,0,0,0,2
Oded,2,0,0,0,2
Isra,0,0,2,0,2
Madelyn,1,0,1,0,2
Madi,1,0,1,0,2
Sahar,2,0,0,0,2
Octavio,0,0,2,0,2
Maeve,2,0,0,0,2
Iradj,2,0,0,0,2
Obee,2,0,0,0,2
Sahil,1,0,1,0,2
Iquane,2,0,0,0,2
Oates,0,0,2,0,2
Isamar,0,0,2,0,2
Lynford,1,0,1,0,2
Olena,2,0,0,0,2
Safia,2,0,0,0,2
Luci,1,0,1,0,2
Sable,2,0,0,0,2
Sabra,1,0,1,0,2
Onika,1,0,1,0,2
Omri,1,0,1,0,2
Ludina,0,0,2,0,2
Ludovica,1,0,1,0,2
Luis And Oriana,2,0,0,0,2
Olya,0,0,2,0,2
Luiz,0,0,2,0,2
Lukia,0,0,2,0,2
Sadie,1,0,1,0,2
Lulu,0,0,2,0,2
Luosong,0,0,2,0,2
SaeHo,1,0,1,0,2
Lupe,1,0,1,0,2
Olivera,1,0,1,0,2
Oli,1,0,1,0,2
Lydiah,1,0,0,1,2
Lyndell,1,0,1,0,2
Lyndon,2,0,0,0,2
Jamel,1,0,1,0,2
Liat,1,0,1,0,2
Lhakpa,2,0,0,0,2
Perla Joe,0,0,2,0,2
Jean Paul,0,0,2,0,2
Rosalina,1,0,1,0,2
Rosalyn,1,0,1,0,2
Ladi,0,0,2,0,2
Jazzy,0,0,2,0,2
Petros,2,0,0,0,2
Laia,2,0,0,0,2
Laine,1,0,1,0,2
Lamarr,1,0,1,0,2
Lance & Wanda,2,0,0,0,2
Larah,2,0,0,0,2
Lexie,0,0,2,0,2
Rose Pauline,2,0,0,0,2
Laramie,1,0,1,0,2
Jay Mark,2,0,0,0,2
Larrisa,2,0,0,0,2
Roseann,1,0,1,0,2
Pepper,2,0,0,0,2
Latasha,2,0,0,0,2
Peniel,0,0,2,0,2
Penha,2,0,0,0,2
Latif,2,0,0,0,2
LaToya,1,0,1,0,2
Phylicia,2,0,0,0,2
Kyril,1,0,1,0,2
Piedad Esthela,0,0,2,0,2
Jelen,2,0,0,0,2
Ronit,2,0,0,0,2
Pr,1,0,1,0,2
Kristiana,0,0,2,0,2
Kristie,2,0,0,0,2
Polina,1,0,1,0,2
Pnb,1,0,1,0,2
Krysia,2,0,0,0,2
Jeffrey And Anna Rita,2,0,0,0,2
Jeffery,1,0,1,0,2
Jefferson,0,0,1,1,2
Jeff And Michelle,0,0,2,0,2
Pj,0,0,2,0,2
Piotr,0,0,2,0,2
Kunchok,0,0,2,0,2
Kung,0,0,2,0,2
Jed,2,0,0,0,2
Jeanny,1,0,1,0,2
Pim,2,0,0,0,2
Kym,2,0,0,0,2
Roosevelt,2,0,0,0,2
Latonia,0,0,2,0,2
Jaspreet,2,0,0,0,2
Pemba,2,0,0,0,2
Leidi,0,0,2,0,2
Patty,2,0,0,0,2
Patti And Kat,0,0,2,0,2
Roya,1,0,1,0,2
Royal,2,0,0,0,2
Janet-David,1,0,1,0,2
Royalton,0,0,2,0,2
Lendy,0,0,2,0,2
Rr,2,0,0,0,2
Lennon,0,0,2,0,2
Jane & Ian,0,0,2,0,2
Lenore,2,0,0,0,2
Leonel,0,0,2,0,2
Leonor,0,0,2,0,2
Leora,2,0,0,0,2
Lera,0,0,2,0,2
Jamison,1,0,1,0,2
Lesley,2,0,0,0,2
Lethy,0,0,2,0,2
Jamil,0,0,2,0,2
Levi,1,0,1,0,2
Lexi,2,0,0,0,2
Patwell,0,0,1,1,2
Legacy,2,0,0,0,2
Peiyi,1,0,1,0,2
Janina,0,0,2,0,2
Laure,1,0,1,0,2
Peet,2,0,0,0,2
Lauryn,1,0,1,0,2
Laverne,2,0,0,0,2
Pearline,2,0,0,0,2
Jaryd,2,0,0,0,2
Roshan,2,0,0,0,2
Lc,2,0,0,0,2
Pawel,2,0,0,0,2
Jarad,0,0,0,2,2
Leandra,0,0,2,0,2
Rossana,0,0,2,0,2
Pauriany,0,0,2,0,2
Japher,0,0,2,0,2
Roukayatou,0,0,2,0,2
Rowena,2,0,0,0,2
Roxana,2,0,0,0,2
Jannah,2,0,0,0,2
Paulina,2,0,0,0,2
Leecia,1,0,1,0,2
Leena,2,0,0,0,2
 Valéria,0,0,2,0,2
Mrs. Alabi,1,0,1,0,2
Chidi,0,0,2,0,2
Colin And Madelaine,1,0,0,1,2
Club Quarters World Trade Center,0,0,2,0,2
Anaïs,1,0,1,0,2
Emine,1,0,1,0,2
Emily And Vera,2,0,0,0,2
Emilia,2,0,0,0,2
Ander Enterprise,2,0,0,0,2
Andi,0,0,2,0,2
Yiin,0,0,2,0,2
Beebe,2,0,0,0,2
Bec,2,0,0,0,2
Beautiful Harlem,2,0,0,0,2
Beau,1,0,1,0,2
Bel,1,0,1,0,2
Tian,0,0,2,0,2
Emeka,0,0,2,0,2
Yi-Chen,0,0,2,0,2
Beata,1,0,1,0,2
Emanuela,2,0,0,0,2
Andressa,1,0,1,0,2
Conley,1,0,1,0,2
Constance,0,0,2,0,2
Elyse,2,0,0,0,2
Ely,2,0,0,0,2
Elton,0,0,2,0,2
Anatha Angèle,2,0,0,0,2
Club Quarters Grand Central,0,0,2,0,2
Elspeth,2,0,0,0,2
Enoch,1,0,1,0,2
Ana Karla,2,0,0,0,2
Ercilia,1,0,1,0,2
Benat,0,0,2,0,2
Sonam,1,0,1,0,2
Ben&Rachel,2,0,0,0,2
Enrico,2,0,0,0,2
Claudine,2,0,0,0,2
Enrica,1,0,1,0,2
Tika,0,0,2,0,2
Vinneth,2,0,0,0,2
Claudius,2,0,0,0,2
Clell,0,0,2,0,2
Yiota,2,0,0,0,2
Tijana,2,0,0,0,2
Enid,1,0,1,0,2
Anabel,2,0,0,0,2
Eneroliza,2,0,0,0,2
Emrah,0,0,2,0,2
Clement,1,0,1,0,2
Cleo,1,0,1,0,2
Analisa,0,0,1,1,2
Clinton,1,0,1,0,2
Emmett,0,0,2,0,2
Emmanuelle,1,0,1,0,2
Constance F.,0,0,2,0,2
Andria,1,0,1,0,2
Edmundo,2,0,0,0,2
Ania,0,0,2,0,2
Eleanor And Alex,0,0,2,0,2
Yehoshua,2,0,0,0,2
Eldad,2,0,0,0,2
Elda,1,0,1,0,2
Elbeert C,2,0,0,0,2
Barak,2,0,0,0,2
Anh,1,0,1,0,2
Ela,0,0,2,0,2
Cristopher,1,0,1,0,2
Cristóbal,2,0,0,0,2
The Redford,2,0,0,0,2
Crystal Lyn,2,0,0,0,2
Stay Awhile,2,0,0,0,2
Csj,2,0,0,0,2
Ehsan,1,0,1,0,2
The Orchard Street,0,0,2,0,2
Stephania,1,0,1,0,2
Cy,2,0,0,0,2
Eean,0,0,2,0,2
Edyta,2,0,0,0,2
Anisia,0,0,2,0,2
Cynthia And Froebel,1,0,1,0,2
Edouard,2,0,0,0,2
The Gems,2,0,0,0,2
Yehuda,0,0,2,0,2
Elene,0,0,2,0,2
Vito,1,0,1,0,2
Corentin,1,0,1,0,2
Elon,2,0,0,0,2
Srdjan,2,0,0,0,2
Elodie,2,0,0,0,2
Elmahdi,2,0,0,0,2
André,0,0,2,0,2
Andy & Friends,0,0,1,1,2
Cooper,2,0,0,0,2
Thihira,2,0,0,0,2
Elizabeth And Timothee,2,0,0,0,2
Elizabeth And Roberto,2,0,0,0,2
Eliza Love,1,0,1,0,2
Elireth,0,0,2,0,2
Starr,2,0,0,0,2
Eliran,2,0,0,0,2
Eliot,2,0,0,0,2
Corin,1,0,1,0,2
Elio,1,0,1,0,2
Thiago,2,0,0,0,2
Elif,1,0,1,0,2
Yehudit,2,0,0,0,2
Elien Blue,2,0,0,0,2
Elien,2,0,0,0,2
Elie,1,0,1,0,2
Angeline,2,0,0,0,2
An Ting,2,0,0,0,2
Eren,2,0,0,0,2
Yolander,1,0,1,0,2
Beto,0,0,1,1,2
Fabienne,2,0,0,0,2
Victor G,0,0,2,0,2
Fabi,2,0,0,0,2
Bibiana,0,0,2,0,2
F,1,0,1,0,2
Ezequiel,2,0,0,0,2
Vielca,2,0,0,0,2
Bettina,1,0,1,0,2
Sitar,0,0,2,0,2
Yufan,2,0,0,0,2
Ting Yi,2,0,0,0,2
Alyson,1,0,1,0,2
Fabricio,2,0,0,0,2
Ting,1,0,1,0,2
Yudum,0,0,2,0,2
Six Five Two Central,2,0,0,0,2
Chy,2,0,0,0,2
Alé,1,0,1,0,2
Ewa,2,0,0,0,2
Evyiatar,0,0,2,0,2
Viki,2,0,0,0,2
Evie,2,0,0,0,2
Best Inns,2,0,0,0,2
Evi,1,0,1,0,2
Yuki,2,0,0,0,2
Tisha,1,0,1,0,2
Amy & Dan,2,0,0,0,2
Allyn,2,0,0,0,2
Yunuen,1,0,1,0,2
Chrissy,2,0,0,0,2
Biruta,2,0,0,0,2
Birgitta,2,0,0,0,2
Yunqiu,2,0,0,0,2
Yunis,2,0,0,0,2
Christelle,1,0,1,0,2
Allon,1,0,1,0,2
Biren,0,0,2,0,2
Christian & Carla,1,0,1,0,2
Farhan,2,0,0,0,2
Allyson,1,0,1,0,2
Christos,2,0,0,0,2
Tito,1,0,1,0,2
Fanta,2,0,0,0,2
Family,0,0,2,0,2
Fallon,1,0,1,0,2
Titi,0,0,2,0,2
Christlyn,2,0,0,0,2
Christof,2,0,0,0,2
Yulia And Amine,1,0,1,0,2
Alonso,0,0,2,0,2
Alonzo,1,0,1,0,2
Fadi,0,0,2,0,2
Vikki,1,0,1,0,2
Bertrand,2,0,0,0,2
Viktoriia,0,0,2,0,2
Ermira,0,0,2,0,2
CitizenM,0,2,0,0,2
Aminah,2,0,0,0,2
Esin,0,0,2,0,2
Esi,1,0,1,0,2
Timothy + Katrin,1,0,1,0,2
Sofiya,0,0,2,0,2
Yoselyn,2,0,0,0,2
Vince,0,0,2,0,2
Timo,1,0,1,0,2
Vincent Felicia,2,0,0,0,2
Ernesto,2,0,0,0,2
Erma,2,0,0,0,2
Evens,1,0,1,0,2
Times Square,2,0,0,0,2
Solange,1,0,1,0,2
"Erin, Avi, Kaleb & Shiloh",2,0,0,0,2
Sole,2,0,0,0,2
Beni,2,0,0,0,2
Soleil,1,0,1,0,2
Yonaton,2,0,0,0,2
Amri,2,0,0,0,2
Erhan,1,0,1,0,2
Benham,0,0,2,0,2
Ergun,0,0,2,0,2
Essence,2,0,0,0,2
Timothy And Natalia,2,0,0,0,2
SoSo,0,0,2,0,2
Cinthya,1,0,1,0,2
Bertha,0,0,2,0,2
Ysabel,2,0,0,0,2
Amani,0,0,2,0,2
Evelina,1,0,1,0,2
Yozadib,1,0,1,0,2
Cielo,0,0,2,0,2
Cierra,1,0,1,0,2
Timur,2,0,0,0,2
Amaury,2,0,0,0,2
Evandra,2,0,0,0,2
Evan & Maria,1,0,0,1,2
Skyler,0,0,2,0,2
Eunice,2,0,0,0,2
Ameela,2,0,0,0,2
Eufemia,0,0,1,1,2
Etty,0,0,1,1,2
Sneha,0,0,2,0,2
Cinthia,1,0,1,0,2
Estefani,0,0,2,0,2
Amer,1,0,1,0,2
Esteem,0,0,1,1,2
Estebania,0,0,2,0,2
Yossi,2,0,0,0,2
Ednil,2,0,0,0,2
D.,2,0,0,0,2
Yuri,0,0,2,0,2
Arman,2,0,0,0,2
TInesha,2,0,0,0,2
Diely,2,0,0,0,2
Avery,0,0,2,0,2
Austine,0,0,2,0,2
Taya,1,0,1,0,2
Arlenny,0,0,2,0,2
Aurora,1,0,1,0,2
Wyatt,2,0,0,0,2
Aurelien,1,0,1,0,2
Weiwei,0,0,2,0,2
Arlton,0,0,2,0,2
Dianne,2,0,0,0,2
Arina,1,0,1,0,2
Tavian,0,0,2,0,2
Armin,0,0,2,0,2
Aurangel,0,0,2,0,2
Tatrian,2,0,0,0,2
Armstrong,1,1,0,0,2
Arnaud,2,0,0,0,2
Tatiane,2,0,0,0,2
Arnie,0,0,0,2,2
Diane And Craig,2,0,0,0,2
Woody,1,0,1,0,2
Diala,2,0,0,0,2
Aviad,2,0,0,0,2
Xiangyu,0,0,2,0,2
Deycke,0,0,2,0,2
Argenis,0,0,2,0,2
Divya,1,0,1,0,2
Avram,2,0,0,0,2
Dariusz,2,0,0,0,2
Dirk,2,0,0,0,2
Aviva,1,0,1,0,2
Wayne And Yesim,0,0,2,0,2
Switch,2,0,0,0,2
Tegan,1,0,1,0,2
Ximena,2,0,0,0,2
Dionys,2,0,0,0,2
Arelis,1,0,1,0,2
Sylvester,2,0,0,0,2
Taz Yin,1,0,1,0,2
Darline,0,0,2,0,2
Darling,0,0,2,0,2
Synergy,2,0,0,0,2
Dimitrije,0,0,2,0,2
Aria,2,0,0,0,2
T+Y+K+M,2,0,0,0,2
Ted & Tony,2,0,0,0,2
Darwin And Nicole,2,0,0,0,2
T. Charle,2,0,0,0,2
Darya,2,0,0,0,2
Dikla,2,0,0,0,2
Arnold,1,0,1,0,2
Tasny,1,0,1,0,2
Stuart,1,0,1,0,2
Delcio,0,0,2,0,2
Ashek,1,0,1,0,2
Ashish,1,0,1,0,2
Demus,1,0,1,0,2
Tamar,1,0,1,0,2
Ashlee,2,0,0,0,2
Willi,1,0,1,0,2
Delroy,0,0,2,0,2
Delphine,2,0,0,0,2
Aston,2,0,0,0,2
Will & Tash,0,0,2,0,2
Tamicka,0,0,2,0,2
Delanno,2,0,0,0,2
Ashade,2,0,0,0,2
Tamir,2,0,0,0,2
Ashraful,0,0,2,0,2
Deanna,2,0,0,0,2
Wilhel,2,0,0,0,2
Defeng,0,0,2,0,2
Wilfred Mike,0,0,2,0,2
Wilfred,2,0,0,0,2
Debora,2,0,0,0,2
Wilber,1,0,1,0,2
Declan,2,0,0,0,2
Deedles,0,0,2,0,2
Tarajee,0,0,2,0,2
Wilma,1,0,1,0,2
Wendell,0,0,2,0,2
Winsome,2,0,0,0,2
August,0,0,2,0,2
Tailiana,0,0,2,0,2
Audey,1,0,1,0,2
Devin,0,0,2,0,2
Dawud,2,0,0,0,2
Tashi,2,0,0,0,2
Tarun,2,0,0,0,2
Taka,2,0,0,0,2
Desmar,2,0,0,0,2
Werner,0,0,2,0,2
Artie,2,0,0,0,2
Dayna,1,0,1,0,2
Aseel,2,0,0,0,2
Dayne,2,0,0,0,2
Takanori,0,0,2,0,2
Arturo,0,0,2,0,2
Aruna,2,0,0,0,2
Tarrus,0,0,2,0,2
Tariq,2,0,0,0,2
Tal & Amarelle,2,0,0,0,2
Deonisis,0,0,2,0,2
Tala,1,0,1,0,2
Tarik,2,0,0,0,2
Atlanta,0,0,2,0,2
Dj,2,0,0,0,2
Arazmis,0,0,2,0,2
Dmitriy And Anna,0,0,2,0,2
Damary,1,0,1,0,2
E,1,0,1,0,2
Wael,2,0,0,0,2
Annaliesa,1,0,1,0,2
Dalia & Marina,2,0,0,0,2
Suket,2,0,0,0,2
Dusan,2,0,0,0,2
Dallas,1,0,1,0,2
Sukience,2,0,0,0,2
Anne-Laure,1,0,1,0,2
Anne-Sophie,2,0,0,0,2
Badal,2,0,0,0,2
Tessy,0,0,2,0,2
Wade,2,0,0,0,2
Babak,1,0,1,0,2
Babajide,2,0,0,0,2
Dami,1,0,1,0,2
Annkellie,0,0,2,0,2
Damilola,1,0,1,0,2
Yanela,0,0,2,0,2
Waldemar,0,0,2,0,2
B.,2,0,0,0,2
Damon,1,0,1,0,2
Summar,0,0,2,0,2
Azu,0,0,2,0,2
Sugeiry,1,0,0,1,2
Bailey,1,0,1,0,2
Dmitry,2,0,0,0,2
Su,2,0,0,0,2
Dacia,2,0,0,0,2
Yasemin,0,0,2,0,2
Yarynka,0,0,2,0,2
Edina,2,0,0,0,2
Yaroslav,2,0,0,0,2
Bank,1,0,1,0,2
Edgardo,2,0,0,0,2
Edgar Remigio,0,0,2,0,2
Bambu Homes,2,0,0,0,2
Ann-Deal,2,0,0,0,2
Stā,2,0,0,0,2
Balwinder,0,0,2,0,2
Tharciany,0,0,2,0,2
Yarleny,0,0,2,0,2
Ebony,1,0,1,0,2
Dafni,1,0,1,0,2
Anna And Toby,2,0,0,0,2
Success,1,0,1,0,2
Yarden,1,0,1,0,2
Bairun,1,0,1,0,2
Earlene,2,0,0,0,2
Ean,0,0,2,0,2
Sueheddy,2,0,0,0,2
Sueli,1,0,1,0,2
Drew And Cherri,0,0,2,0,2
DreamSpace,1,0,1,0,2
Aziza,0,0,2,0,2
Domingo,1,0,1,0,2
Susie,1,0,1,0,2
Dante,0,0,2,0,2
Apostle John,0,0,2,0,2
Temple,1,0,1,0,2
Aqeel,2,0,0,0,2
Ayanna,1,0,1,0,2
Ayan,2,0,0,0,2
Xiuzhen,0,0,2,0,2
Temistocles J.,0,0,2,0,2
Aracely,0,0,2,0,2
Xiomara,0,0,2,0,2
Axelle,1,0,1,0,2
Terrence,2,0,0,0,2
Domenica,0,0,2,0,2
Axel,2,0,0,0,2
Dom,2,0,0,0,2
Daquana,2,0,0,0,2
Xinyi,0,0,2,0,2
Aramis,0,0,2,0,2
Dolores,2,0,0,0,2
Dolly,1,0,0,1,2
Dogukan,1,0,1,0,2
Doctor,2,0,0,0,2
Sviat,2,0,0,0,2
Susi,2,0,0,0,2
Sushant,1,0,0,1,2
Yaakov,1,0,1,0,2
Dorin,2,0,0,0,2
Yajaira,0,0,2,0,2
Sunday,1,0,1,0,2
Dania,2,0,0,0,2
Anthony & Jessica,2,0,0,0,2
Danie,0,0,2,0,2
Antonella,2,0,0,0,2
Yahighnes,2,0,0,0,2
Terra,1,0,1,0,2
Dr. Tania,2,0,0,0,2
Yagil,0,0,2,0,2
Walker,0,0,2,0,2
Sunitha,2,0,0,0,2
Azamat,1,0,1,0,2
Antti,0,0,2,0,2
Doyen,2,0,0,0,2
Dovber,2,0,0,0,2
Doungrat (Diane),0,0,2,0,2
Terence,1,0,1,0,2
Yadira,2,0,0,0,2
Suphitcha,0,0,2,0,2
Dorina,2,0,0,0,2
Yaasha,0,0,2,0,2
Ayinde And Safiya,2,0,0,0,2
Allah,2,0,0,0,2
Youssouf,0,0,2,0,2
Tanisha,1,0,1,0,2
Garon,0,0,2,0,2
Abir,1,0,1,0,2
Garnet,0,0,2,0,2
Airik,2,0,0,0,2
Sheren,2,0,0,0,2
Garfield,2,0,0,0,2
Zena,1,0,1,0,2
Toufik,0,0,2,0,2
Tosin/Rashon,0,0,2,0,2
Aisha,1,0,1,0,2
Chanel,2,0,0,0,2
Gann,0,0,2,0,2
Chani,2,0,0,0,2
C S,0,0,2,0,2
Brandyce,2,0,0,0,2
C-S,0,0,2,0,2
Galen,0,0,2,0,2
Gala,2,0,0,0,2
Gaia,1,0,1,0,2
C-Van,2,0,0,0,2
Gizem,2,0,0,0,2
Abul,2,0,0,0,2
Tunde,2,0,0,0,2
Bárbara,1,0,1,0,2
Shanté,1,0,1,0,2
Gavin,2,0,0,0,2
Treasure,2,0,0,0,2
Cezar,0,0,2,0,2
Zui,0,0,2,0,2
Sheneca,0,0,2,0,2
Gautam,1,0,1,0,2
Chad Antonio,2,0,0,0,2
Aileen,2,0,0,0,2
Gaudhi,0,0,1,1,2
Traverse,2,0,0,0,2
Giuseppe,1,0,1,0,2
Aime Parfait,0,0,2,0,2
Gaspard,0,0,2,0,2
Tram,1,0,1,0,2
Burton,0,0,2,0,2
Gaspar,2,0,0,0,2
Ainslie And John,0,0,2,0,2
Tracie,0,0,2,0,2
Shanique,1,0,1,0,2
C.,2,0,0,0,2
Tuva,0,0,2,0,2
Chantell,1,0,1,0,2
Abdumadzhid,2,0,0,0,2
Shine Dee,0,0,2,0,2
Fuat,0,0,2,0,2
Braden,0,0,2,0,2
FuQuan,2,0,0,0,2
Carlota,1,0,1,0,2
Shanda,1,0,1,0,2
Shanakay,2,0,0,0,2
Abdoulaye,0,0,2,0,2
Charley,1,0,1,0,2
Vee,0,0,2,0,2
Shamim,1,0,1,0,2
Shamil,1,0,1,0,2
Umme,1,0,0,1,2
Shameen,1,0,1,0,2
Charn,2,0,0,0,2
Boro Hotel,0,0,2,0,2
Borna,0,0,2,0,2
Frida,1,0,1,0,2
Akilah,2,0,0,0,2
Golden,2,0,0,0,2
Carlyn,2,0,0,0,2
Shani & Emily,0,0,2,0,2
Brandy,1,0,1,0,2
CASA Heidi,2,0,0,0,2
Vasiliqi,2,0,0,0,2
Zeeshan,1,0,1,0,2
Aiza,2,0,0,0,2
Sheva,2,0,0,0,2
Global Luxury,2,0,0,0,2
Chapman,0,0,2,0,2
Aka,2,0,0,0,2
Charity,0,0,2,0,2
Aka Sutton Place,2,0,0,0,2
Torell,0,0,0,2,2
Branda,0,0,2,0,2
Carmen Nathaly,2,0,0,0,2
Godfrey,2,0,0,0,2
Bran,2,0,0,0,2
Charisse,2,0,0,0,2
Tye And Etienne,0,0,2,0,2
BreAnne,1,0,1,0,2
Aigerim Aika,0,0,2,0,2
Freya,2,0,0,0,2
Adesh,2,0,0,0,2
Britt & Greg,2,0,0,0,2
Zoisa,0,0,2,0,2
Bryan-Lee,0,0,2,0,2
Adriel,0,0,1,1,2
Shaya,1,0,1,0,2
Adrián,1,0,1,0,2
Shayan,1,0,1,0,2
Britt,2,0,0,0,2
Vaida,0,0,2,0,2
Shayara,2,0,0,0,2
Casa,2,0,0,0,2
Zorina And Andrew,0,0,2,0,2
Brit,2,0,0,0,2
Sharlee,0,0,2,0,2
Zi,1,0,1,0,2
Sharina,1,0,1,0,2
Gilles,0,0,2,0,2
Shayna,1,0,1,0,2
Adekunle,0,0,2,0,2
Catia,2,0,0,0,2
Adrianne,2,0,0,0,2
Breiana,1,0,1,0,2
Britta,1,0,1,0,2
Cassia,0,0,2,0,2
Zişan,0,0,2,0,2
Casper,1,0,1,0,2
Cassie,0,0,2,0,2
Trista,1,0,1,0,2
Zipporah,2,0,0,0,2
Giac,0,0,2,0,2
Gia,2,0,0,0,2
Admir,2,0,0,0,2
Caterina,1,0,1,0,2
Geuka,2,0,0,0,2
Adonna,1,0,1,0,2
Gesi,2,0,0,0,2
Gila,2,0,0,0,2
Gilad,2,0,0,0,2
Catherine Sylvie,1,0,1,0,2
Bruce & Suzanne,1,0,1,0,2
Shawna,2,0,0,0,2
Cathleen,1,0,1,0,2
Addie,0,0,2,0,2
Ginger,1,0,1,0,2
Afak,0,0,2,0,2
Brice,2,0,0,0,2
Agnese,0,0,2,0,2
Vania,2,0,0,0,2
V.I.,2,0,0,0,2
Carolin,2,0,0,0,2
Giovanny,0,0,2,0,2
Agwu,2,0,0,0,2
Geetanjali,1,0,1,0,2
Celestino,2,0,0,0,2
Celia,2,0,0,0,2
Celin,0,0,2,0,2
Zhansaya,0,0,2,0,2
Adal,1,0,1,0,2
Zhanna,2,0,0,0,2
Uğur,0,0,2,0,2
Farrel,0,0,2,0,2
Aigerim,2,0,0,0,2
Shara,1,0,1,0,2
Gisela,2,0,0,0,2
Ada Azra,0,0,0,2,2
Agel,1,0,1,0,2
Gena,0,0,2,0,2
Cee,2,0,0,0,2
Agatha,1,0,1,0,2
Zoë,1,0,1,0,2
Gino,1,0,1,0,2
Georges,1,0,1,0,2
George&Triny,0,0,2,0,2
George And Frances,2,0,0,0,2
George & Diana,2,0,0,0,2
Trice,2,0,0,0,2
Geoff,1,0,1,0,2
Agathe,2,0,0,0,2
Tri,1,0,1,0,2
Shelbie,0,0,2,0,2
Cece,1,0,1,0,2
Carter,1,0,1,0,2
Shell,2,0,0,0,2
Carson,2,0,0,0,2
Bucardo,0,0,2,0,2
Bria,1,0,1,0,2
Bri,2,0,0,0,2
Akram,2,0,0,0,2
Bradford,1,0,1,0,2
Calle,2,0,0,0,2
Gryphon,1,0,1,0,2
Felicita,1,0,1,0,2
Uday,2,0,0,0,2
Blaise,0,0,2,0,2
Sierra,0,0,2,0,2
Femala,2,0,0,0,2
Venecia,0,0,2,0,2
Alena,2,0,0,0,2
Guo,2,0,0,0,2
Shahzeb,2,0,0,0,2
Flora,0,0,2,0,2
Shunan,1,0,0,1,2
Capri,2,0,0,0,2
Caridad,0,0,2,0,2
Alencar Almeida,1,0,1,0,2
Chikie,0,0,2,0,2
Florencia And Harry,1,0,1,0,2
Carissa,0,0,2,0,2
Capucine,1,0,1,0,2
Shuhua,1,0,1,0,2
Aleksandar,2,0,0,0,2
Flower,1,0,1,0,2
Shreya,1,0,1,0,2
Griffin,1,0,1,0,2
Calatayud Family,2,0,0,0,2
Shu,1,0,0,1,2
Aleksey,1,0,1,0,2
Bladimil,0,0,2,0,2
Candida,2,0,0,0,2
Shubham,2,0,0,0,2
Shuhana,2,0,0,0,2
Florent,0,0,2,0,2
Cherri,1,0,1,0,2
Bolivar,0,0,2,0,2
Aanchal,1,0,1,0,2
Chetina,2,0,0,0,2
Chewie,0,0,2,0,2
Flyn,2,0,0,0,2
Tom & Reina,1,0,1,0,2
正川,0,0,2,0,2
Finola,1,0,1,0,2
Finely,0,0,2,0,2
Filippo,1,0,1,0,2
Alex And Zeena,0,0,2,0,2
Alexander M,2,0,0,0,2
Sibel,1,0,0,1,2
Alexey,2,0,0,0,2
Guilherme,2,0,0,0,2
Alexi,0,0,2,0,2
Alfonso,2,0,0,0,2
A.G.,0,0,2,0,2
Guirlaine,2,0,0,0,2
Sibylle,2,0,0,0,2
Ferran,0,0,2,0,2
Firas,1,0,1,0,2
Yvelisse,2,0,0,0,2
Cam,2,0,0,0,2
Cami,2,0,0,0,2
Chieko,2,0,0,0,2
Alessio,2,0,0,0,2
Flo,1,0,1,0,2
Fer,1,0,1,0,2
Cara,1,0,1,0,2
Cheyenne,2,0,0,0,2
浩,0,0,2,0,2
Tom/Alissa,2,0,0,0,2
Flavia,1,0,1,0,2
Carey,1,0,1,0,2
Guest Care,0,0,2,0,2
Aaash,2,0,0,0,2
Alex & Alena,0,0,2,0,2
AJbnb,2,0,0,0,2
Sidiq,1,0,1,0,2
Chito And Xavier,2,0,0,0,2
Aleksander,2,0,0,0,2
Ali & SweetPea,1,0,0,1,2
Greer,1,0,1,0,2
Franco,2,0,0,0,2
Chris & Megan,0,0,2,0,2
Che,1,0,1,0,2
Tomorrow’s,0,0,2,0,2
Abdes,0,0,2,0,2
Shakeel,0,0,2,0,2
Tommi,2,0,0,0,2
Ugur & Sarina,1,0,1,0,2
Alberto Y Candela,0,0,2,0,2
Bonheur,2,0,0,0,2
Ǧani,2,0,0,0,2
Alden,2,0,0,0,2
Sihan,0,0,2,0,2
Francisca,1,0,1,0,2
Francois,1,0,1,0,2
Shivani,2,0,0,0,2
Zak,1,0,1,0,2
Zakarya,0,0,2,0,2
Fausto,2,0,0,0,2
Frederic,1,0,1,0,2
Freda,2,0,0,0,2
Silva,1,0,1,0,2
Francynela,0,0,2,0,2
Bonnie,1,0,1,0,2
Aliz Hotel Times Square,0,0,2,0,2
Alain,2,0,0,0,2
Franncis,2,0,0,0,2
Carlman,2,0,0,0,2
Can,0,0,2,0,2
Alaa,0,0,2,0,2
Shamair,0,0,2,0,2
Chris And Zach,2,0,0,0,2
Cheng-Yu,0,0,2,0,2
Ulanbatir,0,0,2,0,2
Candi,1,0,1,0,2
Fazi,1,0,0,1,2
Bond Townhouse,2,0,0,0,2
Cheri,1,0,1,0,2
Fati,2,0,0,0,2
Federica,2,0,0,0,2
Zamena,2,0,0,0,2
Showana And Denzil,2,0,0,0,2
Grayson,0,0,2,0,2
Freija,0,0,2,0,2
Fola,0,0,2,0,2
Chiz,0,0,2,0,2
Cherna,2,0,0,0,2
Alizé,0,0,2,0,2
Caitlyn,1,0,1,0,2
Ale,1,0,1,0,2
Shomari,0,0,2,0,2
Umar,1,0,1,0,2
Chloé,2,0,0,0,2
Bismillah,2,0,0,0,2
Tomi,2,0,0,0,2
Fran,1,0,1,0,2
Zahra,2,0,0,0,2
Fayth,0,0,2,0,2
Zakaria,0,0,2,0,2
Zahida,2,0,0,0,2
Fatih,0,0,2,0,2
Vero,1,0,1,0,2
Oluchi,0,0,1,0,1
Wassym,0,0,1,0,1
Paul And Debra,0,0,1,0,1
Olivia Loksing,1,0,0,0,1
Wasim,0,0,1,0,1
Valery,1,0,0,0,1
Valeryia,1,0,0,0,1
Olubode Shawn,1,0,0,0,1
Washington,1,0,0,0,1
Warren,1,0,0,0,1
Paul & Ewa,1,0,0,0,1
Peggy,0,0,1,0,1
Whit,1,0,0,0,1
PeiYoung,0,0,1,0,1
Olta,0,0,1,0,1
Wiebke,1,0,0,0,1
Olman,1,0,0,0,1
Val &Yuko,0,0,1,0,1
Uli,0,0,1,0,1
Uliana,1,0,0,0,1
Vadwatie,0,0,1,0,1
Valerie Lynn-McDonough,1,0,0,0,1
Warsan,0,0,1,0,1
Odaro,1,0,0,0,1
Peg,1,0,0,0,1
Paul A,0,0,1,0,1
Valerio,1,0,0,0,1
Ulker,1,0,0,0,1
Wellz,0,0,1,0,1
Odile,1,0,0,0,1
Urmat,0,0,1,0,1
Weipeng,0,0,1,0,1
Umberto,1,0,0,0,1
Pavle,1,0,0,0,1
Wei Wen,1,0,0,0,1
Peace,1,0,0,0,1
Olenka,1,0,0,0,1
Okhela,1,0,0,0,1
Peaches,1,0,0,0,1
Wenfei,1,0,0,0,1
Olepa,0,0,1,0,1
Wenqing,1,0,0,0,1
Olesia,1,0,0,0,1
Peach,0,0,1,0,1
Paulos,1,0,0,0,1
Unue,0,0,1,0,1
Oksy,1,0,0,0,1
Una,0,0,1,0,1
Payman,1,0,0,0,1
Umut Can,0,0,1,0,1
Payal,1,0,0,0,1
Wanfang,0,0,1,0,1
Wel,1,0,0,0,1
Wendi,0,0,1,0,1
Olawale,1,0,0,0,1
Olabisi,1,0,0,0,1
Wendee,0,0,1,0,1
Wellington Hotel,0,1,0,0,1
Payam,1,0,0,0,1
Wempy,1,0,0,0,1
Wellstead,1,0,0,0,1
Olai,1,0,0,0,1
Urmny,1,0,0,0,1
Pearl,0,0,1,0,1
Paul And Gia,1,0,0,0,1
Wesly/Jessica,0,0,1,0,1
Wesleyan,0,0,1,0,1
Olive,1,0,0,0,1
Uzy,0,0,1,0,1
Ofir,1,0,0,0,1
Wayde,1,0,0,0,1
Wesly,1,0,0,0,1
Ulviyya,1,0,0,0,1
Urs,0,0,1,0,1
Watson,1,0,0,0,1
Ulrika,0,0,1,0,1
Olivia & Kyle,1,0,0,0,1
VK & Div,1,0,0,0,1
Odile And Mathieu,0,0,1,0,1
West Village,1,0,0,0,1
Ofrit,1,0,0,0,1
Ofry,1,0,0,0,1
Olim,1,0,0,0,1
Oladunni,1,0,0,0,1
Pedro Pablo,0,0,1,0,1
Uzi,1,0,0,0,1
Utku,0,0,1,0,1
Pedro J,1,0,0,0,1
Oge,0,0,1,0,1
Uly,0,0,1,0,1
Olia,0,0,1,0,1
Wes,0,0,1,0,1
Umang,1,0,0,0,1
Wayne Keith,1,0,0,0,1
Webster,1,0,0,0,1
Weeks,0,0,0,1,1
Weez,0,0,1,0,1
Valissa,1,0,0,0,1
Verona,0,0,1,0,1
Walton,0,0,1,0,1
Vinzenz,0,0,1,0,1
Vinette,0,0,1,0,1
Veljko,1,0,0,0,1
Vineet,1,0,0,0,1
Oscar & Johanna,1,0,0,0,1
Vinciane,1,0,0,0,1
Panid,1,0,0,0,1
Pancho,1,0,0,0,1
Vincenza,0,0,1,0,1
Oshane,1,0,0,0,1
Osnyc,1,0,0,0,1
Panayiota,1,0,0,0,1
Panagiotis,0,0,1,0,1
Osten,1,0,0,0,1
Pamila,1,0,0,0,1
Vin,0,0,1,0,1
Osvaldo,1,0,0,0,1
Vimal,1,0,0,0,1
Pamella,0,0,1,0,1
Osyma,1,0,0,0,1
Velvet,1,0,0,0,1
Oteri,1,0,0,0,1
Veleda And Orion,1,0,0,0,1
Orli,0,0,1,0,1
Palvasha,0,0,1,0,1
Vela,1,0,0,0,1
Vaughn,1,0,0,0,1
Vcybil,0,0,1,0,1
Virginia & Steve,1,0,0,0,1
Virgil,1,0,0,0,1
Orhun,0,0,1,0,1
Ved,0,0,1,0,1
Viran,0,0,1,0,1
Pao Sharon,0,0,1,0,1
Viramo,0,0,1,0,1
Orkhan,1,0,0,0,1
Orlan,1,0,0,0,1
Veej,1,0,0,0,1
Vir,0,0,1,0,1
Panya,1,0,0,0,1
Violette,1,0,0,0,1
Violetta,1,0,0,0,1
Violet,1,0,0,0,1
Viola,1,0,0,0,1
Orlee,1,0,0,0,1
Vio,0,0,1,0,1
Panthea,1,0,0,0,1
Othman,1,0,0,0,1
Otis,1,0,0,0,1
Vass,1,0,0,0,1
Vika,1,0,0,0,1
Vijay,0,0,1,0,1
Verena  And Dylan,1,0,0,0,1
Vidalyn,0,0,1,0,1
Ozzie,1,0,0,0,1
Victoria And Juliana,1,0,0,0,1
Painter,1,0,0,0,1
Vianney,0,0,1,0,1
Vi,1,0,0,0,1
Veton,1,0,0,0,1
Paget,1,0,0,0,1
Veta,0,0,1,0,1
Verna,0,0,1,0,1
Vernasta,1,0,0,0,1
Vernette,1,0,0,0,1
Vesna,1,0,0,0,1
Verun,1,0,0,0,1
Veronique,1,0,0,0,1
Veronica And Tyler,1,0,0,0,1
PM Events Worldwide Services,1,0,0,0,1
Paco & Pamela,1,0,0,0,1
Paayal,0,0,1,0,1
Vik,1,0,0,0,1
Ozkan,0,0,1,0,1
Ouafi,1,0,0,0,1
Paisha,0,0,1,0,1
Oumar,1,0,0,0,1
Villa De Tano LLC,1,0,0,0,1
Oumarou,1,0,0,0,1
Vilena,1,0,0,0,1
Out Of The Box,1,0,0,0,1
Outpost,0,0,0,1,1
Paloma & German,1,0,0,0,1
Odalys,1,0,0,0,1
Vil,0,0,0,1,1
Veneisha,1,0,0,0,1
Viktoriya,0,0,1,0,1
Venera,0,0,1,0,1
Palmer And Isobel,1,0,0,0,1
Venture,1,0,0,0,1
Venus,1,0,0,0,1
Vikram,1,0,0,0,1
Oyenbhen Joy,1,0,0,0,1
Palma,1,0,0,0,1
Veola,0,0,1,0,1
Pal,1,0,0,0,1
Ozge,0,0,1,0,1
Papis,1,0,0,0,1
Paranee,1,0,0,0,1
Walkiris,0,0,1,0,1
Wakenna,1,0,0,0,1
Omwattie,1,0,0,0,1
Vance,1,0,0,0,1
Vander,1,0,0,0,1
Passang,1,0,0,0,1
Pasha,1,0,0,0,1
Onaedo,1,0,0,0,1
One Fine BnB,1,0,0,0,1
Vandra,0,0,1,0,1
Onedeige,0,0,1,0,1
Wai-Yee,1,0,0,0,1
Oneil,1,0,0,0,1
Wai,0,0,1,0,1
Paschal,0,0,1,0,1
Vane,1,0,0,0,1
Vanette,1,0,0,0,1
Wada,1,0,0,0,1
Waciuma,0,0,1,0,1
Waahid,0,0,1,0,1
W Sarah,1,0,0,0,1
Partha,0,0,1,0,1
W,1,0,0,0,1
Wajahat Siddiqui,1,0,0,0,1
Patience And Mayya,1,0,0,0,1
Vanina,0,0,1,0,1
Vana,1,0,0,0,1
Pattricia,1,0,0,0,1
Oluwamodupe,1,0,0,0,1
Valleix,0,0,1,0,1
Walkiria,0,0,1,0,1
Valley,1,0,0,0,1
Patrycja,1,0,0,0,1
Oluwaseyi,1,0,0,0,1
Patrizio,1,0,0,0,1
Olympia,1,0,0,0,1
Patrik,1,0,0,0,1
Valmik,1,0,0,0,1
Waleska,1,0,0,0,1
Valor,1,0,0,0,1
Omala,1,0,0,0,1
Walesca,1,0,0,0,1
Waldy,1,0,0,0,1
Patricia Molina,0,0,1,0,1
Omar And Kareema,1,0,0,0,1
Omari,1,0,0,0,1
Omelie,1,0,0,0,1
Valvil,0,0,1,0,1
Parth,1,0,0,0,1
Véronique,0,0,1,0,1
Paras,0,0,1,0,1
Vasili,1,0,0,0,1
Vixen,1,0,0,0,1
Vivivn,1,0,0,0,1
Pariis,0,0,1,0,1
Vivienne,1,0,0,0,1
Vivien,1,0,0,0,1
Vivianne,1,0,0,0,1
Viviane,0,0,1,0,1
Vasilios,1,0,0,0,1
Viveca,1,0,0,0,1
Ora,0,0,1,0,1
Viva,0,0,1,0,1
Vito & Miriam,1,0,0,0,1
Vasilisa,1,0,0,0,1
Paresh,1,0,0,0,1
Pardis,1,0,0,0,1
Vitaly And Lena,1,0,0,0,1
Vitaly,0,0,1,0,1
Vitalina,1,0,0,0,1
Vita,0,0,1,0,1
Orel,1,0,0,0,1
Vishal,1,0,0,0,1
Vasiliki,0,0,1,0,1
Vlada,1,0,0,0,1
Onusa,1,0,0,0,1
Parish,0,0,1,0,1
Vapee,1,0,0,0,1
Vytaute,1,0,0,0,1
Vyacheslav,1,0,0,0,1
Parnell,1,0,0,0,1
Onyedikachi,1,0,0,0,1
Vuong,0,0,1,0,1
Onyeka,1,0,0,0,1
Varun,1,0,0,0,1
Vriana,1,0,0,0,1
Oof,1,0,0,0,1
Voxie,1,0,0,0,1
Parker,1,0,0,0,1
Oona,0,0,1,0,1
Volker,1,0,0,0,1
Voisin,0,0,1,0,1
Oorja,1,0,0,0,1
Vasb,1,0,0,0,1
Vashti,0,0,1,0,1
Opera House Hotel,0,1,0,0,1
Vasi,1,0,0,0,1
Vladislav,1,0,0,0,1
Vartan,1,0,0,0,1
Yamin,1,0,0,0,1
Wilboyd Earl,0,0,1,0,1
Zane And Annie,1,0,0,0,1
Zaid,1,0,0,0,1
Zaineb,0,0,1,0,1
Natasja,1,0,0,0,1
Natan,0,0,1,0,1
Zainul,1,0,0,0,1
Zaira E,0,0,1,0,1
Zaire,1,0,0,0,1
Zaka,1,0,0,0,1
Natalie And Dan,1,0,0,0,1
Zaliqua,1,0,0,0,1
Zam,1,0,0,0,1
Zaman,0,0,1,0,1
Zandy,1,0,0,0,1
Natal,1,0,0,0,1
Natacha,0,0,1,0,1
Zahira,1,0,0,0,1
Zahi,0,0,1,0,1
Zaher,1,0,0,0,1
Naum & Alexandra,1,0,0,0,1
Nawar,1,0,0,0,1
Navin,1,0,0,0,1
Zachary Robert,1,0,0,0,1
Naveen,1,0,0,0,1
Navarra,0,0,1,0,1
Nauman,1,0,0,0,1
Nattalia,0,0,1,0,1
Nathan And Brock,0,0,1,0,1
Natsuko,0,0,1,0,1
Native,0,0,1,0,1
Zackery,1,0,0,0,1
Nati,1,0,0,0,1
Zahava,0,0,1,0,1
Nathanael,1,0,0,0,1
Zane,0,0,1,0,1
Zani,0,0,1,0,1
Zere,1,0,0,0,1
Nassim,1,0,0,0,1
Nardo,0,0,1,0,1
Naomie,0,0,1,0,1
Zeid,1,0,0,0,1
Naomi Beth,1,0,0,0,1
Zeina,1,0,0,0,1
Zek,1,0,0,0,1
Nanonte,0,0,1,0,1
Zeleke,1,0,0,0,1
Nano,1,0,0,0,1
Zelvia,0,0,1,0,1
Nani,1,0,0,0,1
Nando,1,0,0,0,1
Nandanie,1,0,0,0,1
Nancy L.,0,0,1,0,1
Zenobia,1,0,0,0,1
Zedal,0,0,1,0,1
Nardys,1,0,0,0,1
Zed,1,0,0,0,1
Narul,1,0,0,0,1
Nasreen,1,0,0,0,1
Nasim,1,0,0,0,1
Nashita,1,0,0,0,1
Nash,1,0,0,0,1
Nas,1,0,0,0,1
Zare,1,0,0,0,1
Zaydee Ann,0,0,1,0,1
Zdzislawa,0,0,1,0,1
Zaza,0,0,1,0,1
Zbigniew,1,0,0,0,1
Nargiza,1,0,0,0,1
Nargiz,0,0,1,0,1
Narges,1,0,0,0,1
Naressa,1,0,0,0,1
Nayan,1,0,0,0,1
Nayary,0,0,1,0,1
Zachariah And Jess,1,0,0,0,1
Nayoung,0,0,1,0,1
Yuichi,0,0,1,0,1
Yujie,0,0,1,0,1
Nelly,0,0,1,0,1
Yujiro,0,0,1,0,1
Nells,1,0,0,0,1
Nellita,1,0,0,0,1
Yujun,0,0,1,0,1
Yukiko,0,0,1,0,1
Yuko,0,0,1,0,1
Nell,1,0,0,0,1
Nelissa,0,0,1,0,1
Nelima,0,0,1,0,1
Yuliang,0,0,1,0,1
Yuliia,1,0,0,0,1
Nela,1,0,0,0,1
Nena,0,0,1,0,1
Neni,1,0,0,0,1
Neomi,1,0,0,0,1
Nessa,0,0,1,0,1
Yu-Ting,1,0,0,0,1
Nestor,1,0,0,0,1
Yuanwei & Veronica,1,0,0,0,1
Yuanwen,1,0,0,0,1
Yuanyuan,1,0,0,0,1
Nessim,0,0,1,0,1
Ness,1,0,0,0,1
Nephy,1,0,0,0,1
Yuedi,0,0,1,0,1
Neriza,1,0,0,0,1
Yueying,0,0,1,0,1
Nerissa,1,0,0,0,1
Nerenda,0,0,1,0,1
Yuhee,0,0,1,0,1
Yuliya,1,0,0,0,1
Neit,0,0,1,0,1
Neil & Katie,1,0,0,0,1
Ndelea,1,0,0,0,1
Yuuki,1,0,0,0,1
Yuxi,0,0,1,0,1
Neanna,1,0,0,0,1
Yuxin,0,0,1,0,1
Yva,1,0,0,0,1
Yvan,1,0,0,0,1
Nazmul,1,0,0,0,1
Yutian,0,0,1,0,1
Nazleen,1,0,0,0,1
Yáng,0,0,1,0,1
Nazar,0,0,1,0,1
Zabeeda,1,0,0,0,1
Zabrina,1,0,0,0,1
Zach And Emma,1,0,0,0,1
Yuting,0,0,1,0,1
Yurа,1,0,0,0,1
Yumi,0,0,0,1,1
Nehemie,1,0,0,0,1
Neida,0,0,1,0,1
Yun,1,0,0,0,1
Yuna,1,0,0,0,1
Nehprii,1,0,0,0,1
Nehia,0,0,1,0,1
Nehi,0,0,1,0,1
Yuria,0,0,0,1,1
Neelu,1,0,0,0,1
Yurika,0,0,1,0,1
Neh,1,0,0,0,1
Yurina,0,0,1,0,1
Negar,1,0,0,0,1
Yuriy,1,0,0,0,1
Yury,0,0,1,0,1
Nancy And David,1,0,0,0,1
Zeta,1,0,0,0,1
Wilda,1,0,0,0,1
İsmail,0,0,1,0,1
Zuzi,0,0,1,0,1
Zyad,1,0,0,0,1
Mykyta,0,0,1,0,1
Mykola,0,0,1,0,1
Mykle-Kane,1,0,0,0,1
Zyn,1,0,0,0,1
Myeta,0,0,1,0,1
Myesha,0,0,1,0,1
Àngel,1,0,0,0,1
Mychelle,0,0,1,0,1
Myah,1,0,0,0,1
Myaa,0,0,1,0,1
Mya,0,0,1,0,1
Ángel,1,0,0,0,1
Ángela,1,0,0,0,1
Mylene,1,0,0,0,1
Zuwanda,1,0,0,0,1
Zuriel,1,0,0,0,1
Myrtle,1,0,0,0,1
Zsolt,0,0,1,0,1
N,0,0,1,0,1
M’stays,0,0,1,0,1
Zuben,1,0,0,0,1
Zuffina,1,0,0,0,1
Mysia,0,0,1,0,1
Myrta,0,0,1,0,1
Mymy,1,0,0,0,1
Zulay,0,0,1,0,1
Zulinette,1,0,0,0,1
Zulu & Andy,0,0,1,0,1
Myrma,1,0,0,0,1
Myra,1,0,0,0,1
Zuri,0,0,1,0,1
Öykü,0,0,1,0,1
Ирина,1,0,0,0,1
Zev,1,0,0,0,1
Mustafa,1,0,0,0,1
Mubin,1,0,0,0,1
玉姗,0,0,1,0,1
Muaz,1,0,0,0,1
Muammer Sergen,0,0,1,0,1
Mslisa,1,0,0,0,1
Ms. Yvonne,0,0,1,0,1
福田,1,0,0,0,1
Ms. Lee,1,0,0,0,1
Ms. H,0,0,1,0,1
耀阳,1,0,0,0,1
颖,0,0,1,0,1
단비,1,0,0,0,1
Ms.,1,0,0,0,1
Ms Sunny,0,0,1,0,1
Ms Charles,1,0,0,0,1
槟利,0,0,1,0,1
林振,0,0,1,0,1
李,0,0,1,0,1
佳,0,0,1,0,1
Лена,1,0,0,0,1
Лима,0,0,1,0,1
Мария,0,0,1,0,1
Тest,1,0,0,0,1
ゆりあ & Fredy,0,0,1,0,1
Muslum,0,0,1,0,1
威,0,0,1,0,1
Murad,1,0,0,0,1
Mursheda,1,0,0,0,1
媛媛 Michelle,0,0,1,0,1
Muriel,1,0,0,0,1
孙浩,0,0,1,0,1
景詒,0,0,1,0,1
Murah,1,0,0,0,1
N Associates,1,0,0,0,1
N-And-A,1,0,0,0,1
N.L.,0,0,1,0,1
Zoya,1,0,0,0,1
Nailton,0,0,1,0,1
Naief,1,0,0,0,1
Naichen,0,0,1,0,1
Nahuel,0,0,1,0,1
Zhen Zhen,1,0,0,0,1
Nahom,0,0,1,0,1
Zheni,1,0,0,0,1
Zhenyu,0,0,0,1,1
Zhijian,0,0,1,0,1
ZhongJei,0,0,1,0,1
Naftoli,1,0,0,0,1
Naftaly,1,0,0,0,1
Zhou,0,0,1,0,1
Zhuo,0,0,1,0,1
Naftali,1,0,0,0,1
Zheliang,1,0,0,0,1
Zhaoyun,1,0,0,0,1
Zhaoyu,0,0,1,0,1
Naliaka,1,0,0,0,1
Zevel,1,0,0,0,1
Zexi,1,0,0,0,1
Nan,0,0,1,0,1
Namita,0,0,1,0,1
Nami,0,0,1,0,1
Zeynep,1,0,0,0,1
Najmah,1,0,0,0,1
Naiomy,0,0,1,0,1
Najat,1,0,0,0,1
Nairoby,1,0,0,0,1
Zhaniya,1,0,0,0,1
Zhaoping,0,0,1,0,1
Nairee,0,0,1,0,1
Zhaoyan,0,0,1,0,1
Nafisah,0,0,1,0,1
Nafees,1,0,0,0,1
Zichen,0,0,1,0,1
Na'Im,0,0,1,0,1
Zita,0,0,1,0,1
Zizi,1,0,0,0,1
Zo,0,0,1,0,1
Zoesarah (And) Anu,1,0,0,0,1
Naafeh,1,0,0,0,1
Naa-Sakle,1,0,0,0,1
NYC Paradise Oasis,1,0,0,0,1
Nacho,0,0,1,0,1
Zoila,0,0,1,0,1
Zoilo,1,0,0,0,1
Zoltán,0,0,1,0,1
Zora & Chris,1,0,0,0,1
NY Blue House,1,0,0,0,1
Zoryana,1,0,0,0,1
Nachel,1,0,0,0,1
Nadalie,0,0,1,0,1
Ziggi,1,0,0,0,1
Zinaida,1,0,0,0,1
Naeem,1,0,0,0,1
Ziggy & Rome,1,0,0,0,1
Nadjah,1,0,0,0,1
Nadja Verena,1,0,0,0,1
Zina,1,0,0,0,1
Nadine & Jean-Louis,1,0,0,0,1
Zing,1,0,0,0,1
Nadav,1,0,0,0,1
Nadie,1,0,0,0,1
Nadia And Tarek,1,0,0,0,1
Ziporah,1,0,0,0,1
Ziporen,0,0,1,0,1
Nadege & Charles,1,0,0,0,1
Ziqi,1,0,0,0,1
Yu Qun,1,0,0,0,1
Ysmell,1,0,0,0,1
Neto,1,0,0,0,1
Noah And Kristi,1,0,0,0,1
Noelia,0,0,1,0,1
Xionghui,1,0,0,0,1
Xiu,0,0,1,0,1
XnL,1,0,0,0,1
Xris,0,0,1,0,1
Noe,1,0,0,0,1
Xristina&Keith,1,0,0,0,1
Xristos,0,0,1,0,1
Xu,0,0,0,1,1
Nodar,1,0,0,0,1
Xuan,0,0,1,0,1
Y&O,1,0,0,0,1
Nobella,1,0,0,0,1
Yacine,1,0,0,0,1
Yacov,1,0,0,0,1
Noelky,1,0,0,0,1
Xinyu,0,0,1,0,1
Noelmy,1,0,0,0,1
Xinhua,0,0,1,0,1
Xihuitl Juliette,1,0,0,0,1
Nona,1,0,0,0,1
Noma,1,0,0,0,1
XinOu,0,0,1,0,1
Xina & Adam,1,0,0,0,1
Xinchen,1,0,0,0,1
Nohora V,0,0,1,0,1
Xinyan,0,0,1,0,1
Nofit,1,0,0,0,1
Xinhui,0,0,1,0,1
Nofar,1,0,0,0,1
Xinxin,0,0,1,0,1
Noemie,1,0,0,0,1
Noemi,1,0,0,0,1
Noam,1,0,0,0,1
Yael (Alex),1,0,0,0,1
Nevan,0,0,1,0,1
Yael / Mair,1,0,0,0,1
Pelin,0,0,1,0,1
Yan Yun,0,0,1,0,1
Yaneli,0,0,1,0,1
Nitish,1,0,0,0,1
Yang & Su,1,0,0,0,1
Yangbing,0,0,1,0,1
Nita And Eka,1,0,0,0,1
Nita,1,0,0,0,1
Yanilsa,0,0,1,0,1
Nishi,0,0,1,0,1
Nisheka,1,0,0,0,1
Yanina,0,0,1,0,1
Yanique,1,0,0,0,1
Yaniris,0,0,1,0,1
Nirmal,1,0,0,0,1
Yamile,1,0,0,0,1
Yamid,0,0,1,0,1
Yalon,1,0,0,0,1
Nnachi,0,0,1,0,1
Noadja,0,0,1,0,1
Yaevick,1,0,0,0,1
Yaffa,1,0,0,0,1
Yago,0,0,1,0,1
NoLimit,1,0,0,0,1
Nneoma,1,0,0,0,1
Yaimara,0,0,1,0,1
Niveen,1,0,0,0,1
Nkoli,1,0,0,0,1
Nizar,0,0,1,0,1
Niyi,0,0,1,0,1
Niya,0,0,1,0,1
Yale,1,0,0,0,1
Nixie & Hai,0,0,0,1,1
Noni,1,0,0,0,1
Nonie,0,0,1,0,1
Xiaozhi,1,0,0,0,1
Xiaoyun,1,0,0,0,1
O'Dell,1,0,0,0,1
O J,1,0,0,0,1
Winifer,0,0,1,0,1
Nïco,1,0,0,0,1
Winnie,1,0,0,0,1
Nyree,1,0,0,0,1
Winona,0,0,1,0,1
Winter,0,0,1,0,1
Nyla,1,0,0,0,1
"Nykaz, Llc",1,0,0,0,1
Winthan,1,0,0,0,1
Nyesha,1,0,0,0,1
Nyasha,0,0,1,0,1
Nyariang,0,0,1,0,1
Wisdom Global Realty,1,0,0,0,1
Wing,1,0,0,0,1
O.,0,0,1,0,1
O.D.,1,0,0,0,1
Ocean Hill,1,0,0,0,1
Odalina,1,0,0,0,1
Wilder,1,0,0,0,1
Odali,0,0,1,0,1
Odaine,1,0,0,0,1
Will & Kim,1,0,0,0,1
Will & Yenn,0,0,1,0,1
Willem,0,0,1,0,1
Winda,1,0,0,0,1
Ocean,0,0,1,0,1
Obed,1,0,0,0,1
Oasis,1,0,0,0,1
Willow,1,0,0,0,1
Oakley,1,0,0,0,1
Wilson Daniel,0,0,1,0,1
Wish,0,0,1,0,1
Nuria,0,0,1,0,1
Nuoya,1,0,0,0,1
Noralma P,0,0,1,0,1
Norga,1,0,0,0,1
Wycliffe,1,0,0,0,1
Noreen,1,0,0,0,1
Wynn,0,0,1,0,1
Xavi,1,0,0,0,1
Xela,1,0,0,0,1
XiWei,0,0,1,0,1
Noriko,1,0,0,0,1
Xiao Yan,0,0,1,0,1
Noralea,0,0,1,0,1
Norah,1,0,0,0,1
Xiaodi,0,0,1,0,1
Xiaowen,0,0,1,0,1
Noor,0,0,1,0,1
Nori,1,0,0,0,1
Wuraola,1,0,0,0,1
Wismick,1,0,0,0,1
Noza,1,0,0,0,1
Nuno,0,0,1,0,1
Numbers Studios,1,0,0,0,1
Wj,0,0,1,0,1
Wolfe,1,0,0,0,1
Ntifafa Akoko,1,0,0,0,1
Noëmi,0,0,1,0,1
Wonu,0,0,1,0,1
Wright,1,0,0,0,1
Novi,1,0,0,0,1
Wowa,0,0,1,0,1
Noushin,1,0,0,0,1
Wray,1,0,0,0,1
Noubar,1,0,0,0,1
Notoya,1,0,0,0,1
Niral,0,0,1,0,1
Yanru,1,0,0,0,1
Nir And Ari,1,0,0,0,1
Nicoletta,1,0,0,0,1
Nick & D.,1,0,0,0,1
Yiselle,1,0,0,0,1
Yiska,1,0,0,0,1
Yiyi,1,0,0,0,1
Yoann,1,0,0,0,1
Nichola,0,0,1,0,1
Nicho,1,0,0,0,1
Yochi,0,0,1,0,1
Nichelina,1,0,0,0,1
Yoel,1,0,0,0,1
Nichele,1,0,0,0,1
Yogini,0,0,1,0,1
Yogita,0,0,1,0,1
Yoki,0,0,1,0,1
Niccolo,0,0,1,0,1
Yiran,1,0,0,0,1
Nick And Noémie,1,0,0,0,1
Yiping,0,0,1,0,1
Yiming (Steven),0,0,1,0,1
Nicole And Nathan,1,0,0,0,1
Nicole And Jason,1,0,0,0,1
Yifat,0,0,1,0,1
Yigit,0,0,1,0,1
Yiling,0,0,1,0,1
Yim,1,0,0,0,1
Nicolae,1,0,0,0,1
Yiou,0,0,1,0,1
Yimka,0,0,1,0,1
Yin,1,0,0,0,1
Ying,0,0,1,0,1
Nicki,1,0,0,0,1
Ying Ying,0,0,1,0,1
Yinhang,1,0,0,0,1
Niccol,1,0,0,0,1
Yoko,1,0,0,0,1
Nicci,1,0,0,0,1
New,1,0,0,0,1
Youl,0,0,1,0,1
Youness,1,0,0,0,1
Neysa,0,0,1,0,1
Newyorkroomwithaview,0,0,1,0,1
Newton,0,0,1,0,1
NewYorker,0,0,1,0,1
Young Jean,1,0,0,0,1
Yoshimasa,0,0,1,0,1
Your Best,1,0,0,0,1
Your Fave,1,0,0,0,1
Your Hostess,1,0,0,0,1
Neviah,1,0,0,0,1
Yovel,1,0,0,0,1
Nevena,1,0,0,0,1
Yosub,1,0,0,0,1
Nezih,1,0,0,0,1
Niara,0,0,1,0,1
Nhia,0,0,1,0,1
Yonathan,1,0,0,0,1
Niall,1,0,0,0,1
Yone,0,0,1,0,1
Yonelle,1,0,0,0,1
Yonette,1,0,0,0,1
Yong,0,0,1,0,1
Yong Hee,1,0,0,0,1
Nezzy,0,0,1,0,1
Yongsoo,1,0,0,0,1
Yordanos IPG LLC,1,0,0,0,1
Yoseph,0,0,0,1,1
Ngoyi,1,0,0,0,1
Ngone,1,0,0,0,1
Yoshihisa,0,0,1,0,1
Nicole Lavonne,1,0,0,0,1
Yibin,1,0,0,0,1
Yanyan,0,0,1,0,1
Yi Qun,1,0,0,0,1
Yashaddai,1,0,0,0,1
Yasheeva,1,0,0,0,1
Nilda,1,0,0,0,1
Yasin,0,0,1,0,1
Nikos,1,0,0,0,1
Yasir,1,0,0,0,1
Nikolina,1,0,0,0,1
Yasmeen,0,0,1,0,1
Yasser,0,0,1,0,1
Yassine,0,0,1,0,1
Yassir,1,0,0,0,1
Nikolaos,1,0,0,0,1
Yatmui,1,0,0,0,1
Yauheniya,0,0,1,0,1
Yavuz,0,0,1,0,1
Yash,1,0,0,0,1
Nile,0,0,1,0,1
Nilita,1,0,0,0,1
Yari,1,0,0,0,1
Nino,1,0,0,0,1
Ninja & Sung,1,0,0,0,1
Ninja,1,0,0,0,1
Nini,1,0,0,0,1
Ninette,1,0,0,0,1
Yao,1,0,0,0,1
Nin,1,0,0,0,1
Nils,0,0,1,0,1
Yaritza,1,0,0,0,1
Nim,1,0,0,0,1
Yariv,1,0,0,0,1
Nilufa,1,0,0,0,1
Yarong,1,0,0,0,1
Nilu,1,0,0,0,1
Yaw,1,0,0,0,1
Yawen,0,0,1,0,1
Yayel'S,1,0,0,0,1
Yetubnesh,1,0,0,0,1
Nika Nurkyz,0,0,1,0,1
Niji,0,0,1,0,1
Yenpo,0,0,1,0,1
Yero,0,0,1,0,1
Yesbelt,0,0,1,0,1
Yessica,1,0,0,0,1
Nigar,0,0,1,0,1
Yeniffer,0,0,1,0,1
Niecia,1,0,0,0,1
Nidia,0,0,1,0,1
Yeun-Ah,0,0,1,0,1
Nidal,0,0,1,0,1
Yezica,1,0,0,0,1
Nicollé And Craig,1,0,0,0,1
Yennifer,1,0,0,0,1
Nikali,1,0,0,0,1
Nikky,0,0,1,0,1
Nikia,1,0,0,0,1
Nikki Jo,1,0,0,0,1
Yazmiyn,0,0,1,0,1
Ye Qin,1,0,0,0,1
Yeelen,1,0,0,0,1
Yehudah,1,0,0,0,1
Nikima,1,0,0,0,1
Yeison,1,0,0,0,1
Yenella,1,0,0,0,1
Yekaterina,0,0,1,0,1
Nikhil,1,0,0,0,1
Yelhan,0,0,1,0,1
Yemane,1,0,0,0,1
Yen,1,0,0,0,1
Nikeisha,1,0,0,0,1
Peiyu,0,0,1,0,1
Shafeqa,1,0,0,0,1
Ujunwa,0,0,1,0,1
Ruohao,0,0,1,0,1
Skye,0,0,1,0,1
Skye And Jeremy,1,0,0,0,1
Ruko B,1,0,0,0,1
Ruishu,0,0,1,0,1
Rui Hua,1,0,0,0,1
Skyloft Homes,1,0,0,0,1
Slavo,1,0,0,0,1
Sloane,1,0,0,0,1
Smart,1,0,0,0,1
Smyles And Diara,1,0,0,0,1
Rueben,0,0,1,0,1
Sne,0,0,1,0,1
Snezhana,1,0,0,0,1
Snoopy,1,0,0,0,1
So-Jung,0,0,1,0,1
Skippy,1,0,0,0,1
Ruokun,0,0,1,0,1
Rut,1,0,0,0,1
Rupan,0,0,1,0,1
Rustam,1,0,0,0,1
Russi,1,0,0,0,1
Sixtus,0,0,1,0,1
Sixty Les,0,1,0,0,1
Siya,0,0,1,0,1
Siyani,1,0,0,0,1
Rushil,1,0,0,0,1
Rushella,0,0,1,0,1
Siyi,0,0,1,0,1
Sk,1,0,0,0,1
Rushell,1,0,0,0,1
Skip,0,0,1,0,1
Rupi,1,0,0,0,1
Ruperto,1,0,0,0,1
Rupert,1,0,0,0,1
Rudolf,1,0,0,0,1
Rudnei,1,0,0,0,1
Rudi,0,0,1,0,1
Rubén,1,0,0,0,1
Solonje,1,0,0,0,1
Roxane,0,0,1,0,1
Somewhere SIlk,1,0,0,0,1
Roxana Andreea,1,0,0,0,1
Sommer,1,0,0,0,1
Rove,1,0,0,0,1
Roula,1,0,0,0,1
Somrit,0,0,1,0,1
Rotem,1,0,0,0,1
Son,0,0,1,0,1
Sonche,1,0,0,0,1
Roslyn,1,0,0,0,1
Roslene,1,0,0,0,1
Rosine,0,0,1,0,1
Sondra,0,0,1,0,1
Solmarie,0,0,1,0,1
Roxie,0,0,1,0,1
Roxy,0,0,1,0,1
Sofie,1,0,0,0,1
Rubi,1,0,0,0,1
Sobe,1,0,0,0,1
Sofi,0,0,1,0,1
Rubem,1,0,0,0,1
Sofia & Cesar,1,0,0,0,1
Sofiane,0,0,1,0,1
Soham,1,0,0,0,1
Roy M,1,0,0,0,1
Rt,1,0,0,0,1
Soheil,1,0,0,0,1
Roza,1,0,0,0,1
Sohel,1,0,0,0,1
Sol And Coach,1,0,0,0,1
Solange Et Michel,1,0,0,0,1
Six Columbus  Central Park Hotel,0,1,0,0,1
Siwen,0,0,1,0,1
Sagnes,0,0,1,0,1
Sadio,1,0,0,0,1
Sil,0,0,1,0,1
Sila,1,0,0,0,1
Sabrine,1,0,0,0,1
Silvan & Ilana,1,0,0,0,1
Silvester,0,0,1,0,1
Silvio,1,0,0,0,1
Sim,1,0,0,0,1
Sabir,1,0,0,0,1
Sabine,1,0,0,0,1
Simi,1,0,0,0,1
Sabia,1,0,0,0,1
Saba,0,0,1,0,1
Sab,1,0,0,0,1
Saarthak,0,0,1,0,1
Saadet,0,0,1,0,1
Sadequl,1,0,0,0,1
Sadiq,1,0,0,0,1
Ruta,0,0,1,0,1
Saeed,0,0,1,0,1
Sage,0,0,1,0,1
Saga,0,0,1,0,1
Siddharth,0,0,1,0,1
Safiyah,1,0,0,0,1
Siddhartha,0,0,0,1,1
Sidrah,1,0,0,0,1
Safira,1,0,0,0,1
Sien,0,0,1,0,1
Sietzka,1,0,0,0,1
Safiel,1,0,0,0,1
Safi,0,0,1,0,1
Sigal,0,0,1,0,1
Sael,1,0,0,0,1
Signe,0,0,1,0,1
Saeko,1,0,0,0,1
Simin,1,0,0,0,1
SMD Homes,1,0,0,0,1
S.M.,1,0,0,0,1
S.A.,0,0,1,0,1
Siobhan,1,0,0,0,1
Sioux,1,0,0,0,1
Siovan,1,0,0,0,1
Ruver,0,0,1,0,1
Ruthy,0,0,1,0,1
Ruthven,1,0,0,0,1
RuthlessEstates,1,0,0,0,1
Siria,1,0,0,0,1
Siré,1,0,0,0,1
Ruthie,1,0,0,0,1
Sissy,0,0,1,0,1
Sister City,0,1,0,0,1
Rutger,1,0,0,0,1
Rute,1,0,0,0,1
Sito,1,0,0,0,1
Ry,1,0,0,0,1
Singer,1,0,0,0,1
Sing,0,0,1,0,1
Simona & Jon,0,0,1,0,1
S Yussef,0,0,1,0,1
Simme,1,0,0,0,1
Simmone,1,0,0,0,1
Simo,1,0,0,0,1
Simon & Jessie,1,0,0,0,1
Rüya,1,0,0,0,1
Rylie,0,0,1,0,1
Sinead,1,0,0,0,1
Simone & Matthew,1,0,0,0,1
Rylee,1,0,0,0,1
Sinat,0,0,1,0,1
Rylan,0,0,1,0,1
Ryder,1,0,0,0,1
Sinda,1,0,0,0,1
Roshumba,1,0,0,0,1
Song,0,0,1,0,1
Rosey,0,0,1,0,1
Rolanuga,1,0,0,0,1
Sterling,0,0,1,0,1
Steve & Carla,1,0,0,0,1
Stoney,1,0,0,0,1
Roi,1,0,0,0,1
Stonie,0,0,1,0,1
Rohul,1,0,0,0,1
Storm,0,0,1,0,1
Stratos,0,0,1,0,1
Rohail,0,0,1,0,1
Roget,1,0,0,0,1
Studio,1,0,0,0,1
Styopa,1,0,0,0,1
Stéphane,1,0,0,0,1
Rogelio,1,0,0,0,1
Rodwyn,1,0,0,0,1
Stephen Dayo,1,0,0,0,1
Rolland,0,0,1,0,1
Rosetta,1,0,0,0,1
Stephen & Jillian,1,0,0,0,1
Stefan & Marianne,1,0,0,0,1
Stefani,1,0,0,0,1
Stefania,1,0,0,0,1
Stefanie Elizabeth,1,0,0,0,1
Stefanos,0,0,1,0,1
Steffan Per,1,0,0,0,1
Romi,1,0,0,0,1
Romeo,1,0,0,0,1
Steffany,0,0,1,0,1
Steffi,1,0,0,0,1
Romana,1,0,0,0,1
Stelian Deanna H And H,1,0,0,0,1
Stephane,0,0,1,0,1
Romain,1,0,0,0,1
Stephano,1,0,0,0,1
Stéphen,0,0,1,0,1
Suad,0,0,1,0,1
Suada,0,0,1,0,1
Subarkah,1,0,0,0,1
Suki,1,0,0,0,1
Robin & Bob,1,0,0,0,1
Sulaman,1,0,0,0,1
Suleman,0,0,1,0,1
Robertta,1,0,0,0,1
Sulima,1,0,0,0,1
Suling,1,0,0,0,1
Roberto Carlos,0,0,1,0,1
Sullivan,0,0,1,0,1
Sulma,1,0,0,0,1
Sulman,1,0,0,0,1
Sultan,1,0,0,0,1
Robertny,1,0,0,0,1
Sumaia,1,0,0,0,1
Roberta & Rob,1,0,0,0,1
Suk,1,0,0,0,1
Sujeiry,1,0,0,0,1
Robina,1,0,0,0,1
Suedama Luxury Suites,1,0,0,0,1
Subhana,1,0,0,0,1
Subramanian,0,0,1,0,1
Rodinei,0,0,1,0,1
Rode,0,0,1,0,1
Roddy,1,0,0,0,1
Suea,1,0,0,0,1
Suemattie,1,0,0,0,1
Suite Spot Properties,1,0,0,0,1
Sufia,1,0,0,0,1
Rochel,1,0,0,0,1
Rocco,1,0,0,0,1
Suhel,1,0,0,0,1
Robson,0,0,1,0,1
Robinson,1,0,0,0,1
Stay360,1,0,0,0,1
Romney,1,0,0,0,1
Romona,1,0,0,0,1
Spasenka,1,0,0,0,1
Sophia Yi,0,0,1,0,1
Roscoe,1,0,0,0,1
Sophiane,0,0,1,0,1
Rosanna,0,0,1,0,1
Soraya,1,0,0,0,1
Sorcha,0,0,1,0,1
Sotira,1,0,0,0,1
Sotirios,1,0,0,0,1
Rosamond,1,0,0,0,1
Soufian,1,0,0,0,1
Rosalynn,1,0,0,0,1
Soya,0,0,1,0,1
Soye,1,0,0,0,1
Rosaly,0,0,1,0,1
Rosalind,1,0,0,0,1
Rose Ann,1,0,0,0,1
Sophia And Shannon,0,0,1,0,1
Rose-Marie,1,0,0,0,1
Sony,0,0,1,0,1
Rosemary,1,0,0,0,1
Sonia & Victor,0,0,1,0,1
Roselynn,0,0,1,0,1
Sonskeshana,0,0,1,0,1
Roselyn,1,0,0,0,1
Roselin,1,0,0,0,1
Roselie,1,0,0,0,1
Soph,1,0,0,0,1
Roselene,1,0,0,0,1
Soojeong,0,0,1,0,1
Roseanne,1,0,0,0,1
Soon,0,0,1,0,1
RoseAnne,0,0,1,0,1
Soonbin,1,0,0,0,1
Sp,0,0,1,0,1
Rosalba,1,0,0,0,1
Romy,1,0,0,0,1
Special K,0,0,1,0,1
Ronni,0,0,1,0,1
Ronn,1,0,0,0,1
StandOut,0,0,1,0,1
Stanislas,0,0,1,0,1
Stanisław,0,0,1,0,1
Roni,1,0,0,0,1
Rondell,1,0,0,0,1
Stanley And Rosalinda,1,0,0,0,1
Stara,1,0,0,0,1
Ronaldo,1,0,0,0,1
Starlee,1,0,0,0,1
Ron & Hila,1,0,0,0,1
Starling,1,0,0,0,1
Stas,0,0,1,0,1
Stav,1,0,0,0,1
Stan,0,0,1,0,1
Stacie,1,0,0,0,1
Staci,1,0,0,0,1
Spiritchild,0,0,1,0,1
Roque,0,0,1,0,1
Spens,1,0,0,0,1
Spenser,0,0,1,0,1
Spice,1,0,0,0,1
Roosbelinda,0,0,1,0,1
Spirid,1,0,0,0,1
Spiro,1,0,0,0,1
Staccey,0,0,1,0,1
Spring,0,0,1,0,1
Room,0,0,1,0,1
Spyridon,1,0,0,0,1
Roodmy,0,0,1,0,1
Srulik,1,0,0,0,1
Ss,1,0,0,0,1
Sibyl,0,0,1,0,1
Sibin,1,0,0,0,1
Pema,1,0,0,0,1
Shariq,1,0,0,0,1
Sharma,0,0,1,0,1
Sharmila,1,0,0,0,1
Seema,1,0,0,0,1
Sedrick,0,0,1,0,1
Sharmilli,0,0,1,0,1
Sedon,1,0,0,0,1
Sharn,0,0,0,1,1
Sedat,0,0,1,0,1
Sebastien Rafael,0,0,1,0,1
Sharon And Dave,1,0,0,0,1
Sharon And Tom,1,0,0,0,1
Shary,1,0,0,0,1
Sharyn,0,0,1,0,1
Shasta,1,0,0,0,1
Sebastian & Andrea,0,0,1,0,1
Seema N James,1,0,0,0,1
Sego,1,0,0,0,1
Shanthi,1,0,0,0,1
Segun,1,0,0,0,1
Selika,0,0,1,0,1
Shaquille,1,0,0,0,1
Sharan,1,0,0,0,1
Selene,0,0,1,0,1
Selena,1,0,0,0,1
Selen,1,0,0,0,1
Selasie,1,0,0,0,1
Sharat,1,0,0,0,1
Sharday,1,0,0,0,1
Selam,0,0,0,1,1
Sekiya,1,0,0,0,1
Sharde,0,0,1,0,1
Seif,1,0,0,0,1
Sehrish,0,0,1,0,1
Sharif J.,1,0,0,0,1
Shatandra,1,0,0,0,1
Sebas,0,0,1,0,1
Seba,0,0,1,0,1
Shatese,0,0,1,0,1
Sayaka,1,0,0,0,1
Saya & Diego,1,0,0,0,1
Saya,1,0,0,0,1
Shayanne,0,0,1,0,1
Savitha,1,0,0,0,1
Saville,1,0,0,0,1
Shaye,0,0,1,0,1
Savanah,0,0,1,0,1
Sausan,1,0,0,0,1
Shayne,1,0,0,0,1
Shazzat,1,0,0,0,1
Sattie,0,0,1,0,1
Shearly,1,0,0,0,1
Sattawat,1,0,0,0,1
Satour,0,0,1,0,1
Shay & Anat,1,0,0,0,1
Shawnna,1,0,0,0,1
Sayyed,1,0,0,0,1
Scotty,0,0,1,0,1
Season,1,0,0,0,1
Shatia,1,0,0,0,1
Shaul,0,0,1,0,1
Sean And  Vanessa,0,0,1,0,1
Shaun-Marie,1,0,0,0,1
Shavanne,1,0,0,0,1
Scott & Jennifer,1,0,0,0,1
Shawnelle,1,0,0,0,1
Ms,1,0,0,0,1
Shawanda,1,0,0,0,1
Scosha,1,0,0,0,1
Scooter,1,0,0,0,1
Scarlen,1,0,0,0,1
Scar,0,0,1,0,1
Selim,0,0,1,0,1
Shantelle,0,0,1,0,1
Siara S.,1,0,0,0,1
Seyhan,1,0,0,0,1
Seva,1,0,0,0,1
Seun,1,0,0,0,1
Shahram,1,0,0,0,1
Shahriar,0,0,1,0,1
Shahryar,1,0,0,0,1
Shahrzad,0,0,1,0,1
Shahzad,1,0,0,0,1
Seshini,1,0,0,0,1
Sesenu,0,0,1,0,1
Shaila & Alex,1,0,0,0,1
Serra Victoria,1,0,0,0,1
Shailah,0,0,1,0,1
Serife,0,0,1,0,1
Shailesh,1,0,0,0,1
Shaily,0,0,1,0,1
Seve,1,0,0,0,1
Shahin,1,0,0,0,1
Shannoya,0,0,1,0,1
Shahid,0,0,1,0,1
Shafiur,0,0,1,0,1
Shah,1,0,0,0,1
Shahdiya,1,0,0,0,1
Shadae,1,0,0,0,1
Shad,1,0,0,0,1
Shachi,1,0,0,0,1
Shachar,1,0,0,0,1
Shabse,1,0,0,0,1
Shahed,1,0,0,0,1
Shabari,0,0,1,0,1
Shaheem,1,0,0,0,1
Shaheen,0,0,1,0,1
Seçil,0,0,1,0,1
Seán,1,0,0,0,1
Sezer,1,0,0,0,1
Shain,1,0,0,0,1
Shaina,0,0,1,0,1
Shakima,0,0,1,0,1
Shakira,1,0,0,0,1
Shanell,0,0,1,0,1
Senem,1,0,0,0,1
Seneca,1,0,0,0,1
Shanika,0,0,1,0,1
Senda,1,0,0,0,1
Sena,1,0,0,0,1
Semo,0,0,1,0,1
Semih,0,0,1,0,1
Shanise,1,0,0,0,1
Semaj,1,0,0,0,1
Selvete,1,0,0,0,1
Shanna-Lee,1,0,0,0,1
Selma,0,0,1,0,1
Shannon And Dahrehn,1,0,0,0,1
Selina,1,0,0,0,1
Shaneen,0,0,1,0,1
Shanea,1,0,0,0,1
Shane Michael,1,0,0,0,1
Shamal,1,0,0,0,1
Shalin,1,0,0,0,1
Shalini Sarena,1,0,0,0,1
Sergey & Kate,1,0,0,0,1
Shalva,0,0,1,0,1
Sergei,1,0,0,0,1
Shamaine,0,0,1,0,1
Shameeka And Dean,1,0,0,0,1
Shane & Shreshth,0,0,0,1,1
Serena (Legally Irina),1,0,0,0,1
Shamroz,0,0,1,0,1
Shandeep,0,0,1,0,1
Sercan,0,0,1,0,1
Serap,1,0,0,0,1
Serah,1,0,0,0,1
Sathi,1,0,0,0,1
Sheeba,0,0,1,0,1
Shef,0,0,1,0,1
Samin,1,0,0,0,1
Shirly,0,0,1,0,1
Shirrod,1,0,0,0,1
Shiva,0,0,1,0,1
Samer,1,0,0,0,1
Shivam,1,0,0,0,1
Shivangi,0,0,1,0,1
Saman,1,0,0,0,1
Samaa,1,0,0,0,1
Sam And Masha,1,0,0,0,1
Shivaul,0,0,1,0,1
Sam And Britt,1,0,0,0,1
Sam And,1,0,0,0,1
Sam / Sahar,1,0,0,0,1
Sam & Emily,1,0,0,0,1
Sho-Boo Of Sho-Boo Suite,0,0,1,0,1
Shirley (Fred),0,0,1,0,1
Shirine,1,0,0,0,1
Sheine,1,0,0,0,1
Shireen,0,0,1,0,1
Sanam,0,0,1,0,1
Sanadra,0,0,1,0,1
San,0,0,1,0,1
Samridhi,1,0,0,0,1
Shinhee,1,0,0,0,1
Sampson,0,0,1,0,1
Sammy & Chris,1,0,0,0,1
Shining,1,0,0,0,1
Shinobu,1,0,0,0,1
Shinsuke,1,0,0,0,1
Shiny,1,0,0,0,1
Sammie,1,0,0,0,1
Shir,0,0,1,0,1
Sammarullah,1,0,0,0,1
Shiraz,1,0,0,0,1
Shoaib,0,0,0,1,1
Salwah,1,0,0,0,1
Shomaker,0,0,1,0,1
Salvatore,0,0,1,0,1
Sajeel,1,0,0,0,1
Sajee,1,0,0,0,1
Sajad,0,0,1,0,1
Saif,0,0,1,0,1
Shunichi,0,0,1,0,1
Shutong,1,0,0,0,1
Sai,1,0,0,0,1
Sahra,1,0,0,0,1
Shuyi,0,0,1,0,1
Sahr,0,0,1,0,1
Sahla,1,0,0,0,1
Shwetha,1,0,0,0,1
Shyann,0,0,0,1,1
Sia,0,0,1,0,1
Sian,0,0,1,0,1
Shunchen,0,0,1,0,1
Sakeeb,1,0,0,0,1
Shulin,1,0,0,0,1
Shreen,1,0,0,0,1
Shondel,1,0,0,0,1
Salomie,1,0,0,0,1
Shosh,1,0,0,0,1
Shoshana,0,0,1,0,1
Shravan,1,0,0,0,1
Salman,1,0,0,0,1
Salisha,1,0,0,0,1
Shula,0,0,1,0,1
Shreyasi,0,0,1,0,1
Shu Cao,0,0,1,0,1
Salem,1,0,0,0,1
Salar,1,0,0,0,1
Sala,0,0,1,0,1
Sakinah,1,0,0,0,1
Sancar,1,0,0,0,1
Shimrit,0,0,1,0,1
Sandee,1,0,0,0,1
Santron,1,0,0,0,1
Sara I,0,0,1,0,1
Sara Fay,1,0,0,0,1
Shemel,0,0,1,0,1
Shemi,1,0,0,0,1
Shemroy,0,0,1,0,1
Shena,1,0,0,0,1
Sara And Greg,1,0,0,0,1
Sara & Dan,1,0,0,0,1
Shenaide,1,0,0,0,1
Shenaz,1,0,0,0,1
Sapphire,1,0,0,0,1
Sheneque,1,0,0,0,1
Sapir,1,0,0,0,1
Saori,0,0,1,0,1
Sheng,1,0,0,0,1
Shemeka,1,0,0,0,1
Sarah & Burak,1,0,0,0,1
Sarah & Peter,1,0,0,0,1
Sarina,1,0,0,0,1
Shel,1,0,0,0,1
Shelia,1,0,0,0,1
Shelieza,1,0,0,0,1
Shella,0,0,1,0,1
Sarita,1,0,0,0,1
Sarine,0,0,1,0,1
Sarel,1,0,0,0,1
Shemar,0,0,1,0,1
Shelliann,1,0,0,0,1
Saral,1,0,0,0,1
Shellon,1,0,0,0,1
Sarah Jazmine,1,0,0,0,1
Shelly & Wayne,1,0,0,0,1
Shem,1,0,0,0,1
Sheng-Min,0,0,1,0,1
Santosh,1,0,0,0,1
Sandeep,0,0,1,0,1
Sher-Min,1,0,0,0,1
Sherrye,0,0,1,0,1
Sheryl-Ann,1,0,0,0,1
Sandro,1,0,0,0,1
Sandrea,0,0,1,0,1
Sandra And Jorge,1,0,0,0,1
Sheying,0,0,1,0,1
Sandra And Cary,0,0,1,0,1
Shi Qing,0,0,1,0,1
Sandra & Cynthia,1,0,0,0,1
Shia,0,0,1,0,1
Shichao,0,0,1,0,1
Sandivell,1,0,0,0,1
Shihan,1,0,0,0,1
Shilo,1,0,0,0,1
Shimon,1,0,0,0,1
Sherree,1,0,0,0,1
Sherma,1,0,0,0,1
Sanghee,1,0,0,0,1
Sherer,1,0,0,0,1
Santos,0,0,1,0,1
Sherece,1,0,0,0,1
Shereen,0,0,1,0,1
Santi,1,0,0,0,1
Sanli,0,0,1,0,1
Sanket,0,0,1,0,1
Sanjna,1,0,0,0,1
Sangileen,0,0,1,0,1
Sanjeev,1,0,0,0,1
Sherice,0,0,1,0,1
Sherif,0,0,1,0,1
Sherina,0,0,1,0,1
Sherlock,0,0,1,0,1
Sherlyn,0,0,1,0,1
Sumeet,1,0,0,0,1
Robert And Zafir,1,0,0,0,1
Sumeira,1,0,0,0,1
Tina Jasmine,1,0,0,0,1
Rabia,0,0,1,0,1
Rabah,1,0,0,0,1
Raashi,1,0,0,0,1
RaVal,1,0,0,0,1
RaShaan,1,0,0,0,1
Ra-Ey,1,0,0,0,1
Tingting,1,0,0,0,1
Ra,1,0,0,0,1
Tinnie,1,0,0,0,1
Tiphaine,1,0,0,0,1
R. Scott,1,0,0,0,1
R. Paddington,1,0,0,0,1
Tirzah,0,0,1,0,1
R.,1,0,0,0,1
R&R,0,0,1,0,1
Rabya,1,0,0,0,1
Tina And Tim,1,0,0,0,1
Raeja,1,0,0,0,1
Rachel & Preston,0,0,1,0,1
Rae,1,0,0,0,1
Radiris,0,0,1,0,1
Radilena,0,0,1,0,1
Timothy Isaac,0,0,1,0,1
Radha,0,0,1,0,1
Radeisha,1,0,0,0,1
Racso,0,0,1,0,1
Timothée,1,0,0,0,1
Rachid,0,0,1,0,1
Rachelle,0,0,1,0,1
Rachele,1,0,0,0,1
Rachel...You Can Call Me Kaya :),0,0,1,0,1
Rachel Jillian,1,0,0,0,1
Rachel And Bart,1,0,0,0,1
Rachel And Ari,0,0,1,0,1
R S,0,0,1,0,1
Tischen,1,0,0,0,1
R David,0,0,1,0,1
Tish,1,0,0,0,1
Tolley,1,0,0,0,1
Tolu,1,0,0,0,1
Tom & Jennifer,1,0,0,0,1
Shaffiq,1,0,0,0,1
Qianyao,1,0,0,0,1
QianWen,0,0,1,0,1
Qian Yi (Kim),1,0,0,0,1
Tom Hank,1,0,0,0,1
Qian,0,0,1,0,1
Qaim,1,0,0,0,1
Qai,0,0,1,0,1
Pınar,1,0,0,0,1
Toma,0,0,1,0,1
Pénélope,0,0,1,0,1
Páidi,0,0,1,0,1
Tokunbo,1,0,0,0,1
Tok,0,0,1,0,1
Quaizar,1,0,0,0,1
Quincy,0,0,1,0,1
Tita,1,0,0,0,1
Quoc,1,0,0,0,1
Quinton,1,0,0,0,1
Quinto,1,0,0,0,1
Quinten,1,0,0,0,1
Tito And Lynn,1,0,0,0,1
Quetzal,0,0,1,0,1
Toda,1,0,0,0,1
Tito Ixcoy,1,0,0,0,1
Tiyanna,1,0,0,0,1
Queens,1,0,0,0,1
Que,1,0,0,0,1
Tobin And Lynn,0,0,1,0,1
Quan M,1,0,0,0,1
Raees,1,0,0,0,1
Timothy & Arman,1,0,0,0,1
Robert & Nira,1,0,0,0,1
Theresita,0,0,1,0,1
Thibault,0,0,1,0,1
Thibaut,0,0,1,0,1
Ramirez,1,0,0,0,1
Ramin,1,0,0,0,1
Ramia,0,0,1,0,1
Ramez,1,0,0,0,1
Rameshwar,0,0,1,0,1
Ramaz,1,0,0,0,1
Thornton,1,0,0,0,1
Raluca,1,0,0,0,1
Ralu,0,0,1,0,1
Rallie,0,0,1,0,1
Raliat,1,0,0,0,1
Thulinh,1,0,0,0,1
Thy,0,0,1,0,1
Thi Thu Ha,0,0,1,0,1
Rampa,1,0,0,0,1
Raf,1,0,0,0,1
Ramses,1,0,0,0,1
Ranita,0,0,1,0,1
The Belmonte Penthouse,1,0,0,0,1
The Bowery House,0,0,1,0,1
The Gatsby Hotel,1,0,0,0,1
Randolph,1,0,0,0,1
The Highland,1,0,0,0,1
Randie,0,0,1,0,1
The Hoxton Williamsburg,0,1,0,0,1
The James NoMad,0,1,0,0,1
Randa,1,0,0,0,1
The Parc Hotel,0,0,1,0,1
The Snow Effect,1,0,0,0,1
The Standard,0,1,0,0,1
The William Vale,0,1,0,0,1
Therese,1,0,0,0,1
Thyme & Barbie,1,0,0,0,1
Tia,1,0,0,0,1
Rajaa,1,0,0,0,1
Tianni,0,0,1,0,1
Raghav,0,0,1,0,1
Ragan,0,0,1,0,1
Rafik,1,0,0,0,1
Rafia,0,0,1,0,1
Tile,1,0,0,0,1
Tillie,0,0,1,0,1
Rafi,1,0,0,0,1
Tilo,0,0,1,0,1
Tim And Allison,1,0,0,0,1
Tim And Reuben,1,0,0,0,1
Raffaella,1,0,0,0,1
Timea,1,0,0,0,1
Rafale,1,0,0,0,1
Rafaela,0,0,1,0,1
Timmy,1,0,0,0,1
TiiNyy,1,0,0,0,1
Ragi,1,0,0,0,1
Tift,1,0,0,0,1
Tibor,0,0,1,0,1
Rainnie,1,0,0,0,1
Tianyou,0,0,1,0,1
Rainer J.,0,0,1,0,1
Tiara,1,0,0,0,1
Raine & Andrew,1,0,0,0,1
Tibetan,1,0,0,0,1
Raimot,1,0,0,0,1
Tiffannie,0,0,1,0,1
Rahwa,0,0,1,0,1
Tide,1,0,0,0,1
Rahmel,0,0,1,0,1
Rahmatjon,1,0,0,0,1
Tiffaney,1,0,0,0,1
Tiffani,1,0,0,0,1
Putri,1,0,0,0,1
Pushp,0,0,1,0,1
Tomas Julian,0,0,1,0,1
Phelps,1,0,0,0,1
Tuan-Phi,1,0,0,0,1
Tugba,1,0,0,0,1
Tugce,1,0,0,0,1
Tumay,1,0,0,0,1
Petrona,0,0,1,0,1
Tuncer,0,0,1,0,1
Petko,1,0,0,0,1
Tunzil,1,0,0,0,1
Petey,0,0,1,0,1
Peterson,1,0,0,0,1
Peter(BROOKE) & Maria,1,0,0,0,1
Tural,0,0,1,0,1
Peter Michael,1,0,0,0,1
Peter And MK,1,0,0,0,1
Tushrik,1,0,0,0,1
Phebe,1,0,0,0,1
Phenomenon,0,0,1,0,1
Puravida,1,0,0,0,1
Phi Lee,0,0,1,0,1
Pielah,1,0,0,0,1
Trisha,0,0,1,0,1
Trishia,1,0,0,0,1
Pianpian Carolyn,0,0,1,0,1
Trudian,1,0,0,0,1
Phyl,0,0,1,0,1
Phong,1,0,0,0,1
Trystin,1,0,0,0,1
Phin,1,0,0,0,1
Phillipa,1,0,0,0,1
Tsewang,0,0,1,0,1
Philipp,0,0,1,0,1
Philipe,1,0,0,0,1
Tsz,1,0,0,0,1
Tuan,0,0,1,0,1
Peter A.,0,0,1,0,1
Tutti,0,0,1,0,1
Peter & May,1,0,0,0,1
Petek,1,0,0,0,1
Percival,1,0,0,0,1
Téa,1,0,0,0,1
Tüli,1,0,0,0,1
Per Byholt Leibøl,1,0,0,0,1
Per,1,0,0,0,1
Pepijn,1,0,0,0,1
Pepi,1,0,0,0,1
Pepe,1,0,0,0,1
Pepa,1,0,0,0,1
Pennie,0,0,1,0,1
Udeaku,0,0,1,0,1
Ufuk,1,0,0,0,1
Ugo,1,0,0,0,1
Peng,0,0,0,1,1
Ugur,1,0,0,0,1
Té,1,0,0,0,1
Tzitzi,1,0,0,0,1
Tyson,1,0,0,0,1
Tyreek,0,0,1,0,1
Pete & Laurie,1,0,0,0,1
Tuvia,1,0,0,0,1
Petar,0,0,1,0,1
Tw,0,0,1,0,1
PetaGay,1,0,0,0,1
Tyeesha,0,0,1,0,1
Pet,1,0,0,0,1
Percy,1,0,0,0,1
Pervaiz,1,0,0,0,1
Tyreik,0,0,1,0,1
Tyrell,0,0,1,0,1
Tyrome,1,0,0,0,1
Peretz,1,0,0,0,1
Pereira,1,0,0,0,1
Triny,0,0,1,0,1
Piergiorgio,0,0,1,0,1
Trinize,0,0,0,1,1
Tory,1,0,0,0,1
Praveen,1,0,0,0,1
Tony &Julia,0,0,1,0,1
Prashast,0,0,1,0,1
Prashanth,0,0,1,0,1
Prasanna,1,0,0,0,1
Tony And Bridgette,1,0,0,0,1
Tonya,0,0,1,0,1
Pragya,0,0,0,1,1
Prachal,1,0,0,0,1
Prachak,0,0,1,0,1
Topu,1,0,0,0,1
Pouliasis,0,0,1,0,1
Posha,1,0,0,0,1
Torrey,1,0,0,0,1
Poppy,0,0,1,0,1
Prerna,1,0,0,0,1
Previn,1,0,0,0,1
Tonie,0,0,1,0,1
Tommaso,1,0,0,0,1
Puja,1,0,0,0,1
Przemek,1,0,0,0,1
Properties360,1,0,0,0,1
Tomek,1,0,0,0,1
Pronab,1,0,0,0,1
Tomika,1,0,0,0,1
Prithvi,1,0,0,0,1
Tonay,0,0,1,0,1
Pristine Posh,1,0,0,0,1
Tommy And Coy,1,0,0,0,1
Princess-Wynona,1,0,0,0,1
Tomás,0,0,1,0,1
Princess Bea Jenn,1,0,0,0,1
Princess,1,0,0,0,1
Pooja,0,0,1,0,1
Pona,1,0,0,0,1
Trinity,0,0,1,0,1
Toshi,1,0,0,0,1
TriNneo,1,0,0,0,1
Triada,0,0,1,0,1
Piluca,1,0,0,0,1
Trilce,1,0,0,0,1
Pika And Topi,0,0,1,0,1
Pietro,0,0,1,0,1
Trilla,1,0,0,0,1
Pieter,1,0,0,0,1
Piers,1,0,0,0,1
Pierre-Hubert,1,0,0,0,1
Pierre-Alexis,0,0,1,0,1
Pierre Yves,1,0,0,0,1
Pierre Richard,0,0,1,0,1
Trina,1,0,0,0,1
Trinh,0,0,1,0,1
Piner,1,0,0,0,1
Pippa,1,0,0,0,1
Piya,1,0,0,0,1
Travian,0,0,1,0,1
Tosin,1,0,0,0,1
Touie,1,0,0,0,1
Toyin,1,0,0,0,1
Toyosi,0,0,1,0,1
Trace,1,0,0,0,1
Pon,1,0,0,0,1
Plushy,1,0,0,0,1
Trenton,0,0,1,0,1
Placid,1,0,0,0,1
Trecia,1,0,0,0,1
Places4stay,1,0,0,0,1
Tremaine,1,0,0,0,1
Trent,1,0,0,0,1
Pk,0,0,1,0,1
The Alicea,1,0,0,0,1
Ranjeet,1,0,0,0,1
Thaya,0,0,1,0,1
Ria,0,0,1,0,1
Rhonda & Jude,1,0,0,0,1
Ta'Nika,1,0,0,0,1
TaMur,1,0,0,0,1
Taaj,0,0,1,0,1
Tabata,0,0,0,1,1
Rhoda,0,0,1,0,1
Rhita,0,0,1,0,1
Tabea,0,0,1,0,1
Rhille Joshua,1,0,0,0,1
Rhea,1,0,0,0,1
Rezi,1,0,0,0,1
Tabish,1,0,0,0,1
Reza,0,0,1,0,1
Tabita,1,0,0,0,1
Reyna,0,0,1,0,1
Ta Ta,0,0,1,0,1
Riah,0,0,1,0,1
Taleigh,1,0,0,0,1
Ta,1,0,0,0,1
Richardson,1,0,0,0,1
Richard Nelson,1,0,0,0,1
Syreeta,0,0,1,0,1
Szymon,1,0,0,0,1
Richard And Su,1,0,0,0,1
T Luke,1,0,0,0,1
Richard And Elena,1,0,0,0,1
T.,0,0,1,0,1
Rich & Patricia,1,0,0,0,1
T. Jeanne,1,0,0,0,1
Riccardo,0,0,1,0,1
Ricardo J,1,0,0,0,1
T. Lucy,0,0,1,0,1
Ricardo & Ashlie,1,0,0,0,1
T.O Rentals,1,0,0,0,1
Tabitha,1,0,0,0,1
Rey,0,0,1,0,1
Revital,1,0,0,0,1
Rev Jose & Anna,1,0,0,0,1
Tais Caroline,0,0,1,0,1
Taisha,1,0,0,0,1
Tajh,1,0,0,0,1
Tajudeen,0,0,1,0,1
Takagi,1,0,0,0,1
Renuka,1,0,0,0,1
Takako,1,0,0,0,1
Renuca,0,0,1,0,1
Renu,1,0,0,0,1
Takao & Aiko,1,0,0,0,1
Takashi,1,0,0,0,1
Takeshi,0,0,1,0,1
Takiya,1,0,0,0,1
Renni,1,0,0,0,1
Takuya,1,0,0,0,1
Tairan,0,0,1,0,1
Taina,1,0,0,0,1
Tailor’d Stays,1,0,0,0,1
Restivo,1,0,0,0,1
Tabs,0,0,1,0,1
Reut,1,0,0,0,1
Tae And Mek,1,0,0,0,1
Taeko,1,0,0,0,1
Taela,0,0,1,0,1
Reuben,0,0,1,0,1
Taelyr,1,0,0,0,1
Tahseen,1,0,0,0,1
Tafazzul,1,0,0,0,1
Taft,1,0,0,0,1
Taher,0,0,1,0,1
Tahirou,0,0,1,0,1
Rep,1,0,0,0,1
Tahiré,0,0,1,0,1
Synclaire,0,0,1,0,1
Sylwia,1,0,0,0,1
Sylvain,1,0,0,0,1
Susanne,0,0,1,0,1
Sunika,1,0,0,0,1
Sunil,1,0,0,0,1
Rnl,1,0,0,0,1
Rk,0,0,1,0,1
Sunlight,1,0,0,0,1
Sunnymello Homes,1,0,0,0,1
Sunshine,1,0,0,0,1
Suphichaya,0,0,1,0,1
Rivers,1,0,0,0,1
Suri,1,0,0,0,1
Susan & Aarti,1,0,0,0,1
Ritty,0,0,1,0,1
Rito,1,0,0,0,1
Ritchy,1,0,0,0,1
Susanna And Ricki,1,0,0,0,1
Rob&Elle,0,0,1,0,1
Sunhwa,1,0,0,0,1
Sung Ae,1,0,0,0,1
Suncerae,1,0,0,0,1
Robert & Holly,1,0,0,0,1
Robert & Bianca,1,0,0,0,1
Sumit,1,0,0,0,1
Sumitra,1,0,0,0,1
Sun,0,0,1,0,1
Sun-Young,1,0,0,0,1
Roberson,0,0,1,0,1
Robb,0,0,1,0,1
Robenson,0,0,1,0,1
Sundar,0,0,1,0,1
Robbie & Apples,1,0,0,0,1
Sundeep,1,0,0,0,1
Sunder,0,0,1,0,1
Sundiata,1,0,0,0,1
Susannah And Omar,1,0,0,0,1
Sushil,1,0,0,0,1
Sybil,1,0,0,0,1
Susy,0,0,1,0,1
Rika,0,0,1,0,1
Rigoberto,1,0,0,0,1
Rigo,0,0,1,0,1
Svintsov,0,0,1,0,1
Rien,1,0,0,0,1
Svitlana,1,0,0,0,1
Swan,1,0,0,0,1
Swann,0,0,1,0,1
Swati,1,0,0,0,1
Sweet Home Host,1,0,0,0,1
Ricki,1,0,0,0,1
Swipe,1,0,0,0,1
Sy,0,0,1,0,1
Rickey,1,0,0,0,1
Sy Asamaporn,1,0,0,0,1
Sven,1,0,0,0,1
Svein,1,0,0,0,1
Rikki,1,0,0,0,1
Suzel,1,0,0,0,1
Susye,1,0,0,0,1
Suvi,1,0,0,0,1
Rishi,1,0,0,0,1
Suwan,1,0,0,0,1
Rishad,1,0,0,0,1
Risha,1,0,0,0,1
Suzen,1,0,0,0,1
Riley,1,0,0,0,1
Rish,1,0,0,0,1
Rise,0,0,1,0,1
Risa&Jacky,1,0,0,0,1
Suzette,1,0,0,0,1
Svea,1,0,0,0,1
Rinaldo & Jessa,0,0,1,0,1
Talal,1,0,0,0,1
Renay,1,0,0,0,1
Ranny,0,0,1,0,1
Telitha,1,0,0,0,1
Rayshaun,1,0,0,0,1
Tema,0,0,1,0,1
Raysa,1,0,0,0,1
Temi,1,0,0,0,1
Temitope,1,0,0,0,1
Raynald,1,0,0,0,1
Temoh,0,0,1,0,1
Tempest,1,0,0,0,1
Raymonde,1,0,0,0,1
Raymond C.,0,0,1,0,1
Ten,1,0,0,0,1
Tene,1,0,0,0,1
Tenisha,1,0,0,0,1
Tennessee,1,0,0,0,1
Raymond And Kymme,1,0,0,0,1
Rayshawn,1,0,0,0,1
Teki,1,0,0,0,1
Renatta & Jennifer,0,0,1,0,1
Tekecia,1,0,0,0,1
Tayyab,1,0,0,0,1
Rebecca (Marks),1,0,0,0,1
Taz And Nayyirah,1,0,0,0,1
Tazin,1,0,0,0,1
Tedy,1,0,0,0,1
Reaz,1,0,0,0,1
Teedo,1,0,0,0,1
Real Estate To Go,0,0,1,0,1
Reagan,1,0,0,0,1
Tega,1,0,0,0,1
Razan,1,0,0,0,1
Razaki,0,0,1,0,1
Razack And Linda,1,0,0,0,1
Teirney,1,0,0,0,1
Tejal,0,0,1,0,1
Tenziah,1,0,0,0,1
Tere,1,0,0,0,1
Rayes,1,0,0,0,1
Teresita,1,0,0,0,1
Rasaki,1,0,0,0,1
Tevin,1,0,0,0,1
Rarles,0,0,1,0,1
Tfeila,1,0,0,0,1
Thais Navarro Leite,1,0,0,0,1
Thales,1,0,0,0,1
Raphaëlle,1,0,0,0,1
Raphaël,1,0,0,0,1
Thalia,1,0,0,0,1
Thanh,1,0,0,0,1
Raphael & Sydonie,1,0,0,0,1
Thatcher,1,0,0,0,1
Thaw Dar,1,0,0,0,1
Raoul,1,0,0,0,1
Rany,1,0,0,0,1
Tevfik,0,0,1,0,1
Tetef,0,0,1,0,1
Tessa Marie,0,0,1,0,1
Terrick,1,0,0,0,1
Terje,0,0,1,0,1
Rayanna,1,0,0,0,1
Ray & Kenia,0,0,1,0,1
Terrell,0,0,1,0,1
Raviv,1,0,0,0,1
Terresa,1,0,0,0,1
Terrie,1,0,0,0,1
Rasheed,1,0,0,0,1
Terrill,1,0,0,0,1
Ravan,1,0,0,0,1
Terrioma,1,0,0,0,1
Rattan,1,0,0,0,1
Tesha,1,0,0,0,1
Rashmi,0,0,1,0,1
Taylor & Tee,0,0,1,0,1
Rebecca Choo,1,0,0,0,1
Rebeccah & Daniel,1,0,0,0,1
Tanny,1,0,0,0,1
Remmy,1,0,0,0,1
Taner,1,0,0,0,1
Tanesha,1,0,0,0,1
Tanguy,1,0,0,0,1
Relaxandtravel,1,0,0,0,1
Tani,1,0,0,0,1
Reke,1,0,0,0,1
Tania & Gio,1,0,0,0,1
Tanika,1,0,0,0,1
Reisha,1,0,0,0,1
Reigen,1,0,0,0,1
Tanise,1,0,0,0,1
Tanja,1,0,0,0,1
Tanmay,0,0,1,0,1
Tanner Myles,0,0,1,0,1
Tamer,1,0,0,0,1
Tameka,1,0,0,0,1
Remsha,0,0,1,0,1
Renard,0,0,1,0,1
Talha,0,0,1,0,1
Tali,1,0,0,0,1
Renato,0,0,1,0,1
Renata And Howard,1,0,0,0,1
Talib,1,0,0,0,1
Talita,1,0,0,0,1
Talor,0,0,1,0,1
Tameisha,0,0,1,0,1
Renaldo,0,0,1,0,1
Talya,1,0,0,0,1
Talysha And Nelson,1,0,0,0,1
Ren,1,0,0,0,1
Tamarinda,1,0,0,0,1
Tamarka,0,0,1,0,1
Tannise,1,0,0,0,1
Regis,1,0,0,0,1
Rebecka,1,0,0,0,1
Regine,1,0,0,0,1
Redoneva,1,0,0,0,1
Tasos,1,0,0,0,1
Redi,1,0,0,0,1
Redford,1,0,0,0,1
Redding,0,0,1,0,1
Tasrina,1,0,0,0,1
Tassili,1,0,0,0,1
Tatev,0,0,1,0,1
Tatia,1,0,0,0,1
Red Autumn House Too,1,0,0,0,1
Red Autumn House LLC,1,0,0,0,1
Taufiqul,1,0,0,0,1
Reccie,1,0,0,0,1
Tavish,0,0,1,0,1
Rebeckah,1,0,0,0,1
Redwan,1,0,0,0,1
Taslima,0,0,1,0,1
Reece,0,0,1,0,1
Taras,1,0,0,0,1
Tao,1,0,0,0,1
Tapashi,0,0,1,0,1
Regie,1,0,0,0,1
Regiane Navarro,1,0,0,0,1
Regi,1,0,0,0,1
Taran & Najla,1,0,0,0,1
Tarek,1,0,0,0,1
Tasia,1,0,0,0,1
Tarnjot,1,0,0,0,1
Reese,0,0,1,0,1
Tarry,1,0,0,0,1
Tarvatta,0,0,1,0,1
Taryn,1,0,0,0,1
Tasha,1,0,0,0,1
Shawanah,0,0,1,0,1
Kriti,0,0,1,0,1
Mr. W,1,0,0,0,1
Dejan,1,0,0,0,1
Deren,1,0,0,0,1
Derek + Mona,1,0,0,0,1
Denzil,1,0,0,0,1
Dennis J.,0,0,1,0,1
Denna,1,0,0,0,1
Deniz N,0,0,1,0,1
Denise & Rich,1,0,0,0,1
Dening,1,0,0,0,1
Deniece,0,0,1,0,1
Deni,1,0,0,0,1
Denel,1,0,0,0,1
Denae,1,0,0,0,1
Demoy,0,0,1,0,1
Demir,0,0,1,0,1
Demid,0,0,1,0,1
Demi,1,0,0,0,1
Demetria,0,0,1,0,1
Delsy,0,0,1,0,1
Delores,1,0,0,0,1
Delna,0,0,1,0,1
Delicia,1,0,0,0,1
Deleted,1,0,0,0,1
Del,0,0,1,0,1
Derick,1,0,0,0,1
Derrica,1,0,0,0,1
Derwin,1,0,0,0,1
Devanshi,1,0,0,0,1
Dewyane,1,0,0,0,1
Dewan,0,0,1,0,1
Devyn,0,0,1,0,1
Devshri,0,0,1,0,1
Devorah,1,0,0,0,1
Devony,0,0,1,0,1
Devin & Genevieve,1,0,0,0,1
Devin  & Justin,0,0,1,0,1
Devi,1,0,0,0,1
Deverne,0,0,1,0,1
Devaki,0,0,1,0,1
Deryck,1,0,0,0,1
Dev,1,0,0,0,1
Destiny,1,0,0,0,1
Dessa,1,0,0,0,1
Despina,1,0,0,0,1
Desphie,1,0,0,0,1
Deslyn,1,0,0,0,1
Desislava,0,0,1,0,1
Deshawn,0,0,1,0,1
Deshaun,0,0,1,0,1
Desaree,1,0,0,0,1
Dejon,1,0,0,0,1
Deivy,0,0,1,0,1
Dhanrajie,0,0,1,0,1
Defkarle,1,0,0,0,1
Dayanna,0,0,1,0,1
Dayana,1,0,0,0,1
Dayan,1,0,0,0,1
Dayakishan,1,0,0,0,1
Day-Yawn,1,0,0,0,1
Dax,1,0,0,0,1
Dawnie,1,0,0,0,1
Dawne,1,0,0,0,1
Dawn & Vernon,1,0,0,0,1
Dawid,0,0,1,0,1
Dawa & Phurpa,1,0,0,0,1
Davon,0,0,1,0,1
Davit,0,0,1,0,1
Davidson,1,0,0,0,1
Davide,0,0,1,0,1
David Y,0,0,1,0,1
David And Natalia,1,0,0,0,1
David & Orli,1,0,0,0,1
David & Mary,1,0,0,0,1
David & Manny,1,0,0,0,1
David & Elise,1,0,0,0,1
David & Derek,1,0,0,0,1
Daveyjoe!,0,0,1,0,1
Daylian,1,0,0,0,1
Daynel,1,0,0,0,1
Dayse,0,0,1,0,1
Deborah/Aston,1,0,0,0,1
Deevee,1,0,0,0,1
Deepika,1,0,0,0,1
Deepen,1,0,0,0,1
Deepak,1,0,0,0,1
Deep,0,0,1,0,1
Deedee,1,0,0,0,1
DeeDee,1,0,0,0,1
Dedra,0,0,1,0,1
Decidel,1,0,0,0,1
Debris,1,0,0,0,1
Deandrea,1,0,0,0,1
Dd,0,0,1,0,1
DeShawn,1,0,0,0,1
DeShanda,1,0,0,0,1
DeSean,1,0,0,0,1
DeMia,1,0,0,0,1
DeMarius,1,0,0,0,1
DeLex,0,0,1,0,1
DeColby,0,0,1,0,1
De La Luna,1,0,0,0,1
De & Claudia,0,0,1,0,1
De,1,0,0,0,1
De’Quan,1,0,0,0,1
Dhruv,0,0,1,0,1
Dulaina,0,0,1,0,1
Dominika,1,0,0,0,1
Dory,0,0,1,0,1
Dorthy,0,0,1,0,1
Dorthea,1,0,0,0,1
Dorota,0,0,1,0,1
Dorka,0,0,1,0,1
Dorion,1,0,0,0,1
Dorien,0,0,1,0,1
Dori,1,0,0,0,1
Doretha,1,0,0,0,1
Doreshia,1,0,0,0,1
Dorde,0,0,1,0,1
Dorcas,1,0,0,0,1
Doran,1,0,0,0,1
Donnie,1,0,0,0,1
Donna & Candise,0,0,1,0,1
Donminique,0,0,1,0,1
Donika,0,0,1,0,1
Dongxu,0,0,1,0,1
Donavan,1,0,0,0,1
Donalda,1,0,0,0,1
Donal,1,0,0,0,1
Don & Evita,1,0,0,0,1
Domonique,1,0,0,0,1
Dotun,1,0,0,0,1
Dovile,1,0,0,0,1
Doyle,1,0,0,0,1
Driss,1,0,0,0,1
Duery,0,0,1,0,1
Ducrot,1,0,0,0,1
Duanne,0,0,1,0,1
Duane N Tara,1,0,0,0,1
Drue,1,0,0,0,1
Dror Daniel,1,0,0,0,1
Dror,1,0,0,0,1
Droany,1,0,0,0,1
Drj,0,0,1,0,1
Driton,0,0,1,0,1
Dridi,0,0,1,0,1
Dp,1,0,0,0,1
Drica,1,0,0,0,1
Drea,0,0,1,0,1
Dre,1,0,0,0,1
Drake,0,0,1,0,1
Dragomir,0,0,1,0,1
Dragica,1,0,0,0,1
Dragan,0,0,0,1,1
Dr.Sally,0,0,1,0,1
Dr. Sergio,1,0,0,0,1
Dr,1,0,0,0,1
Domonick,1,0,0,0,1
Domenico,1,0,0,0,1
Di Di,1,0,0,0,1
Dolphy,1,0,0,0,1
Dimitar,0,0,0,1,1
Dima,0,0,1,0,1
Dily,0,0,1,0,1
Dilini,0,0,1,0,1
Dilek,1,0,0,0,1
Dila,0,0,1,0,1
Dil,1,0,0,0,1
Dike,0,0,1,0,1
Digna,1,0,0,0,1
Dieuna,1,0,0,0,1
Dieudonne,1,0,0,0,1
Dierdre,1,0,0,0,1
Diego Fernando,0,0,1,0,1
Didier,1,0,0,0,1
Didi,0,0,1,0,1
Didar,1,0,0,0,1
Diavanna,1,0,0,0,1
Diara,0,0,1,0,1
Dianis,0,0,1,0,1
Dianilsa,1,0,0,0,1
Diane Hua,0,0,1,0,1
Dian,0,0,1,0,1
Di Ming,1,0,0,0,1
Dimitra,1,0,0,0,1
Dinah,1,0,0,0,1
Dinero,1,0,0,0,1
Dirk Damian,0,0,1,0,1
Dolores & David,1,0,0,0,1
Dolli,1,0,0,0,1
Doc,0,0,1,0,1
Doa,0,0,1,0,1
Dmitriy & Amy,1,0,0,0,1
Djene,1,0,0,0,1
Django,1,0,0,0,1
Diuly Cristine,0,0,1,0,1
Distinct,1,0,0,0,1
Disha,1,0,0,0,1
Dipti,1,0,0,0,1
Ding,0,0,1,0,1
Dipak,1,0,0,0,1
Dioris,0,0,1,0,1
Diorilina,1,0,0,0,1
Dionyssios,1,0,0,0,1
Diony,1,0,0,0,1
Dionicio,1,0,0,0,1
Dion,0,0,1,0,1
Diogo,1,0,0,0,1
Dins,1,0,0,0,1
Dingyu,0,0,1,0,1
Daveth,1,0,0,0,1
Dave And Luisa,1,0,0,0,1
Dave & Theresa,1,0,0,0,1
Claibourne,0,0,1,0,1
Colie,1,0,0,0,1
Coley,1,0,0,0,1
Coco And Davis,1,0,0,0,1
Clyde,1,0,0,0,1
Cloud,1,0,0,0,1
Clotaire,0,0,1,0,1
Clifford,1,0,0,0,1
Clif,1,0,0,0,1
Clesio,0,0,1,0,1
Cleopatra,0,0,1,0,1
Clemente,0,0,1,0,1
Clemence,1,0,0,0,1
Claudiu,0,0,1,0,1
Claudia And Luis,0,0,1,0,1
Claudia And Leo,1,0,0,0,1
Claudia & Turi,1,0,0,0,1
Clark,1,0,0,0,1
Clarisse,1,0,0,0,1
Clarissa & Tano,1,0,0,0,1
Clarina,1,0,0,0,1
Clare And Michael,1,0,0,0,1
Clarabel,1,0,0,0,1
Claire & Adrien,1,0,0,0,1
Colin And Bryn,1,0,0,0,1
Coline,1,0,0,0,1
Collen,1,0,0,0,1
Cordeelia,0,0,1,0,1
Cousin Connie,0,0,1,0,1
Courtney-Brooke,0,0,1,0,1
Courtney & Melissa,1,0,0,0,1
Costa,1,0,0,0,1
Corrie,1,0,0,0,1
Corrado,1,0,0,0,1
Corinne,1,0,0,0,1
Corinna,1,0,0,0,1
Corina E.,1,0,0,0,1
Cori,1,0,0,0,1
Corban,1,0,0,0,1
Colton,1,0,0,0,1
Coral,0,0,1,0,1
Cook F.,1,0,0,0,1
Constanze,1,0,0,0,1
Constanza,1,0,0,0,1
Constantine,1,0,0,0,1
Conrado,1,0,0,0,1
Connor R,0,0,1,0,1
Confidence,1,0,0,0,1
Conall,1,0,0,0,1
Comfy,0,0,1,0,1
Clair&Charles,1,0,0,0,1
City,1,0,0,0,1
Daur,0,0,1,0,1
Ciro,1,0,0,0,1
Chomwan,1,0,0,0,1
Cholly,0,0,1,0,1
Chisom,0,0,1,0,1
Chiron,1,0,0,0,1
Chinomnso,1,0,0,0,1
Chinith M,0,0,1,0,1
Chin-Feng,1,0,0,0,1
Chin,1,0,0,0,1
Chima,0,0,1,0,1
Chika,1,0,0,0,1
Chii,0,0,1,0,1
Chien-Ni,0,0,1,0,1
Chiarra,0,0,1,0,1
Chiaki,1,0,0,0,1
Chezi,1,0,0,0,1
Cheyann (Shy Ann),0,0,1,0,1
Chevez,0,0,1,0,1
Cheryn,0,0,1,0,1
Cher,1,0,0,0,1
Chenoa,0,0,1,0,1
Chennae,1,0,0,0,1
Chenits,1,0,0,0,1
Chelsie,0,0,1,0,1
Chong,0,0,1,0,1
Chongyuan,0,0,1,0,1
Chowdhury,1,0,0,0,1
Chun Kit,0,0,1,0,1
Cinthia Odalis,1,0,0,0,1
Cinetta,0,0,0,1,1
Cillian,0,0,1,0,1
Ciara,0,0,1,0,1
Chyna,0,0,1,0,1
Chyanne & Jermaine,1,0,0,0,1
Chuyuan,1,0,0,0,1
Chunxiao,1,0,0,0,1
Chungla,1,0,0,0,1
Chung Hao,0,0,1,0,1
Chun,1,0,0,0,1
Chris And Precious,1,0,0,0,1
Chukwurado,0,0,1,0,1
Chukwudike,1,0,0,0,1
Chrys,0,0,1,0,1
Christoni,0,0,1,0,1
Christine & Philip,1,0,0,0,1
Christina Jo,0,0,1,0,1
Christiane,1,0,0,0,1
Christele,1,0,0,0,1
Christan,0,0,1,0,1
Chris&Suly,1,0,0,0,1
Cranford,1,0,0,0,1
Cristhian,1,0,0,0,1
Cristiana,1,0,0,0,1
Cristiano,1,0,0,0,1
Daphna,1,0,0,0,1
Daouda,0,0,1,0,1
Danyell,1,0,0,0,1
Danoulo28,1,0,0,0,1
Danny D,0,0,1,0,1
Danny And Alex,1,0,0,0,1
Danka,0,0,1,0,1
Daniël,0,0,1,0,1
Daniyal,1,0,0,0,1
Danisia,1,0,0,0,1
Danila,0,0,1,0,1
Daniil,0,0,1,0,1
Danielisa,0,0,1,0,1
Daniel Sebastian,1,0,0,0,1
Daniel And Yana,1,0,0,0,1
Daniel And Shabnam,0,0,1,0,1
Daniel And Elsa,0,0,1,0,1
Daniel & Lia,1,0,0,0,1
Danial,1,0,0,0,1
Danforth,1,0,0,0,1
Dandan,1,0,0,0,1
Dan & Bliss,1,0,0,0,1
Dan & Amy,1,0,0,0,1
Daphne And Jonathan,1,0,0,0,1
Daphnee/Allan,1,0,0,0,1
Daphney,1,0,0,0,1
Darrin,1,0,0,0,1
Dassy,0,0,1,0,1
Das,0,0,1,0,1
Daryn,0,0,1,0,1
Daryen,1,0,0,0,1
Darxy,0,0,1,0,1
Darwin,1,0,0,0,1
Darunee,0,0,1,0,1
Darshan,0,0,1,0,1
Darryl Diego,1,0,0,0,1
Darrol,1,0,0,0,1
Darrell,1,0,0,0,1
Darby,0,0,1,0,1
Darrah,1,0,0,0,1
Darley,1,0,0,0,1
Darlena,0,0,1,0,1
Darla,1,0,0,0,1
Darin,0,0,1,0,1
Darien,1,0,0,0,1
Darell,1,0,0,0,1
Darcy And Ross,1,0,0,0,1
Darcy,1,0,0,0,1
Darchelle,0,0,1,0,1
Damoya,1,0,0,0,1
Damon And Kent,1,0,0,0,1
Damon & Yvonne,0,0,1,0,1
Cydia,1,0,0,0,1
D. Christopher,0,0,1,0,1
D. Anthony,1,0,0,0,1
Céline,1,0,0,0,1
Cécilia & Criselis,1,0,0,0,1
Cândida,1,0,0,0,1
Cyrus,1,0,0,0,1
Cyril,1,0,0,0,1
Cynthia Vanessa Liliane,0,0,1,0,1
Cynthia And  Charlie,1,0,0,0,1
Cyndi,1,0,0,0,1
Curwin,1,0,0,0,1
D.S.,1,0,0,0,1
Curtiss,1,0,0,0,1
Curt & Patricia,1,0,0,0,1
Curlene,1,0,0,0,1
Cui Miu,0,0,1,0,1
Ct,1,0,0,0,1
Crystal & John,1,0,0,0,1
CrossOver,1,0,0,0,1
Crosby,0,0,1,0,1
Cristobal,1,0,0,0,1
Cristina A.,1,0,0,0,1
D. Rp,1,0,0,0,1
DAVID And RICK,0,0,1,0,1
Damni,1,0,0,0,1
Dalila,0,0,1,0,1
Damiso,1,0,0,0,1
Damion And Brandii,1,0,0,0,1
Damion,0,0,1,0,1
Daming,0,0,1,0,1
Dametria,0,0,1,0,1
Damask,1,0,0,0,1
Damaris,1,0,0,0,1
Damali,1,0,0,0,1
Dalva,0,0,1,0,1
Dalilah,1,0,0,0,1
Dalal,0,0,0,1,1
DJ Timothy,0,0,1,0,1
Dakota,1,0,0,0,1
Dak,1,0,0,0,1
Daitao,1,0,0,0,1
Daisuke,0,0,1,0,1
Dain,1,0,0,0,1
Daiki,0,0,1,0,1
Daichi,1,0,0,0,1
Dafna,1,0,0,0,1
Daehan,0,0,1,0,1
Daan,1,0,0,0,1
Duke,1,0,0,0,1
Dulcina,0,0,1,0,1
Mr. & Mrs. Kris,1,0,0,0,1
Fifth Floor,1,0,0,0,1
Folami,1,0,0,0,1
Fma,1,0,0,0,1
Floyd,1,0,0,0,1
Florin,1,0,0,0,1
Florie,1,0,0,0,1
Floriane,1,0,0,0,1
Floriana,1,0,0,0,1
Florian / Anna,0,0,1,0,1
Florentino,0,0,1,0,1
Florencio,0,0,1,0,1
Florence And Peter,0,0,1,0,1
Florcie,1,0,0,0,1
Flor De Liz,0,0,1,0,1
Floor,1,0,0,0,1
Flojo,1,0,0,0,1
Flo And Erin,1,0,0,0,1
Fletcher,1,0,0,0,1
Flavien,0,0,1,0,1
Fla,0,0,1,0,1
Fitzroy,1,0,0,0,1
Fisayo,1,0,0,0,1
Firat,1,0,0,0,1
Fionn,0,0,1,0,1
Fon,0,0,1,0,1
Foster,1,0,0,0,1
Fotini,1,0,0,0,1
Franny & Zooey,1,0,0,0,1
Fridolin,1,0,0,0,1
Friday,1,0,0,0,1
Freema,1,0,0,0,1
Freeda,0,0,1,0,1
Fredys,0,0,1,0,1
Fredrik,0,0,1,0,1
Frederikke,1,0,0,0,1
Frederico,1,0,0,0,1
Frasier,0,0,1,0,1
Frantz,1,0,0,0,1
Franklyn,1,0,0,0,1
Fotis,0,0,1,0,1
Francoise X,0,0,1,0,1
Francois-Xavier,1,0,0,0,1
Francisco Javier,0,0,1,0,1
Francielly,1,0,0,0,1
Francheska,0,0,1,0,1
Franchesca,0,0,0,1,1
Fran And Phyl,1,0,0,0,1
Frailin,0,0,1,0,1
Fracily,0,0,1,0,1
Fourth,1,0,0,0,1
Fikile,1,0,0,0,1
Fifi,0,0,1,0,1
Frits,0,0,0,1,1
Fidelis,1,0,0,0,1
Farrah,1,0,0,0,1
Farouk,0,0,1,0,1
Farjana,1,0,0,0,1
Farideh,1,0,0,0,1
Fariborz,1,0,0,0,1
Farhad,1,0,0,0,1
Fares,1,0,0,0,1
Fareez,1,0,0,0,1
Faraz,0,0,1,0,1
Fantasia,0,0,1,0,1
Fannie,1,0,0,0,1
Falana,0,0,1,0,1
Fakir,1,0,0,0,1
Faiven,0,0,0,1,1
Faisal,0,0,1,0,1
Faina,0,0,1,0,1
Faigie,0,0,1,0,1
Fahmida,0,0,1,0,1
Faheem,0,0,1,0,1
Fahd,1,0,0,0,1
Facundo,1,0,0,0,1
Fabrício,0,0,1,0,1
Fabrice,1,0,0,0,1
Faruk,1,0,0,0,1
Fatema,1,0,0,0,1
Fatima Vélez,1,0,0,0,1
Fenol,1,0,0,0,1
Fidel,0,0,1,0,1
Feyikunmi,0,0,1,0,1
Fersa,1,0,0,0,1
Ferris,1,0,0,0,1
Ferhat Emre,1,0,0,0,1
Ferhat,0,0,1,0,1
Ferhan,0,0,1,0,1
Ferenc,1,0,0,0,1
Ferdousi,1,0,0,0,1
Feon,0,0,1,0,1
Femi,1,0,0,0,1
Fatimazahra,1,0,0,0,1
Felo,1,0,0,0,1
Feliz,1,0,0,0,1
Felami,1,0,0,0,1
Fejir,0,0,1,0,1
Feifei,1,0,0,0,1
Feginse,0,0,1,0,1
Fayna,1,0,0,0,1
Fawaz,0,0,0,1,1
Favio,0,0,1,0,1
Fattie,0,0,1,0,1
Friko,1,0,0,0,1
Fritzlene,1,0,0,0,1
Dullette,0,0,1,0,1
Genevieve & Brett,1,0,0,0,1
Germa,1,0,0,0,1
Geri,0,0,1,0,1
Gerceida,0,0,1,0,1
Geraldo,1,0,0,0,1
Geraldine,1,0,0,0,1
Geraldina,1,0,0,0,1
Geralde,0,0,1,0,1
Geovanna,0,0,1,0,1
Geoseline,0,0,1,0,1
Georgy,0,0,1,0,1
Georgie,1,0,0,0,1
Georgia And Kevin,1,0,0,0,1
George S,0,0,1,0,1
George - Francis,1,0,0,0,1
Geordie,1,0,0,0,1
Geordan,1,0,0,0,1
Genéa,1,0,0,0,1
Gentry,0,0,1,0,1
Genni And Stephen,1,0,0,0,1
Gennaro,1,0,0,0,1
Gennady + Laura,1,0,0,0,1
Genna,1,0,0,0,1
Geniya,0,0,1,0,1
German,1,0,0,0,1
Germanico,0,0,0,1,1
Germanie,1,0,0,0,1
Gian Franco,1,0,0,0,1
Gilda,0,0,1,0,1
Gilberto,0,0,1,0,1
Gil & Stacy,1,0,0,0,1
Giedre & Andre,1,0,0,0,1
Gidon,1,0,0,0,1
Gianni,1,0,0,0,1
Giancarlo,1,0,0,0,1
Gian-Murray,1,0,0,0,1
Gian Maria,1,0,0,0,1
Gian Marco,1,0,0,0,1
Giampiero,1,0,0,0,1
Germán,0,0,1,0,1
Giada,0,0,1,0,1
Ghislain,0,0,1,0,1
Gheorghe,1,0,0,0,1
Ghazi,1,0,0,0,1
Gharet,0,0,1,0,1
Ghaflan,1,0,0,0,1
Gery,0,0,1,0,1
Gerwin,1,0,0,0,1
Gershon,1,0,0,0,1
Gerri,1,0,0,0,1
Genine,0,0,1,0,1
Genesy,0,0,1,0,1
Fritzner,1,0,0,0,1
Genenne,1,0,0,0,1
Gannell,1,0,0,0,1
Gamal,1,0,0,0,1
Galya,1,0,0,0,1
Galla,1,0,0,0,1
Gage,1,0,0,0,1
Gagandeep,1,0,0,0,1
Gaetano,0,0,1,0,1
Gaea,0,0,1,0,1
Gadi,1,0,0,0,1
Gabriela Corina,0,0,1,0,1
Gabo,0,0,1,0,1
Gabe And Darwin,0,0,1,0,1
G. Chris,0,0,1,0,1
G. Brown,1,0,0,0,1
G.,1,0,0,0,1
G&G Services,1,0,0,0,1
Fyre,0,0,1,0,1
Fx,1,0,0,0,1
Furkan,1,0,0,0,1
Funmilayo,1,0,0,0,1
Fun,0,0,1,0,1
Fulya,0,0,1,0,1
Frédérique And Guillaume,1,0,0,0,1
Garcia,1,0,0,0,1
Gardens Suites Hotel By Affinia,0,1,0,0,1
Gareth,1,0,0,0,1
Gay,1,0,0,0,1
Gemm,0,0,1,0,1
Gelila,0,0,1,0,1
Geli,0,0,1,0,1
Gel,0,0,1,0,1
Geetha,1,0,0,0,1
Gee Moon,1,0,0,0,1
Gearóid,1,0,0,0,1
GeGa,1,0,0,0,1
Ge,1,0,0,0,1
Gayane,0,0,1,0,1
Gawon,1,0,0,0,1
Garland,0,0,1,0,1
Gautier,1,0,0,0,1
Gaute,0,0,1,0,1
Gaurab,0,0,1,0,1
Gat,1,0,0,0,1
Gaston,0,0,1,0,1
Garvey,0,0,1,0,1
Garry,1,0,0,0,1
Garret Kane,1,0,0,0,1
Garret,1,0,0,0,1
Garnett,1,0,0,0,1
Fabio & Angie,1,0,0,0,1
Fabien,1,0,0,0,1
Fabe,1,0,0,0,1
Efren,1,0,0,0,1
Elen,1,0,0,0,1
Eleinis,0,0,1,0,1
Eleena,0,0,1,0,1
Eleanna,1,0,0,0,1
Elean,1,0,0,0,1
Eldar,0,0,1,0,1
Elazar,0,0,1,0,1
Elam,0,0,1,0,1
Elaina,0,0,1,0,1
Elai,1,0,0,0,1
Ekin,1,0,0,0,1
Eki,1,0,0,0,1
Ekansh,0,0,1,0,1
Ekanem,0,0,1,0,1
Eja,0,0,0,1,1
Ej,1,0,0,0,1
Eitan,0,0,1,0,1
Eimy,1,0,0,0,1
Eilyn,0,0,1,0,1
Eilon,1,0,0,0,1
Ehssan,0,0,1,0,1
Ehren,0,0,1,0,1
Ehi,0,0,1,0,1
Elena And William,1,0,0,0,1
Eleonora,1,0,0,0,1
Elevate Rentals,1,0,0,0,1
Ellena,0,0,1,0,1
Elyssa,1,0,0,0,1
Elvin,0,0,1,0,1
Elsye,0,0,1,0,1
Elska,1,0,0,0,1
Eloise,0,0,1,0,1
Elma,0,0,1,0,1
Elly,1,0,0,0,1
Ellouise,1,0,0,0,1
Elliott,0,0,1,0,1
Elli,0,0,1,0,1
Ellen Fannie,1,0,0,0,1
Elhadj,0,0,1,0,1
Ella Jane,1,0,0,0,1
Elke,0,0,1,0,1
Elka,1,0,0,0,1
Eljon,1,0,0,0,1
Elizaveta,1,0,0,0,1
Eliu,1,0,0,0,1
Elito,1,0,0,0,1
Eliseu,1,0,0,0,1
Elin,1,0,0,0,1
Eliasz,0,0,1,0,1
Egbe,1,0,0,0,1
Efrem,1,0,0,0,1
Ezgi,1,0,0,0,1
Efrat,1,0,0,0,1
Ebonie,1,0,0,0,1
Eboni,0,0,1,0,1
Ebenezer,0,0,1,0,1
Ebe,0,0,1,0,1
Eb,0,0,1,0,1
EastNewYork Hospitality,1,0,0,0,1
East Village,1,0,0,0,1
Eada,1,0,0,0,1
E.C,1,0,0,0,1
E. Denise,1,0,0,0,1
E Vera,0,0,1,0,1
E Jeanne,0,0,1,0,1
Déon,1,0,0,0,1
Dynasty And Soull,0,0,1,0,1
Dymphna,0,0,1,0,1
Dwright,0,0,1,0,1
Dwarmis,0,0,1,0,1
Dwain,1,0,0,0,1
Duryea,0,0,0,1,1
Durell,0,0,1,0,1
Duran,0,0,1,0,1
Dung,1,0,0,0,1
Duncan,1,0,0,0,1
Ebul,0,0,1,0,1
Ece,0,0,0,1,1
Ed &Alexa,0,0,1,0,1
Edo,0,0,0,1,1
Efran,0,0,1,0,1
Effy,1,0,0,0,1
Ef,1,0,0,0,1
Edyana,1,0,0,0,1
Edy,1,0,0,0,1
Edwina,0,0,1,0,1
Edward And Elena,1,0,0,0,1
Edvaldo,0,0,1,0,1
Eduin,1,0,0,0,1
Edrizio,1,0,0,0,1
Edna + Isaiah,0,0,0,1,1
Ed And Heather,1,0,0,0,1
Edmee Marie,1,0,0,0,1
Edmee,1,0,0,0,1
Edmea Valeria,0,0,1,0,1
Edmarine,0,0,1,0,1
Edison,0,0,1,0,1
Edinson Jose,0,0,1,0,1
Edin,1,0,0,0,1
Edicson,0,0,1,0,1
Edel,0,0,1,0,1
Eddison,1,0,0,0,1
Elzbieta,1,0,0,0,1
Elís,0,0,1,0,1
Emalick,1,0,0,0,1
Eman,1,0,0,0,1
Eugenie,0,0,1,0,1
Etta,1,0,0,0,1
Etienne,0,0,1,0,1
Etiam,1,0,0,0,1
Etan,0,0,1,0,1
Eszter,1,0,0,0,1
Esty,1,0,0,0,1
Estrellita,1,0,0,0,1
Estrella Y.,0,0,1,0,1
Esti,1,0,0,0,1
Estella,1,0,0,0,1
Estela,1,0,0,0,1
Este,1,0,0,0,1
Essa,1,0,0,0,1
Esme,0,0,1,0,1
Esef,1,0,0,0,1
Esa-Be,1,0,0,0,1
Erwin,1,0,0,0,1
Erwan,0,0,1,0,1
Ervin,1,0,0,0,1
Erv,1,0,0,0,1
Errince,1,0,0,0,1
Ernie,1,0,0,0,1
Eun M,0,0,1,0,1
Eunice And Marc,1,0,0,0,1
Eunwoo,1,0,0,0,1
Evy,0,0,1,0,1
Eyerusalem,0,0,1,0,1
Eydie,1,0,0,0,1
Eyal And Amy,1,0,0,0,1
Eyal,1,0,0,0,1
Extend,1,0,0,0,1
Experience Host,1,0,0,0,1
Executive LeSoleil,0,1,0,0,1
Excellent,1,0,0,0,1
Ewelina,1,0,0,0,1
Ewat,1,0,0,0,1
Evianna,1,0,0,0,1
Ev,1,0,0,0,1
Evgeniya,1,0,0,0,1
Evgen,1,0,0,0,1
Everol,1,0,0,0,1
Evens And Charlene,1,0,0,0,1
Eveline,1,0,0,0,1
Evelin,0,0,1,0,1
Evaristo,0,0,1,0,1
Evangelista,0,0,1,0,1
Evandro,1,0,0,0,1
Evan & Yunna,1,0,0,0,1
Ernesto Arauz & Flory Lopez,0,0,1,0,1
Ernest,0,0,1,0,1
Erkan,0,0,1,0,1
Emine Gozde,0,0,1,0,1
Empress,0,0,1,0,1
Emory,1,0,0,0,1
Emoke,1,0,0,0,1
Emme,1,0,0,0,1
Emmanouil,1,0,0,0,1
Emma Shalom,1,0,0,0,1
Emma Leigh,1,0,0,0,1
Emma Faith,1,0,0,0,1
Emliy,1,0,0,0,1
Emir,1,0,0,0,1
Emilia And Michael,1,0,0,0,1
Emre,0,0,1,0,1
Emilee,1,0,0,0,1
Emery,1,0,0,0,1
Emerson,1,0,0,0,1
Emerald,1,0,0,0,1
Emely,1,0,0,0,1
Emeline,0,0,1,0,1
Emel,0,0,1,0,1
Emekah,1,0,0,0,1
Eme,0,0,1,0,1
Emch,1,0,0,0,1
Empressive Stays,1,0,0,0,1
Ena,1,0,0,0,1
Erjon,1,0,0,0,1
Ercio,0,0,1,0,1
Eris And Nik,0,0,1,0,1
Erina,0,0,1,0,1
Erin And Eli,1,0,0,0,1
Eriko,1,0,0,0,1
Erick Alfonso,0,0,1,0,1
Erica And Abhik,1,0,0,0,1
Erica & David,1,0,0,0,1
Eric & Satrina,1,0,0,0,1
Erez,1,0,0,0,1
Erenita,1,0,0,0,1
Equinox Hotel,0,1,0,0,1
Endless,1,0,0,0,1
Eon,1,0,0,0,1
Eoin,1,0,0,0,1
Eo,0,0,1,0,1
Enzo,0,0,1,0,1
Enyel,0,0,1,0,1
Enoma,1,0,0,0,1
Enisha,1,0,0,0,1
Enilda,1,0,0,0,1
Eniko,1,0,0,0,1
Engin,0,0,1,0,1
Chela,0,0,1,0,1
Chee,1,0,0,0,1
Chaz,0,0,1,0,1
Anayah,1,0,0,0,1
Andrés,1,0,0,0,1
Andry & Sky,1,0,0,0,1
Andromeda,0,0,1,0,1
Andriy,1,0,0,0,1
Andriele,1,0,0,0,1
Andriana,0,0,1,0,1
Andrian,1,0,0,0,1
Andrezza,1,0,0,0,1
Andrew And Katie,1,0,0,0,1
Andrew And Coline,1,0,0,0,1
Andrew And Clara,1,0,0,0,1
Andrew & Markus,1,0,0,0,1
Andres And Salina,0,0,1,0,1
Andrei,1,0,0,0,1
Andreea,1,0,0,0,1
Andreanna,0,0,1,0,1
Andrea&Luis,0,0,1,0,1
Andrea & James,1,0,0,0,1
Andraz,1,0,0,0,1
Andom,1,0,0,0,1
Andjela,0,0,1,0,1
And A Mule,1,0,0,0,1
Anchal,1,0,0,0,1
Andy & Leonardo,1,0,0,0,1
Aneel,1,0,0,0,1
Aneerban,1,0,0,0,1
Angie And Matthew,1,0,0,0,1
Aniko,1,0,0,0,1
Anika,1,0,0,0,1
Aniekan,1,0,0,0,1
Aniefiok,1,0,0,0,1
Anibal E.,1,0,0,0,1
Anhanyers,1,0,0,0,1
Anhad,1,0,0,0,1
Anh & David,1,0,0,0,1
Angmpark,1,0,0,0,1
Angly,1,0,0,0,1
Angely,0,0,1,0,1
Aneisha,0,0,1,0,1
Angelo Gabriel,1,0,0,0,1
Angella,1,0,0,0,1
Angelika,1,0,0,0,1
Angele,1,0,0,0,1
Angela Del Sol,0,0,1,0,1
Angel R.,1,0,0,0,1
Ange,0,0,1,0,1
Anfisa,0,0,1,0,1
Aneudy,1,0,0,0,1
Anelcia Carolle,1,0,0,0,1
Anca,0,0,1,0,1
Anatoly,1,0,0,0,1
Anique,1,0,0,0,1
Anatol,1,0,0,0,1
Amos Rothschild,1,0,0,0,1
Amos,0,0,1,0,1
Amobi,1,0,0,0,1
Amo,1,0,0,0,1
Amna,0,0,1,0,1
Ammar,1,0,0,0,1
Amjad,1,0,0,0,1
Amitai,1,0,0,0,1
Amita,1,0,0,0,1
Amish,1,0,0,0,1
Amira,1,0,0,0,1
Amir B,0,0,1,0,1
Aminat,0,0,1,0,1
Amina,0,0,1,0,1
Amikole,0,0,1,0,1
Amie,1,0,0,0,1
Ami,1,0,0,0,1
Ames,1,0,0,0,1
Amella,0,0,1,0,1
Amelie,0,0,1,0,1
Ameet,0,0,1,0,1
Ameer,1,0,0,0,1
Ambria,1,0,0,0,1
Amot,0,0,1,0,1
Amrane,1,0,0,0,1
Amrita,1,0,0,0,1
Anadis,1,0,0,0,1
Anat,1,0,0,0,1
Anastasiya,0,0,1,0,1
Anastasia (Tess),1,0,0,0,1
Anastacia,0,0,1,0,1
Anasha,1,0,0,0,1
Ananova,0,0,1,0,1
Anamaria,1,0,0,0,1
Analee,1,0,0,0,1
Anaiya,0,0,1,0,1
Anahit,1,0,0,0,1
Anabelle,0,0,1,0,1
AmyMichael,1,0,0,0,1
Anabella,1,0,0,0,1
Ana-Maria,1,0,0,0,1
Ana Yamel,0,0,1,0,1
Ana Paula,0,0,1,0,1
Ana María,1,0,0,0,1
Ana Maria,1,0,0,0,1
Ana Cristina,1,0,0,0,1
Ana Carolina,0,0,1,0,1
An,1,0,0,0,1
Amílcar,0,0,1,0,1
Anil,1,0,0,0,1
Anisha,1,0,0,0,1
Chavis,1,0,0,0,1
Antroy,1,0,0,0,1
Arcadie,0,0,1,0,1
Arben,1,0,0,0,1
Ararat,1,0,0,0,1
Aralis,0,0,1,0,1
Arafat,1,0,0,0,1
Aracelys,1,0,0,0,1
Arabella,1,0,0,0,1
Ara,0,0,1,0,1
Aquilia,1,0,0,0,1
Aqlesia,1,0,0,0,1
Aqila,0,0,1,0,1
Aqib,0,0,1,0,1
Apple,0,0,0,1,1
Aparna,1,0,0,0,1
Aoxue-Shelly,0,0,1,0,1
Anyika,0,0,1,0,1
Anyela,0,0,1,0,1
Anya & Marco,1,0,0,0,1
Anushua,0,0,1,0,1
Anusheh,0,0,1,0,1
Anup,1,0,0,0,1
Anuj,1,0,0,0,1
Anu -Nicole,1,0,0,0,1
Archie,1,0,0,0,1
Archina,0,0,1,0,1
Arcilesi Homberg,0,0,1,0,1
Aris,1,0,0,0,1
Arnell,1,0,0,0,1
Armine,1,0,0,0,1
Armelle,0,0,1,0,1
Arline,0,0,1,0,1
Arlette,0,0,1,0,1
Arkin & Aloni,0,0,1,0,1
Arkady,1,0,0,0,1
Arjun,1,0,0,0,1
Aristotle,0,0,1,0,1
Aristides,1,0,0,0,1
Arin,0,0,1,0,1
Ardan,1,0,0,0,1
Arikia,1,0,0,0,1
Ariela,0,0,1,0,1
Aridio,1,0,0,0,1
Arica,0,0,1,0,1
Arianna & Z,1,0,0,0,1
Ariane,0,0,1,0,1
Ariadna,1,0,0,0,1
Ari And Irin,1,0,0,0,1
Ardiana,1,0,0,0,1
Ardeana,1,0,0,0,1
António,0,0,1,0,1
Antony,1,0,0,0,1
Anissa,1,0,0,0,1
Antonis,1,0,0,0,1
Anne Gessica,1,0,0,0,1
Annalyn,0,0,1,0,1
Annalee,1,0,0,0,1
Annagrace,1,0,0,0,1
Annabella,0,0,1,0,1
Anna/Fonzy,1,0,0,0,1
Anna Sofie,1,0,0,0,1
Anna Meng,0,0,1,0,1
Anna Leah,0,0,1,0,1
Anna And Chris,0,0,1,0,1
Anna + Michael,1,0,0,0,1
AnnMarie,0,0,1,0,1
Ann/James,1,0,0,0,1
Ann-Sylvia,1,0,0,0,1
Anmarie,1,0,0,0,1
Ankita,1,0,0,0,1
Anjulika,0,0,1,0,1
Anjha'S,0,0,1,0,1
Anja,0,0,1,0,1
Anitra & Steven,1,0,0,0,1
Anitra,1,0,0,0,1
Anita-Kay,0,0,1,0,1
Anita Sorine & Peter,1,0,0,0,1
Anne Lise,0,0,1,0,1
Anne Marie,1,0,0,0,1
Anneta,1,0,0,0,1
Anqi,1,0,0,0,1
Antoni,1,0,0,0,1
Antong,0,0,1,0,1
Antoneta,1,0,0,0,1
Antoaneta,1,0,0,0,1
Antal,1,0,0,0,1
Ansley,1,0,0,0,1
Anslem,1,0,0,0,1
Anshul,0,0,1,0,1
Anshu,0,0,1,0,1
Anselmo,0,0,1,0,1
Anoushka,0,0,1,0,1
Anni,1,0,0,0,1
Anoush,1,0,0,0,1
Anouk,1,0,0,0,1
Anoop,0,0,1,0,1
Anolee,1,0,0,0,1
Anokye,1,0,0,0,1
Annushka,1,0,0,0,1
Annissa,1,0,0,0,1
Annique,0,0,1,0,1
Annika And Jon,1,0,0,0,1
Annie And Victor,1,0,0,0,1
Amber Rose,1,0,0,0,1
Amber Irene,0,0,1,0,1
Amaurys,0,0,1,0,1
Adeolu,0,0,1,0,1
Afnan,0,0,1,0,1
Affo,0,0,1,0,1
Aeon,1,0,0,0,1
Aeieyuwa,1,0,0,0,1
Adé,0,0,1,0,1
Ady,1,0,0,0,1
Adwa,0,0,1,0,1
Adriano,1,0,0,0,1
Adriaan,0,0,1,0,1
Adreinne,1,0,0,0,1
Adora,1,0,0,0,1
Adonis,1,0,0,0,1
Adolfo,0,0,1,0,1
Admin,1,0,0,0,1
Adjoa,1,0,0,0,1
Adishwar,0,0,1,0,1
Adis,1,0,0,0,1
Adir,0,0,1,0,1
Adi And Evangel,0,0,1,0,1
Adham,1,0,0,0,1
Adfia,1,0,0,0,1
Adewale,0,0,1,0,1
Adetoro,1,0,0,0,1
Afolake,0,0,1,0,1
Afriqiyah,1,0,0,0,1
Afsoon,0,0,1,0,1
Aina,0,0,1,0,1
Aissata,1,0,0,0,1
Aissa,1,0,0,0,1
Aishwarya,0,0,1,0,1
Aishah,0,0,1,0,1
Aisha & Sherwin,1,0,0,0,1
Aisabomen,0,0,1,0,1
Airamis,0,0,1,0,1
AirBnb,1,0,0,0,1
Aiping,1,0,0,0,1
Aine,0,0,1,0,1
Ailin,1,0,0,0,1
Agathe Et Francois,0,0,1,0,1
Ailee,1,0,0,0,1
Aigner,0,0,1,0,1
Aiala,1,0,0,0,1
Ahuva,1,0,0,0,1
Ahshar,1,0,0,0,1
Ahnastasia,0,0,1,0,1
Aharon,1,0,0,0,1
Agustin,1,0,0,0,1
Agueda Anaid,1,0,0,0,1
Agostina,1,0,0,0,1
Aderanti,1,0,0,0,1
Ademola,0,0,0,1,1
Amauris,1,0,0,0,1
Ademi,1,0,0,0,1
Abc,1,0,0,0,1
Abby & Kurt,1,0,0,0,1
Abbey,1,0,0,0,1
Abbe,1,0,0,0,1
Abba,1,0,0,0,1
Aba,0,0,1,0,1
Ab,1,0,0,0,1
Aarthi,0,0,1,0,1
Aamir,1,0,0,0,1
Aaleyah,1,0,0,0,1
Aalap,1,0,0,0,1
Aahliyah,0,0,1,0,1
Aafreen,1,0,0,0,1
AHm,0,0,1,0,1
A.V.,1,0,0,0,1
A.M,0,0,1,0,1
A-B,1,0,0,0,1
A J,1,0,0,0,1
@Gbuena1,1,0,0,0,1
2018Serenity,0,0,1,0,1
-TheQueensCornerLot,1,0,0,0,1
(Email hidden by Airbnb),1,0,0,0,1
(Ari) HENRY LEE,1,0,0,0,1
Abdel,1,0,0,0,1
Abdon,1,0,0,0,1
Abdou,1,0,0,0,1
Ad,1,0,0,0,1
Adelle,0,0,1,0,1
Adelaide,1,0,0,0,1
Adela,1,0,0,0,1
Adarsh,1,0,0,0,1
Adar,1,0,0,0,1
Adanna,1,0,0,0,1
Adana,1,0,0,0,1
Adamilca,0,0,1,0,1
Adama,0,0,1,0,1
Adam + Caro,1,0,0,0,1
Acima,1,0,0,0,1
Abdus,1,0,0,0,1
Achiaa,1,0,0,0,1
Achara,0,0,1,0,1
Acadia,0,0,1,0,1
Aby,1,0,0,0,1
Abinav,0,0,1,0,1
Abi,1,0,0,0,1
Abhishek,1,0,0,0,1
Abhinaya,0,0,1,0,1
Abhilasha Ashiv,1,0,0,0,1
Abe & Gail,1,0,0,0,1
Aitan,1,0,0,0,1
Aitana,1,0,0,0,1
Aja,1,0,0,0,1
Ajitpal,1,0,0,0,1
Aloft Long Island,1,0,0,0,1
Almu,1,0,0,0,1
Allyssa,1,0,0,0,1
Ally And Adam,0,0,1,0,1
Allora,1,0,0,0,1
Allia,1,0,0,0,1
Alleyne,0,0,1,0,1
Allen & Irina,1,0,0,0,1
Allam,1,0,0,0,1
Alkis,1,0,0,0,1
Alkhadher,1,0,0,0,1
Alizaveta,1,0,0,0,1
Aliyah,0,0,1,0,1
Aliya,1,0,0,0,1
Aliu,0,0,1,0,1
Alis Daniela,0,0,1,0,1
Alin,0,0,1,0,1
Alimata,0,0,1,0,1
Aliesha,0,0,0,1,1
Alienor,1,0,0,0,1
Alie And Pat,1,0,0,0,1
Alicia And Zach,0,0,1,0,1
Alican,0,0,1,0,1
Alon,0,0,1,0,1
Alorfa,0,0,1,0,1
Alsu,1,0,0,0,1
Ama,0,0,1,0,1
Amaryllis,1,0,0,0,1
Amarie2131,0,0,1,0,1
Amara,0,0,1,0,1
Amandine,0,0,1,0,1
Amanda Brooke,1,0,0,0,1
Amanda And Tanya,1,0,0,0,1
Amah,1,0,0,0,1
Amael,1,0,0,0,1
Amadu,0,0,1,0,1
Amadou,0,0,1,0,1
Am,1,0,0,0,1
Altaf,1,0,0,0,1
Alyzza Marie,1,0,0,0,1
Alyssa & Dion,1,0,0,0,1
Alyse,0,0,1,0,1
Alyona,0,0,1,0,1
Alycen,1,0,0,0,1
Alyandry,0,0,1,0,1
Alwyn,1,0,0,0,1
Alvern,0,0,1,0,1
Alva,0,0,0,1,1
Altagracia,1,0,0,0,1
Aliana,0,0,1,0,1
Ali Nicole,1,0,0,0,1
Ali And Amy,1,0,0,0,1
Aktina,0,0,1,0,1
Alberta,0,0,1,0,1
Albena,0,0,1,0,1
Alaric,0,0,1,0,1
Alanah,0,0,0,1,1
Alaina,1,0,0,0,1
AlFatiha,0,0,1,0,1
Al-Nisa,0,0,1,0,1
Al-,1,0,0,0,1
Al Amin,1,0,0,0,1
Akua,1,0,0,0,1
Akon,1,0,0,0,1
Alea Malay,0,0,1,0,1
Akio,1,0,0,0,1
Akino,0,0,1,0,1
Akini,1,0,0,0,1
Akim,0,0,1,0,1
Akili,1,0,0,0,1
Akiea,1,0,0,0,1
Akhil,1,0,0,0,1
Akene,1,0,0,0,1
Akem & Terry,1,0,0,0,1
Akeel,1,0,0,0,1
Aldo,1,0,0,0,1
Alebert,1,0,0,0,1
Alfred And Lau,0,0,1,0,1
Alex & Yoly,1,0,0,0,1
Alfie,1,0,0,0,1
Alexus,0,0,1,0,1
Alexisz Tamás,1,0,0,0,1
Alexi & Brendan,0,0,1,0,1
Alexandru,1,0,0,0,1
Alexandr,1,0,0,0,1
Alex&Ivy,1,0,0,0,1
Alex And Tatiana,1,0,0,0,1
Alex And Lindsey,1,0,0,0,1
Alex And Dre,1,0,0,0,1
Alex & Family,1,0,0,0,1
Alecza,1,0,0,0,1
Alethea,1,0,0,0,1
Alester,0,0,1,0,1
Alesia,1,0,0,0,1
Alesandra,0,0,1,0,1
Aleksej,1,0,0,0,1
Alek,1,0,0,0,1
Alejo,1,0,0,0,1
Alejandro Bilbao,1,0,0,0,1
Alejandrina,0,0,1,0,1
Aleeen,1,0,0,0,1
Arnitta,1,0,0,0,1
Arnol,0,0,1,0,1
Arnoluis,1,0,0,0,1
Brittani,1,0,0,0,1
Burtay,1,0,0,0,1
Burt,1,0,0,0,1
Burim,1,0,0,0,1
Burak,0,0,1,0,1
Bunge,0,0,1,0,1
Buke,1,0,0,0,1
Brígida,0,0,1,0,1
Brysen,0,0,1,0,1
Bryn,0,0,1,0,1
Bryanne,0,0,1,0,1
Bryan And Sasha,1,0,0,0,1
Brou,0,0,1,0,1
Brooke & Jonathan,0,0,1,0,1
Brook,1,0,0,0,1
Bronwyn,1,0,0,0,1
Bronislaw,0,0,1,0,1
Brodii,1,0,0,0,1
Brizzo,0,0,1,0,1
Brittni,0,0,1,0,1
Brittnee,0,0,1,0,1
Brittini,1,0,0,0,1
Brittany Nicole,1,0,0,0,1
Brittanirose,0,0,1,0,1
Busra,0,0,1,0,1
Butchie,0,0,1,0,1
C Alexander,1,0,0,0,1
Caio,1,0,0,0,1
Camiren,1,0,0,0,1
Camillia,1,0,0,0,1
Camille-Bettina,0,0,1,0,1
Camilla,1,0,0,0,1
Camil,1,0,0,0,1
Cameran,1,0,0,0,1
Calixto,1,0,0,0,1
Calen,1,0,0,0,1
Caitie,0,0,1,0,1
Cait,1,0,0,0,1
Caila,0,0,1,0,1
C Lum,0,0,1,0,1
Cai,0,0,1,0,1
Cagla,0,0,1,0,1
Cagkan,0,0,1,0,1
Cacho,0,0,1,0,1
Ca,0,0,1,0,1
CK & Tia,0,0,1,0,1
CJ & Raissa,1,0,0,0,1
CCC International,1,0,0,0,1
C.S.,1,0,0,0,1
C.D.,0,0,0,1,1
Brittanie,1,0,0,0,1
Brittan,1,0,0,0,1
Bjorn,0,0,1,0,1
Britnee,1,0,0,0,1
Bradach,1,0,0,0,1
Bowie,0,0,1,0,1
Boryana,1,0,0,0,1
Borja,1,0,0,0,1
Bono,1,0,0,0,1
Bonissat,0,0,1,0,1
Bojana,1,0,0,0,1
Boja,1,0,0,0,1
Boer,0,0,1,0,1
Boem,0,0,1,0,1
Boehm,1,0,0,0,1
Boddy Joan,0,0,1,0,1
Bobby And Ruth,1,0,0,0,1
Bobbie Ysabel,1,0,0,0,1
Bo,0,0,1,0,1
Blythe,1,0,0,0,1
Blue,1,0,0,0,1
Blossom A,1,0,0,0,1
Bliss,1,0,0,0,1
Bless,0,0,1,0,1
Bleik,0,0,1,0,1
Blair & Brian,1,0,0,0,1
Blaine,0,0,1,0,1
Braham,1,0,0,0,1
Braily,0,0,1,0,1
Bramble,1,0,0,0,1
Brene,1,0,0,0,1
Britani,0,0,1,0,1
Brita,0,0,1,0,1
Brinn,1,0,0,0,1
Brighton,1,0,0,0,1
Briania,1,0,0,0,1
"Brian,Gigi & Clementine",1,0,0,0,1
Brian And Rachel,1,0,0,0,1
Brian & Arlette,0,0,1,0,1
Bret,0,0,1,0,1
Brennan,0,0,1,0,1
Brenden,1,0,0,0,1
Branden,1,0,0,0,1
Brekat,0,0,1,0,1
Breanne,1,0,0,0,1
Breanna,1,0,0,0,1
Brayler,0,0,1,0,1
Braydon,1,0,0,0,1
Brayan,0,0,1,0,1
Braulio,0,0,1,0,1
Brant,1,0,0,0,1
Brandy-Courtney,1,0,0,0,1
Brando,1,0,0,0,1
Campbell,1,0,0,0,1
Campo Elias,0,0,1,0,1
Canan,1,0,0,0,1
Candacy,0,0,1,0,1
Challen,1,0,0,0,1
Chaima,0,0,1,0,1
Chai,0,0,1,0,1
Chahine,0,0,1,0,1
Chaehyun,1,0,0,0,1
Cha,1,0,0,0,1
Cesca,1,0,0,0,1
Ceri,1,0,0,0,1
Cemi,1,0,0,0,1
Celsa,0,0,1,0,1
Celena,1,0,0,0,1
Ceilidh,0,0,1,0,1
Cefi,1,0,0,0,1
Cedric,1,0,0,0,1
Cecily,1,0,0,0,1
Cecil,0,0,1,0,1
Ceci,1,0,0,0,1
Cecca,0,0,1,0,1
Cayla,1,0,0,0,1
Catriona,1,0,0,0,1
Catrina,1,0,0,0,1
Catmom,1,0,0,0,1
Catlin,1,0,0,0,1
Challie,1,0,0,0,1
Champson,0,0,1,0,1
Chan,0,0,1,0,1
Charlayne,1,0,0,0,1
Chavi,1,0,0,0,1
Chau,1,0,0,0,1
Charo,0,0,1,0,1
Charlène,1,0,0,0,1
Charly,1,0,0,0,1
Charline,1,0,0,0,1
Charlie & Dianna,1,0,0,0,1
Charleston,0,0,1,0,1
Charles-Hugo,0,0,1,0,1
Charlemagne,0,0,1,0,1
Charis,0,0,1,0,1
Chance,1,0,0,0,1
Charese,1,0,0,0,1
Chao,0,0,1,0,1
Chantou,0,0,1,0,1
Chantelle,1,0,0,0,1
Chantel,1,0,0,0,1
Channing,1,0,0,0,1
Chanette,0,0,1,0,1
Chandraki,0,0,1,0,1
Chandler,0,0,1,0,1
Chandan,1,0,0,0,1
Catiriana,1,0,0,0,1
Catiana,1,0,0,0,1
Cathie,1,0,0,0,1
Carleen,1,0,0,0,1
Carlynn,1,0,0,0,1
Carly & Sebastian,1,0,0,0,1
Carlotta,1,0,0,0,1
Carlos Esteban,0,0,1,0,1
Carlo Fabricio,1,0,0,0,1
Carline,1,0,0,0,1
Carlina,0,0,1,0,1
Carli,1,0,0,0,1
Carles,0,0,1,0,1
Carleigh,1,0,0,0,1
Carla & Ken,1,0,0,0,1
Carmelo,0,0,1,0,1
Carl Owen,1,0,0,0,1
Carinne,0,0,1,0,1
Carini,0,0,1,0,1
Carine,0,0,1,0,1
Carethia,0,0,1,0,1
Cannon,1,0,0,0,1
Candyce,1,0,0,0,1
Candy,0,0,1,0,1
Candlewood Suites Times Square,1,0,0,0,1
Candia,1,0,0,0,1
Carme,1,0,0,0,1
Carmenjaz,1,0,0,0,1
Cathia,0,0,1,0,1
Caré,0,0,1,0,1
Catharine,1,0,0,0,1
Cath,1,0,0,0,1
Catarina,1,0,0,0,1
Cassy,1,0,0,0,1
Cassondra,1,0,0,0,1
Cassidy,0,0,1,0,1
Cassi,1,0,0,0,1
Casimir,1,0,0,0,1
Casandra,1,0,0,0,1
Casain,1,0,0,0,1
Carvi Hotel,0,1,0,0,1
Carmia And Joe,1,0,0,0,1
Cartier,1,0,0,0,1
Carron,1,0,0,0,1
Caroline & Georg,0,0,1,0,1
Caroline & Charlie,1,0,0,0,1
Carolanne,1,0,0,0,1
Carolann,1,0,0,0,1
Carol-Anne,0,0,1,0,1
Carmine Pio,1,0,0,0,1
Carmine,0,0,1,0,1
Carmichael,1,0,0,0,1
Blackfoot,1,0,0,0,1
Bj,0,0,1,0,1
Arosha,0,0,1,0,1
Audia,1,0,0,0,1
Avriel,1,0,0,0,1
Avri,0,0,1,0,1
Avremi And Shmuly,0,0,1,0,1
Avner,1,0,0,0,1
Aviv,1,0,0,0,1
Avital,1,0,0,0,1
Avijit,0,0,1,0,1
Avihay,1,0,0,0,1
Avigdor,1,0,0,0,1
Aviel,1,0,0,0,1
Avia,0,0,1,0,1
Avery Mark,1,0,0,0,1
Auzi,0,0,1,0,1
Ausra,1,0,0,0,1
Aushra,1,0,0,0,1
Aurelie,0,0,1,0,1
Aurea,1,0,0,0,1
Auran,1,0,0,0,1
Aunim,1,0,0,0,1
Aunik,1,0,0,0,1
Auminea,0,0,1,0,1
Augustus,1,0,0,0,1
Augustina,0,0,1,0,1
Avto,0,0,1,0,1
Axay,1,0,0,0,1
Ayele,0,0,1,0,1
Azza,0,0,1,0,1
Baijing,1,0,0,0,1
Bahshillo,1,0,0,0,1
Bahiyyah,0,0,1,0,1
Badreddin (Ben),1,0,0,0,1
Baden,0,0,1,0,1
Bada,1,0,0,0,1
Babatunde,1,0,0,0,1
BKLYN Chic,1,0,0,0,1
B Management,0,0,1,0,1
B Ali,0,0,1,0,1
Aziz,0,0,1,0,1
Aygul,1,0,0,0,1
Azi,1,0,0,0,1
Az,1,0,0,0,1
Ayoub,0,0,1,0,1
Ayoola,1,0,0,0,1
Ayodele,0,0,1,0,1
Ayo,0,0,1,0,1
Ayman,1,0,0,0,1
Ayla,0,0,1,0,1
Aykut,0,0,1,0,1
Ayhan,1,0,0,0,1
Augustin,1,0,0,0,1
Aude,1,0,0,0,1
Bismar Javier,0,0,0,1,1
Atta,0,0,1,0,1
Ashkon,0,0,1,0,1
Ashanty,1,0,0,0,1
Ashanti,1,0,0,0,1
Asfandiyar,0,0,1,0,1
Asen,0,0,1,0,1
Asema,0,0,1,0,1
Arzu,1,0,0,0,1
Aryuna,1,0,0,0,1
Aryn,1,0,0,0,1
Arya,1,0,0,0,1
Ary,1,0,0,0,1
Arunima,1,0,0,0,1
Arunchandra,0,0,1,0,1
Arun,1,0,0,0,1
Artur Elias Jossi,1,0,0,0,1
Artur,0,0,1,0,1
Arti,0,0,1,0,1
Artez,1,0,0,0,1
Artemisia,1,0,0,0,1
Artemie,1,0,0,0,1
Arshad,1,0,0,0,1
Arsenio,1,0,0,0,1
Arpan,0,0,1,0,1
Ashlene,1,0,0,0,1
Ashley Otilia,0,0,1,0,1
Ashmita,1,0,0,0,1
Assia,0,0,1,0,1
Atsuko & Peter,1,0,0,0,1
Atma,1,0,0,0,1
Atieh,1,0,0,0,1
Atia,1,0,0,0,1
Athlee,0,0,0,1,1
Atherly,0,0,1,0,1
Athanasios,0,0,1,0,1
Atay,1,0,0,0,1
Aswini,1,0,0,0,1
Assiati And Tonderai,1,0,0,0,1
Asshur,0,0,1,0,1
Ashraf,1,0,0,0,1
Assan,0,0,1,0,1
Assaf,1,0,0,0,1
Aspano,1,0,0,0,1
Asim,1,0,0,0,1
Asil,1,0,0,0,1
Asijah,0,0,1,0,1
Asiatic,1,0,0,0,1
Ashwin,0,0,1,0,1
Ashumi,1,0,0,0,1
Ashton,0,0,1,0,1
Baizy,1,0,0,0,1
Bakare,0,0,1,0,1
Baker,0,0,1,0,1
Balla,0,0,1,0,1
Betsie,1,0,0,0,1
Betsaida,0,0,1,0,1
Bethany,1,0,0,0,1
Bethania,0,0,1,0,1
Bess,1,0,0,0,1
Besnik,1,0,0,0,1
Besanya,0,0,1,0,1
Bertte,1,0,0,0,1
Bertran,1,0,0,0,1
Bertide,1,0,0,0,1
Berta,1,0,0,0,1
Bert,1,0,0,0,1
Bersabel,0,0,1,0,1
Berny,1,0,0,0,1
Bernadene,1,0,0,0,1
Berel,1,0,0,0,1
Bentley,1,0,0,0,1
Benson,1,0,0,0,1
Benoit,1,0,0,0,1
Bennett,1,0,0,0,1
Benjamín,0,0,1,0,1
Benito,0,0,1,0,1
Bengu,1,0,0,0,1
Betsy,1,0,0,0,1
Bettinna,0,0,1,0,1
Betul,1,0,0,0,1
Billie,1,0,0,0,1
Birch,1,0,0,0,1
Birce,1,0,0,0,1
Binxiong,1,0,0,0,1
Binta,1,0,0,0,1
Bingham,1,0,0,0,1
Bindia,0,0,1,0,1
Bina,0,0,1,0,1
Bilyana,1,0,0,0,1
Billye,1,0,0,0,1
Billy And Anastasia,1,0,0,0,1
Billel,0,0,1,0,1
Bev,1,0,0,0,1
Bilal,1,0,0,0,1
Bijan,1,0,0,0,1
Biggi,0,0,1,0,1
Bifan,0,0,1,0,1
Bidya,0,0,1,0,1
Bianca And Yotam,1,0,0,0,1
Bianca And Jordan,1,0,0,0,1
Bhavin,0,0,1,0,1
Bharat,1,0,0,0,1
Beyza,0,0,1,0,1
Benco,0,0,1,0,1
Ben And Jane,1,0,0,0,1
Bembe,0,0,1,0,1
Barbra,0,0,1,0,1
Bashiri,1,0,0,0,1
Bartolomeo,1,0,0,0,1
Barthelemy,1,0,0,0,1
Bart,1,0,0,0,1
Barry And Patrick,0,0,1,0,1
Barron,0,0,1,0,1
Barrie,0,0,1,0,1
Barrett,1,0,0,0,1
Barr,0,0,1,0,1
Bari,1,0,0,0,1
Barblin,1,0,0,0,1
Basil And Jacqueline,1,0,0,0,1
Barbie,0,0,1,0,1
Barbar,0,0,1,0,1
Bara,0,0,1,0,1
Bar,1,0,0,0,1
Baqer,0,0,1,0,1
Baochen,0,0,1,0,1
Baochan,0,0,1,0,1
Banu,0,0,1,0,1
Banna,1,0,0,0,1
Bandar,1,0,0,0,1
Basil,0,0,1,0,1
Basim,1,0,0,0,1
Beloved Homes Away,1,0,0,0,1
Beethoven,0,0,1,0,1
Bellyn,0,0,1,0,1
Bello Suites,1,0,0,0,1
Bellamy,1,0,0,0,1
Belladonna,1,0,0,0,1
Bell,1,0,0,0,1
Belgin,0,0,1,0,1
Bel And,0,0,1,0,1
Bei Lei,1,0,0,0,1
Begüm,0,0,1,0,1
Beewee,0,0,1,0,1
Becky And John,1,0,0,0,1
Bassam,1,0,0,0,1
Beck,0,0,1,0,1
Beacon Hotel,0,1,0,0,1
Be,1,0,0,0,1
Bb,0,0,1,0,1
Bayly,0,0,1,0,1
Baylie,1,0,0,0,1
Batya,1,0,0,0,1
Batia,1,0,0,0,1
Batho,1,0,0,0,1
Bassia,0,0,1,0,1
Gilford,0,0,1,0,1
Gili,1,0,0,0,1
Gill,1,0,0,0,1
Libia,0,0,1,0,1
Linnea,0,0,1,0,1
Lingzi,0,0,1,0,1
Lindsee And Peter,1,0,0,0,1
Lindsay B,1,0,0,0,1
Lindon,1,0,0,0,1
Linda Jo,1,0,0,0,1
Lincinco,1,0,0,0,1
Limor,1,0,0,0,1
Lily Lihting  Li,0,0,1,0,1
Lillo,0,0,1,0,1
Lillie,1,0,0,0,1
Liliya,1,0,0,0,1
Lilibeth,0,0,1,0,1
Lili Rosa,1,0,0,0,1
Lili,1,0,0,0,1
Lila (Eli),0,0,1,0,1
Likowsky,0,0,1,0,1
Lika-Alley,0,0,1,0,1
Lijing,1,0,0,0,1
Ligel,0,0,1,0,1
Lidu,0,0,1,0,1
Lidice,0,0,1,0,1
Lida,1,0,0,0,1
Linsey,1,0,0,0,1
Linus,1,0,0,0,1
Lio,0,0,1,0,1
Liuciferis,1,0,0,0,1
Loc,0,0,1,0,1
Lluvia,0,0,1,0,1
Llenifer,1,0,0,0,1
Lizzy,1,0,0,0,1
Lizhen,0,0,1,0,1
Lizavero,1,0,0,0,1
Lixia,1,0,0,0,1
Livinus,0,0,1,0,1
Live,1,0,0,0,1
Liusha,1,0,0,0,1
Liu,1,0,0,0,1
Lior,0,0,1,0,1
Litza,1,0,0,0,1
Litri,0,0,1,0,1
Lissett,1,0,0,0,1
Liselotte,0,0,1,0,1
Lisbeth,1,0,0,0,1
Lisanias,1,0,0,0,1
Lisah,0,0,1,0,1
"Lisa, Nancy & John",0,0,1,0,1
Lisa (Kausiliyia),0,0,1,0,1
Liran,1,0,0,0,1
Lica,1,0,0,0,1
Libertad,1,0,0,0,1
Lone,1,0,0,0,1
Libenson,0,0,1,0,1
Leone,1,0,0,0,1
Leonarda,1,0,0,0,1
Leonard Valentino,0,0,1,0,1
Leona,1,0,0,0,1
Leon Hotel LES,0,1,0,0,1
Leojohn,1,0,0,0,1
Lenora,1,0,0,0,1
Lenny & Lena,0,0,1,0,1
Lennay,0,0,1,0,1
Lenka,1,0,0,0,1
Lenissima,0,0,1,0,1
Lenin,1,0,0,0,1
Lendale,0,0,1,0,1
Lelis,0,0,1,0,1
Lelia,1,0,0,0,1
Leli,1,0,0,0,1
Leland,0,0,1,0,1
Lela,0,0,1,0,1
Leiya,0,0,1,0,1
Leisa,0,0,1,0,1
Leilany,0,0,1,0,1
Leighton,1,0,0,0,1
Leigha,0,0,1,0,1
Leora And Adi,1,0,0,0,1
Leroy,0,0,1,0,1
Lesar,1,0,0,0,1
Lex Hotel,0,1,0,0,1
Libby,1,0,0,0,1
Liba,1,0,0,0,1
Lianne,1,0,0,0,1
Liang,0,0,1,0,1
LiVi,1,0,0,0,1
Lhea Gia,1,0,0,0,1
Leïla,1,0,0,0,1
Lezhang,1,0,0,0,1
Lexy,1,0,0,0,1
Lexus,0,0,1,0,1
Lex And Raun,1,0,0,0,1
Lesia,1,0,0,0,1
Lex,1,0,0,0,1
Lewis,1,0,0,0,1
Lewi,0,0,1,0,1
Levent,1,0,0,0,1
Levadieu,0,0,1,0,1
Leva,1,0,0,0,1
Letisha,0,0,1,0,1
Letha M.,1,0,0,0,1
Lesvia,1,0,0,0,1
Leslibeth,0,0,1,0,1
Lois,0,0,1,0,1
Loni,0,0,1,0,1
Keyonna,1,0,0,0,1
Luxi,1,0,0,0,1
Maayan,0,0,1,0,1
Maarouf,1,0,0,0,1
Ma,0,0,1,0,1
MJ Rentals,1,0,0,0,1
ME Spots,1,0,0,0,1
MD Ismail,1,0,0,0,1
M.J.,0,0,1,0,1
M&J,1,0,0,0,1
M Nurul,1,0,0,0,1
Léa,0,0,1,0,1
Lywon,1,0,0,0,1
Lysia,0,0,1,0,1
Lys,1,0,0,0,1
Lyora,0,0,1,0,1
Lyoka,1,0,0,0,1
Lynette,1,0,0,0,1
Lynda,1,0,0,0,1
Lym,1,0,0,0,1
Lyle,1,0,0,0,1
Lyjah,1,0,0,0,1
Luzmar,0,0,1,0,1
Luz Marina,0,0,1,0,1
Luz Dary,0,0,1,0,1
Maba,1,0,0,0,1
MacKenzie,1,0,0,0,1
Mack,0,0,1,0,1
Mads,0,0,1,0,1
Maggie And Victor,0,0,1,0,1
Magera,1,0,0,0,1
Magen,0,0,1,0,1
Magda & Ian,1,0,0,0,1
Magd,0,0,1,0,1
Magalita,1,0,0,0,1
Magalie,1,0,0,0,1
Mafer,1,0,0,0,1
Maen,0,0,1,0,1
Mae,1,0,0,0,1
Madisun,1,0,0,0,1
Mackenson,1,0,0,0,1
Madina,1,0,0,0,1
Madhu,1,0,0,0,1
Madhavi,1,0,0,0,1
Madelline,1,0,0,0,1
Madelaine,1,0,0,0,1
Madel,1,0,0,0,1
Maddy,0,0,1,0,1
Maddine,1,0,0,0,1
Maddalena,1,0,0,0,1
Madalyn,1,0,0,0,1
Luxury,1,0,0,0,1
Lux,0,0,1,0,1
Lonnie,1,0,0,0,1
Luwam,1,0,0,0,1
Luciano,1,0,0,0,1
Luchiano,1,0,0,0,1
Loylexia,1,0,0,0,1
Lowell,1,0,0,0,1
Lourdie,0,0,1,0,1
Louizos Alexandros,0,0,1,0,1
Louise & Thomas,1,0,0,0,1
LouisandCarroleHoldings,0,0,1,0,1
Loue,1,0,0,0,1
Loubna,1,0,0,0,1
Lotte Elisa,1,0,0,0,1
Lory And Cindy,1,0,0,0,1
Lorin,1,0,0,0,1
Lorien,0,0,1,0,1
Loretha,0,0,1,0,1
Loreley,0,0,1,0,1
Lorelei & Alex,0,0,1,0,1
Lorcán,0,0,1,0,1
Lorand,0,0,1,0,1
Loralee,0,0,1,0,1
Lor,0,0,1,0,1
Loocid,0,0,1,0,1
Lonya,1,0,0,0,1
Lucien,1,0,0,0,1
Lucilu,0,0,1,0,1
Lucina,1,0,0,0,1
Luiz Henrique,0,0,1,0,1
Lutfu,1,0,0,0,1
Luster,0,0,1,0,1
Luping,1,0,0,0,1
Lungile P,1,0,0,0,1
Lunara,0,0,1,0,1
Luna Maria,0,0,1,0,1
Lun,0,0,1,0,1
Lumin And Hendrik,0,0,1,0,1
Luke A,1,0,0,0,1
Luka,0,0,1,0,1
LuisFelipe,1,0,0,0,1
Lucinda,1,0,0,0,1
Luis&Victor,0,0,1,0,1
Luis Fernando,1,0,0,0,1
Luis Alejandro,0,0,1,0,1
Luigi,1,0,0,0,1
Luiggi,1,0,0,0,1
Luequita,0,0,1,0,1
Ludine,0,0,1,0,1
Lucía,0,0,1,0,1
Lucyna,1,0,0,0,1
Lucineia,1,0,0,0,1
Leif,1,0,0,0,1
Leidis,1,0,0,0,1
Leesha,0,0,1,0,1
Kitt,1,0,0,0,1
Kris & Genevieve,1,0,0,0,1
Kris & Daniela,0,0,1,0,1
Kreshnik,1,0,0,0,1
Kostas,1,0,0,0,1
Kosta,0,0,1,0,1
Kossivi,0,0,1,0,1
Kosha,0,0,1,0,1
Kooky,1,0,0,0,1
Konsulta,1,0,0,0,1
Konstantine,1,0,0,0,1
Konstantin,0,0,1,0,1
Konrad,1,0,0,0,1
Konni,1,0,0,0,1
Komako,1,0,0,0,1
Komail,1,0,0,0,1
Kole,1,0,0,0,1
Koku,0,0,1,0,1
Kojenwa,0,0,1,0,1
Koen,1,0,0,0,1
Kody,0,0,1,0,1
Knut Olav,0,0,1,0,1
Kizzy,1,0,0,0,1
Kizzie,1,0,0,0,1
Kristal,0,0,1,0,1
Kristan,0,0,1,0,1
Kristee,0,0,1,0,1
Krystina,1,0,0,0,1
Kusang,0,0,1,0,1
Kurtney,1,0,0,0,1
Kurtis,1,0,0,0,1
Kunjan,1,0,0,0,1
Kunal,0,0,1,0,1
Kumara,1,0,0,0,1
Kuma,0,0,1,0,1
Kujtim,1,0,0,0,1
Kudirat,1,0,0,0,1
Kuang,0,0,1,0,1
Krysta,0,0,1,0,1
Kristen & Aaron,1,0,0,0,1
Krys,1,0,0,0,1
Krongporn,1,0,0,0,1
KrongKrang,0,0,1,0,1
Kritika,0,0,1,0,1
'Cil,0,0,1,0,1
Krisztina,1,0,0,0,1
Kristyn,0,0,1,0,1
Kristofer,1,0,0,0,1
Kristianne,0,0,1,0,1
Kristi,1,0,0,0,1
Kitti,0,0,1,0,1
Kishorie,1,0,0,0,1
Leesa,0,0,1,0,1
Kishore,1,0,0,0,1
Kiela,1,0,0,0,1
Kibel,0,0,1,0,1
Kiarra,0,0,1,0,1
KiM,0,0,1,0,1
Ki,1,0,0,0,1
Khori,1,0,0,0,1
Kheira,1,0,0,0,1
Khatia,1,0,0,0,1
Kharay,1,0,0,0,1
Khansa,1,0,0,0,1
Khan,1,0,0,0,1
Kham,0,0,1,0,1
Khalil,1,0,0,0,1
Khalifa,1,0,0,0,1
Khalif,0,0,1,0,1
Khaleed,1,0,0,0,1
Khairul,1,0,0,0,1
Khadijah,1,0,0,0,1
Khadhyja,1,0,0,0,1
Khadeeja,0,0,1,0,1
Khad,0,0,1,0,1
Keziah,1,0,0,0,1
Kezia,1,0,0,0,1
Kieron,1,0,0,0,1
Kiersten,0,0,1,0,1
Kijin,1,0,0,0,1
Kimyon,1,0,0,0,1
Kishma,1,0,0,0,1
Kirt,1,0,0,0,1
Kiril,1,0,0,0,1
Kiriko,1,0,0,0,1
Kiri,0,0,1,0,1
Kirac,1,0,0,0,1
Kinyarda,0,0,1,0,1
Kinnara,0,0,1,0,1
Kinna,0,0,1,0,1
Kinga,1,0,0,0,1
Kimesha,0,0,1,0,1
Kika,0,0,1,0,1
Kimberly Nicky,0,0,1,0,1
Kimberle,1,0,0,0,1
Kimbe,1,0,0,0,1
Kimball,1,0,0,0,1
Kim Ashley,1,0,0,0,1
Kim  And  Jordan,1,0,0,0,1
Kilroy,1,0,0,0,1
Kilian,1,0,0,0,1
Kilandra,0,0,1,0,1
Kike,1,0,0,0,1
Kv,1,0,0,0,1
Kwabena,1,0,0,0,1
Kwadwo,1,0,0,0,1
Kwam,1,0,0,0,1
Laural,1,0,0,0,1
Laura Y Abraham,0,0,0,1,1
Laura C,0,0,1,0,1
Laura And Robert,0,0,1,0,1
Laura & Antonio,1,0,0,0,1
Laur,1,0,0,0,1
Lature,1,0,0,0,1
Latrisha,0,0,1,0,1
Latreil,0,0,1,0,1
Latiea,0,0,0,1,1
Lateef,0,0,1,0,1
Latecia,0,0,1,0,1
Latane,1,0,0,0,1
Laszlo Jakab,1,0,0,0,1
Lashawn,1,0,0,0,1
Lasata,1,0,0,0,1
Lary,1,0,0,0,1
Lars Byrresen,1,0,0,0,1
Lars,0,0,1,0,1
Larry Raul,0,0,1,0,1
Larance,1,0,0,0,1
Lao,0,0,0,1,1
Lanny,0,0,1,0,1
Laurance,0,0,1,0,1
Lauren & Ron,1,0,0,0,1
Laurent And Marion,1,0,0,0,1
LeKethia,1,0,0,0,1
Leeore,1,0,0,0,1
LeeAnne,0,0,1,0,1
LeeAnn,1,0,0,0,1
Lee And Tara,0,0,1,0,1
Lee And Avery,1,0,0,0,1
Ledora,1,0,0,0,1
Leanna,0,0,1,0,1
Leandro And Julia,0,0,1,0,1
Leander,1,0,0,0,1
Leala,0,0,1,0,1
Le Roux,0,0,1,0,1
Laurène,0,0,1,0,1
Layton,1,0,0,0,1
Layth,1,0,0,0,1
Layna,1,0,0,0,1
Layle-Stav,1,0,0,0,1
Laye,1,0,0,0,1
Law,1,0,0,0,1
Lavonne,1,0,0,0,1
Laverne & David,1,0,0,0,1
Lavell,1,0,0,0,1
Lavar,0,0,1,0,1
Lannon,0,0,1,0,1
Lanee,1,0,0,0,1
Landy,1,0,0,0,1
Kyron,0,0,1,0,1
La Toya,1,0,0,0,1
La Quinta Central Park,0,0,1,0,1
L.,1,0,0,0,1
L'Equipe,1,0,0,0,1
L'Ay,0,0,1,0,1
L Gerard,1,0,0,0,1
L A,1,0,0,0,1
Kyungtae,1,0,0,0,1
Kyungho,1,0,0,0,1
Kyuhoon,1,0,0,0,1
Kyrié,0,0,1,0,1
LaShauna,1,0,0,0,1
Kyriaki,1,0,0,0,1
Kyoung,1,0,0,0,1
Kymberly,1,0,0,0,1
Kylia,0,0,1,0,1
Kylee,1,0,0,0,1
Kyisha,1,0,0,0,1
Ky,1,0,0,0,1
Kwana,1,0,0,0,1
Kwame-Eve,0,0,1,0,1
Kwame,0,0,1,0,1
LaMont,0,0,1,0,1
LaSon,1,0,0,0,1
Landon,1,0,0,0,1
Lakeisha,0,0,1,0,1
Lancelot,0,0,1,0,1
Lamont,1,0,0,0,1
Lamark,0,0,1,0,1
Laly,1,0,0,0,1
Lalita,1,0,0,0,1
Lalit,0,0,1,0,1
Lalibela,1,0,0,0,1
Lali,1,0,0,0,1
Lakshey,0,0,0,1,1
Lakis,0,0,1,0,1
Laina,0,0,1,0,1
Labeat,1,0,0,0,1
Laimute,1,0,0,0,1
Lailee,1,0,0,0,1
Lagane,0,0,1,0,1
Laferne,1,0,0,0,1
LadyShepsa,0,0,1,0,1
Lady Jay,1,0,0,0,1
Lacy,1,0,0,0,1
Lachlan,1,0,0,0,1
Labib,0,0,1,0,1
Labella,0,0,1,0,1
Magnificent Mohamad,0,0,1,0,1
Magnus,1,0,0,0,1
Mahalia,1,0,0,0,1
MiKayla,0,0,1,0,1
Michion,0,0,1,0,1
Michi,1,0,0,0,1
Michelle And Gordon,1,0,0,0,1
Michelle & Heddy,0,0,1,0,1
Michelle & Benjamín,0,0,1,0,1
Michella,1,0,0,0,1
Micheal,0,0,1,0,1
Michaël,1,0,0,0,1
Michal And John,1,0,0,0,1
Michaelle,1,0,0,0,1
Michael J,0,0,1,0,1
Michael Dan,0,0,1,0,1
Michael +Jenelle,0,0,1,0,1
Michael & Sharon,1,0,0,0,1
Michael & Sandy,1,0,0,0,1
Michael & Katherine,1,0,0,0,1
Michael & Bethany,1,0,0,0,1
Michael & Aleksandra,0,0,1,0,1
Michael & Ade,1,0,0,0,1
Micela,1,0,0,0,1
Micaela,0,0,0,1,1
Mica,0,0,1,0,1
Miao,0,0,0,1,1
Michka,1,0,0,0,1
Michèle,1,0,0,0,1
Mick,1,0,0,0,1
Mike And Lori,1,0,0,0,1
Milica,0,0,1,0,1
Milenna,1,0,0,0,1
Mildred,0,0,1,0,1
Milagros,1,0,0,0,1
Mila,1,0,0,0,1
Mil,0,0,1,0,1
Mikki & Doni,1,0,0,0,1
Mikhael,1,0,0,0,1
Mikeebel,1,0,0,0,1
Mike&Mavi,0,0,1,0,1
Mike & Casey,1,0,0,0,1
Mick & Heidi,1,0,0,0,1
Mikalena,0,0,1,0,1
Mikako,1,0,0,0,1
Mihika,0,0,0,1,1
Mihalis,1,0,0,0,1
Mihai,1,0,0,0,1
Miguelito,0,0,1,0,1
Mie,0,0,1,0,1
Micky,0,0,1,0,1
Mickel,0,0,1,0,1
Mickael,1,0,0,0,1
Mian,1,0,0,0,1
Mi,1,0,0,0,1
McKenzie,1,0,0,0,1
Mfoniso,0,0,1,0,1
Melinda & Matilda,1,0,0,0,1
Meli,1,0,0,0,1
Melena,1,0,0,0,1
Melekh,1,0,0,0,1
Melbourne,0,0,1,0,1
Mekado,1,0,0,0,1
Meka,1,0,0,0,1
Mejbah,0,0,1,0,1
Meja Hilde,0,0,1,0,1
Mehfuz,1,0,0,0,1
Mehedhi,1,0,0,0,1
Mehdi,1,0,0,0,1
Meghana,0,0,1,0,1
Megha,1,0,0,0,1
Megan & Erica,1,0,0,0,1
Meerim,1,0,0,0,1
Meenawatti,1,0,0,0,1
Meejee,0,0,1,0,1
Medeline,1,0,0,0,1
Mea,1,0,0,0,1
Me'Lissa,0,0,1,0,1
Mckinley,1,0,0,0,1
Mckenzie,1,0,0,0,1
Melisa,1,0,0,0,1
Melitza,1,0,0,0,1
Melizza,1,0,0,0,1
Merle,0,0,1,0,1
Mez,0,0,1,0,1
Mey,1,0,0,0,1
Mette,1,0,0,0,1
Metta,1,0,0,0,1
Metin,1,0,0,0,1
Mervin,0,0,1,0,1
Merve,0,0,1,0,1
Meru,0,0,1,0,1
Merrill,0,0,1,0,1
Merlin,0,0,1,0,1
Merlberg And Jamaal,1,0,0,0,1
Mellissa,0,0,1,0,1
Merine,1,0,0,0,1
Meriam,1,0,0,0,1
Merciee,1,0,0,0,1
Mercalle,1,0,0,0,1
Mency,0,0,1,0,1
Mena,0,0,1,0,1
Melysa,1,0,0,0,1
Melow,0,0,1,0,1
Meloney,0,0,1,0,1
Melodi,0,0,1,0,1
Miljan,1,0,0,0,1
Millie,1,0,0,0,1
Millind,0,0,1,0,1
Million,0,0,1,0,1
Montage,1,0,0,0,1
Monsur,1,0,0,0,1
Monir,1,0,0,0,1
Monike,1,0,0,0,1
Monika And David,1,0,0,0,1
Monifa & Saint,1,0,0,0,1
Monica Del Pilar,0,0,1,0,1
Monica & Robin,0,0,1,0,1
Moni,1,0,0,0,1
Monette,1,0,0,0,1
Monetta,1,0,0,0,1
Monee,1,0,0,0,1
Mondana,1,0,0,0,1
Moncef,1,0,0,0,1
Monada,0,0,1,0,1
Mona And Wally,1,0,0,0,1
Mon,0,0,1,0,1
Molly & Mike,1,0,0,0,1
Mollie,1,0,0,0,1
Molara,0,0,1,0,1
Moksha,1,0,0,0,1
Moka,1,0,0,0,1
Moise,1,0,0,0,1
Montana,1,0,0,0,1
Montaser,1,0,0,0,1
Mony,1,0,0,0,1
Moshood,1,0,0,0,1
Mr Vivian,1,0,0,0,1
Mozart,1,0,0,0,1
Moying,0,0,1,0,1
Moxi,0,0,1,0,1
Mousey,1,0,0,0,1
Mounir,0,0,1,0,1
Mounia,0,0,1,0,1
Moud,1,0,0,0,1
Motonobu,1,0,0,0,1
Moss,0,0,1,0,1
Mosh,1,0,0,0,1
Moné,0,0,1,0,1
Mory,1,0,0,0,1
Mortuza,1,0,0,0,1
Morteza,0,0,1,0,1
Morlisa,1,0,0,0,1
Morian,1,0,0,0,1
Morgane,0,0,1,0,1
Moreira,1,0,0,0,1
Mordeana,0,0,1,0,1
Moonim,1,0,0,0,1
Moon,1,0,0,0,1
Moira,1,0,0,0,1
Mohit,1,0,0,0,1
Mohine,1,0,0,0,1
Mint House At 70 Pine,0,1,0,0,1
Miroslava,0,0,1,0,1
Mirlande,0,0,1,0,1
Mirko,0,0,1,0,1
Mirka,1,0,0,0,1
Mirinda,0,0,1,0,1
Mirela And Daniel,1,0,0,0,1
Mireia,0,0,1,0,1
Miraya,1,0,0,0,1
Miquel,0,0,1,0,1
Mintao,1,0,0,0,1
Minka,1,0,0,0,1
Miryam,1,0,0,0,1
Minhaz,0,0,1,0,1
Minhao,1,0,0,0,1
Minel,1,0,0,0,1
Mindia,1,0,0,0,1
Miltiades,1,0,0,0,1
Miloš,0,0,1,0,1
Milosz,1,0,0,0,1
Milos,1,0,0,0,1
Milorad,0,0,1,0,1
Miloni,0,0,0,1,1
Mirtha,1,0,0,0,1
Misael,0,0,1,0,1
Mohinder,0,0,1,0,1
Miz,0,0,1,0,1
Mohan Group LLC,1,0,0,0,1
Moh,0,0,1,0,1
Modeste,0,0,1,0,1
Modafix,1,0,0,0,1
Moby,1,0,0,0,1
Mobinul,0,0,1,0,1
Mobile-Digital,1,0,0,0,1
Mobasher,0,0,1,0,1
Mié,0,0,1,0,1
Mizanur,1,0,0,0,1
Miya,1,0,0,0,1
Mischa,1,0,0,0,1
Mitzie,1,0,0,0,1
Mitchel,0,0,0,1,1
Mister G,1,0,0,0,1
Miss Dy,1,0,0,0,1
Miss Duchess,0,0,1,0,1
Miss Carolyn,1,0,0,0,1
Mishka,1,0,0,0,1
Mishell,1,0,0,0,1
Mishay,1,0,0,0,1
Misel,0,0,1,0,1
McLean,1,0,0,0,1
McClain,1,0,0,0,1
Maham,0,0,1,0,1
Maor,1,0,0,0,1
Maria Luna,1,0,0,0,1
Maria Ines,0,0,1,0,1
Maria I.,0,0,1,0,1
Maria C.,0,0,1,0,1
Maria And Mariano,0,0,1,0,1
Maria & Seth,1,0,0,0,1
Mari J,0,0,0,1,1
Margrethe,1,0,0,0,1
Margo And Vipin,1,0,0,0,1
Margaux,0,0,1,0,1
Marg,0,0,1,0,1
Marco Antonio,0,0,1,0,1
Marcelle,1,0,0,0,1
Marceline Natalie,1,0,0,0,1
Marcel Segundo,0,0,1,0,1
Marceau,1,0,0,0,1
Marce,1,0,0,0,1
Marc & Farnoosh,0,0,1,0,1
Marbee,1,0,0,0,1
Maranatha,1,0,0,0,1
Maral,0,0,1,0,1
Marah,0,0,1,0,1
MarQuerite And David,1,0,0,0,1
Maria Magdalena,0,0,1,0,1
Maria-Gracia,1,0,0,0,1
Maria-Lisa,1,0,0,0,1
Marie And Alec,0,0,1,0,1
Marie-Line,0,0,1,0,1
Marie-Jeanne,1,0,0,0,1
Marie-Hélène & Rick,1,0,0,0,1
Marie-Claude,1,0,0,0,1
Marie-Claire,1,0,0,0,1
Marie-Chantal,1,0,0,0,1
Marie-Adele,1,0,0,0,1
Marie Louise,0,0,1,0,1
Marie L,1,0,0,0,1
Marie Ange,1,0,0,0,1
Maridalia,0,0,1,0,1
Mariagracia,1,0,0,0,1
Maricris,1,0,0,0,1
Maricor,1,0,0,0,1
Maricia,1,0,0,0,1
Maribel & Carolina,1,0,0,0,1
Mariarosa,1,0,0,0,1
Mariano,1,0,0,0,1
Mariann,0,0,1,0,1
Mariame,0,0,1,0,1
Mariama,0,0,1,0,1
Mariah,0,0,1,0,1
Maouchi,0,0,1,0,1
Manzoor,0,0,1,0,1
Mazii,0,0,1,0,1
Manuel Alberto,1,0,0,0,1
Malachi,1,0,0,0,1
Maku,1,0,0,0,1
Maksud,0,0,1,0,1
Makia,0,0,1,0,1
Maki,0,0,1,0,1
Majidudeen,1,0,0,0,1
Majd,0,0,1,0,1
Maja,1,0,0,0,1
Maiysha,0,0,1,0,1
Maite,0,0,1,0,1
Maison,1,0,0,0,1
Mairo,1,0,0,0,1
Mairefrans,1,0,0,0,1
Maiki,1,0,0,0,1
Mai,1,0,0,0,1
Mahrokh,0,0,1,0,1
Mahoghany,0,0,1,0,1
Mahnoor,0,0,1,0,1
Mahmood,0,0,1,0,1
Mahir,1,0,0,0,1
Maher,1,0,0,0,1
Mahbuba,1,0,0,0,1
Mahboba,1,0,0,0,1
Malaleel,0,0,1,0,1
Malcolm,0,0,1,0,1
Malena,1,0,0,0,1
Mania,0,0,1,0,1
Manu,1,0,0,0,1
Mante,0,0,1,0,1
Mansura,1,0,0,0,1
Mansimran,0,0,1,0,1
Mansa,0,0,1,0,1
Manrique And Ticiani,1,0,0,0,1
Manrique,0,0,1,0,1
Manoj,1,0,0,0,1
Manny & Gemma,0,0,1,0,1
Manlio,1,0,0,0,1
Mandodaree,1,0,0,0,1
Malene,1,0,0,0,1
Mandi,0,0,1,0,1
Manasvi,0,0,1,0,1
Mamy Francine,0,0,1,0,1
Mamie,1,0,0,0,1
Malvern,1,0,0,0,1
Mallorie,1,0,0,0,1
Mallary,1,0,0,0,1
Malissa,1,0,0,0,1
Malick,0,0,1,0,1
Malgorzata,1,0,0,0,1
Marie-Lourdes,1,0,0,0,1
Marieanne,1,0,0,0,1
Mariellas,1,0,0,0,1
Marielle,1,0,0,0,1
Matt & Virginia,1,0,0,0,1
Matt & Quin,1,0,0,0,1
Matsuko,0,0,1,0,1
Matin,1,0,0,0,1
Mathias Nahuel,0,0,1,0,1
Mathew Kuruvinakunnel,1,0,0,0,1
Matheus,1,0,0,0,1
Mateusz,0,0,1,0,1
Matei,1,0,0,0,1
Mat,1,0,0,0,1
Masum,0,0,1,0,1
Massow,0,0,1,0,1
Massara,0,0,1,0,1
Masoud,1,0,0,0,1
Masami,1,0,0,0,1
Masako,1,0,0,0,1
Masahiro,0,0,1,0,1
Masa,1,0,0,0,1
María Valentina,1,0,0,0,1
María José,0,0,1,0,1
María Gracia,1,0,0,0,1
Marziyeh,0,0,1,0,1
Maryuri,0,0,1,0,1
Matthieu,0,0,1,0,1
Matti,1,0,0,0,1
Mattia,0,0,1,0,1
Maxyne,1,0,0,0,1
Maze,1,0,0,0,1
Mayur,1,0,0,0,1
Mayte,0,0,1,0,1
Mayo,1,0,0,0,1
Mayla,1,0,0,0,1
Mayja,0,0,1,0,1
Mayellyn,1,0,0,0,1
Mayara,1,0,0,0,1
Mayan,1,0,0,0,1
May Thu,1,0,0,0,1
Maximillian,1,0,0,0,1
Mattias,1,0,0,0,1
Maximiliano,1,0,0,0,1
Mawuli,1,0,0,0,1
Maverick,0,0,1,0,1
Mav,0,0,1,0,1
Mauro A,1,0,0,0,1
Mauro,0,0,1,0,1
Maurissa,1,0,0,0,1
Maurilio,1,0,0,0,1
Maurad & Maria,1,0,0,0,1
Maud,1,0,0,0,1
Maryse,1,0,0,0,1
Marycatherine,1,0,0,0,1
MaryAnne,1,0,0,0,1
Maris,1,0,0,0,1
Mark Winston,0,0,1,0,1
Mark Matthew,1,0,0,0,1
Mark Elijah,1,0,0,0,1
Mark And Stoph,1,0,0,0,1
Marjolein,0,0,1,0,1
Marjan,1,0,0,0,1
Mariusz,1,0,0,0,1
Maristane,1,0,0,0,1
Marishka,1,0,0,0,1
Marisa And Colin,1,0,0,0,1
Mariory,1,0,0,0,1
Marlee,0,0,1,0,1
Mario And Laura,1,0,0,0,1
Mario & Eloise,0,0,1,0,1
Marine,0,0,1,0,1
Marinda,0,0,1,0,1
Marilu,0,0,1,0,1
Marilia,0,0,1,0,1
Marija,1,0,0,0,1
Marife,0,0,1,0,1
Marien,1,0,0,0,1
Marieme,0,0,1,0,1
Markeya,0,0,1,0,1
Marlice,1,0,0,0,1
Mary Sue,0,0,1,0,1
Martine & Michelle,1,0,0,0,1
Mary Kate,1,0,0,0,1
Mary Elizabeth,1,0,0,0,1
Mary Beth,0,0,1,0,1
Mary Anne,1,0,0,0,1
Mary And Charles,1,0,0,0,1
Mary & Josh,1,0,0,0,1
Martyn,0,0,1,0,1
Marty,1,0,0,0,1
Martis,1,0,0,0,1
Martino,1,0,0,0,1
Martin & Soledad,0,0,1,0,1
Marlow,1,0,0,0,1
Martin & Hande,1,0,0,0,1
Martie,0,0,1,0,1
Martha Nicole,1,0,0,0,1
Martha Giovanni Remo,1,0,0,0,1
Martha Cristina,0,0,1,0,1
Marshall’s Property,1,0,0,0,1
Mars,1,0,0,0,1
Maro,1,0,0,0,1
Marné,0,0,1,0,1
Marnie,1,0,0,0,1
Keyur,0,0,1,0,1
Kevon,1,0,0,0,1
Gilleka,1,0,0,0,1
Hyunsup,1,0,0,0,1
Ileana,0,0,1,0,1
Ildiko,1,0,0,0,1
Ilayda,0,0,1,0,1
Ilana,1,0,0,0,1
Ilan,1,0,0,0,1
Ikwo,0,0,1,0,1
Ikello,0,0,1,0,1
Ijana,0,0,1,0,1
Iftikhar,1,0,0,0,1
Ife,1,0,0,0,1
Ieza,1,0,0,0,1
Idil,0,0,1,0,1
Idelsa,1,0,0,0,1
Idamil,0,0,1,0,1
Idalmis,1,0,0,0,1
Ichim,0,0,1,0,1
Iara,0,0,1,0,1
Iana,1,0,0,0,1
Ian & Sady,1,0,0,0,1
Ia,0,0,1,0,1
ILena,0,0,1,0,1
I Do Not Live Here,1,0,0,0,1
I Am Phenomenal,0,0,1,0,1
Ilginutin,0,0,1,0,1
Ilhom,1,0,0,0,1
Illias,0,0,1,0,1
Indo,1,0,0,0,1
InspirationalGem,1,0,0,0,1
Insia,1,0,0,0,1
Inrich,1,0,0,0,1
Innocent,0,0,1,0,1
Ink48 Hotel,0,1,0,0,1
Inigo,0,0,1,0,1
Inessa,0,0,1,0,1
Indre,1,0,0,0,1
IndraRisma,0,0,1,0,1
Indra,0,0,1,0,1
Indira,1,0,0,0,1
Illtyd,0,0,1,0,1
Inawd,1,0,0,0,1
Inas,1,0,0,0,1
Inanna,1,0,0,0,1
Imtiaz,0,0,0,1,1
Iman,0,0,1,0,1
Imad,1,0,0,0,1
Ilyas,0,0,1,0,1
Ilse,1,0,0,0,1
Illyse,0,0,1,0,1
Illusionist Matias,0,0,1,0,1
Héctor,1,0,0,0,1
Hyun Na,0,0,1,0,1
Ioana,1,0,0,0,1
Hyun Jin,1,0,0,0,1
Horatio,1,0,0,0,1
Horace,1,0,0,0,1
Hooman,0,0,1,0,1
Honore,0,0,1,0,1
Hongye,0,0,1,0,1
Hongqing,0,0,1,0,1
Honglip,0,0,1,0,1
Hong Ngoc,0,0,1,0,1
Hong,1,0,0,0,1
Homespring,1,0,0,0,1
Homes,1,0,0,0,1
Holiday Inn New York City,1,0,0,0,1
Holiday Inn Express Wall Street,1,0,0,0,1
Hoang,0,0,1,0,1
Hoan,0,0,1,0,1
Hlib,0,0,1,0,1
Hjorth,1,0,0,0,1
Hitarth,0,0,1,0,1
Hiral,1,0,0,0,1
Hiokit (Terry),0,0,1,0,1
Hinelsey,0,0,1,0,1
Hinelda,0,0,1,0,1
Hind,1,0,0,0,1
Horia,1,0,0,0,1
Horton,1,0,0,0,1
Hossam,0,0,1,0,1
Hugo B.,0,0,1,0,1
Hyonok,1,0,0,0,1
Hyonce,1,0,0,0,1
Hyggens,1,0,0,0,1
Huvon,1,0,0,0,1
Hussam,1,0,0,0,1
Hurshum,1,0,0,0,1
Huntley,0,0,1,0,1
Huma,0,0,1,0,1
Hum,1,0,0,0,1
Hui Chong,1,0,0,0,1
Hugo & Amelia,1,0,0,0,1
Hotel,0,0,1,0,1
Huei-Yin,0,0,1,0,1
Hue,1,0,0,0,1
Huan,0,0,1,0,1
Hristiyan,1,0,0,0,1
Howard T.,0,0,0,1,1
Houman,1,0,0,0,1
Houda,1,0,0,0,1
Hotel Hayden,0,1,0,0,1
Hotel Five44,0,1,0,0,1
Hotel 57,0,1,0,0,1
Ioan,1,0,0,0,1
Iodele,0,0,1,0,1
Kevin Unal,1,0,0,0,1
Iwona,1,0,0,0,1
Jad,1,0,0,0,1
Jacquelyne,0,0,1,0,1
Jacqueline Mia,1,0,0,0,1
Jaclyn And Alicia,0,0,1,0,1
Jackson Heights,1,0,0,0,1
Jacketta,0,0,1,0,1
Jackeline,0,0,1,0,1
Jackee,1,0,0,0,1
Jack & Jo,1,0,0,0,1
Jacinto,1,0,0,0,1
Jacinta,1,0,0,0,1
Jac,0,0,1,0,1
Jabbath,1,0,0,0,1
Jaazy,0,0,1,0,1
Jaamil,0,0,1,0,1
J.L.,0,0,1,0,1
J.J.,1,0,0,0,1
J.F.,0,0,1,0,1
J.D.,1,0,0,0,1
J P,1,0,0,0,1
J And Lana,0,0,1,0,1
Izumi,1,0,0,0,1
Izaak,1,0,0,0,1
Jaden,1,0,0,0,1
Jadore,1,0,0,0,1
Jafett,1,0,0,0,1
James Nathan,0,0,1,0,1
Janel,1,0,0,0,1
Janee,0,0,1,0,1
Jane + Abe,0,0,1,0,1
Jamis,1,0,0,0,1
Jamilya,1,0,0,0,1
Jamika,0,0,1,0,1
Jamiel,1,0,0,0,1
Jamie J.,1,0,0,0,1
Jamie Alice,1,0,0,0,1
James R,0,0,1,0,1
James & Lisa,1,0,0,0,1
Jafor,1,0,0,0,1
James  &  Mina,0,0,1,0,1
Jameel,0,0,1,0,1
Jalynn,1,0,0,0,1
Jak,1,0,0,0,1
Jairo,1,0,0,0,1
Jaime Alberto,0,0,1,0,1
Jailine,1,0,0,0,1
Jai,0,0,1,0,1
Jahde,1,0,0,0,1
Jahanzeb,1,0,0,0,1
Iyabo,0,0,1,0,1
Ivonne,1,0,0,0,1
Ion,1,0,0,0,1
Ivly,1,0,0,0,1
Isik,0,0,1,0,1
Isidro,0,0,1,0,1
Isidora,0,0,1,0,1
Isi,0,0,1,0,1
Ishwarjot,1,0,0,0,1
Ishmam,0,0,1,0,1
Ishaq,0,0,1,0,1
Ishan,0,0,1,0,1
Ishac,1,0,0,0,1
Ish & Asa,1,0,0,0,1
Isaura,0,0,1,0,1
Isatou,0,0,1,0,1
Isadora,0,0,1,0,1
Isaac Haise,0,0,1,0,1
Irvin,1,0,0,0,1
Irmak,1,0,0,0,1
Irma,0,0,1,0,1
Irlanda,0,0,1,0,1
Iri,0,0,1,0,1
Irem,0,0,1,0,1
Iquo,1,0,0,0,1
Iqbal,1,0,0,0,1
Ippei,1,0,0,0,1
Isin,0,0,1,0,1
Isis,1,0,0,0,1
Iska,1,0,0,0,1
Ithai,1,0,0,0,1
Ivin,0,0,1,0,1
Ivas,1,0,0,0,1
Ivann,0,0,1,0,1
Ivana And Tami,0,0,1,0,1
Ivan Ralph,1,0,0,0,1
Iva,1,0,0,0,1
Iustin,1,0,0,0,1
Iulia,0,0,1,0,1
Itziar,0,0,1,0,1
Its A Celebration,1,0,0,0,1
Itay,1,0,0,0,1
Islandgetawayz,0,0,1,0,1
Itai,1,0,0,0,1
Ita,0,0,1,0,1
Issa,1,0,0,0,1
Isrrael,0,0,1,0,1
Isroel,0,0,1,0,1
Isoke,0,0,1,0,1
Isobel,1,0,0,0,1
Ismom,1,0,0,0,1
Ismet,1,0,0,0,1
Ismalin,0,0,1,0,1
Hina,1,0,0,0,1
Hilton Garden Inn Times Square,1,0,0,0,1
Hillela,0,0,1,0,1
Green Room,1,0,0,0,1
Gunnar,1,0,0,0,1
Gung,1,0,0,0,1
Gulden And Mavi,0,0,1,0,1
Gul,0,0,1,0,1
Guisela,1,0,0,0,1
Guilardo,1,0,0,0,1
Guido,1,0,0,0,1
Guerline,1,0,0,0,1
Guerin,0,0,1,0,1
Gudrun,1,0,0,0,1
Guanshan,0,0,1,0,1
Guangyu,0,0,1,0,1
Guadalupe,0,0,1,0,1
Griselda,0,0,1,0,1
Grinis,0,0,1,0,1
Griffith,0,0,1,0,1
Greymi,0,0,1,0,1
Grey Sea,0,0,1,0,1
Gretta J.,1,0,0,0,1
Greter,1,0,0,0,1
Greta,1,0,0,0,1
Gregor,1,0,0,0,1
Gregoire,0,0,1,0,1
Gurcharan,0,0,1,0,1
Gurdane,0,0,1,0,1
Gurdeep,0,0,1,0,1
Güney,1,0,0,0,1
Hadiza,1,0,0,0,1
Hadiiya,0,0,1,0,1
Hadi,0,0,1,0,1
Hade,1,0,0,0,1
Hadas,1,0,0,0,1
Hadar,1,0,0,0,1
Hacer Gul,0,0,1,0,1
Habib,0,0,1,0,1
Ha,1,0,0,0,1
H,0,0,1,0,1
Gyurin,1,0,0,0,1
Gurinder,1,0,0,0,1
Gypsy,1,0,0,0,1
Gyaltsen Benita,1,0,0,0,1
Gya,0,0,1,0,1
Gwyned,1,0,0,0,1
Gwendolyn,1,0,0,0,1
Gwen,1,0,0,0,1
Gvantsa,1,0,0,0,1
Gurveen,0,0,1,0,1
Gurp,0,0,1,0,1
Gurjeet,1,0,0,0,1
Greg & Adriane,1,0,0,0,1
Green,1,0,0,0,1
Hili,1,0,0,0,1
Grecia,0,0,1,0,1
Glen And Nova,1,0,0,0,1
Glaucia,0,0,1,0,1
Gjermund,0,0,1,0,1
Gjergji,1,0,0,0,1
Giusy,0,0,1,0,1
Giuseppina,1,0,0,0,1
Giullian,0,0,1,0,1
Giulio,0,0,1,0,1
Gita,1,0,0,0,1
Gislane,1,0,0,0,1
Gisella,0,0,1,0,1
Girija,1,0,0,0,1
Giraud,1,0,0,0,1
Giovani,1,0,0,0,1
Giorgia,1,0,0,0,1
Giorgi,1,0,0,0,1
Giona,1,0,0,0,1
Ginevra,0,0,1,0,1
Ginette,1,0,0,0,1
Gin,1,0,0,0,1
Gimena,1,0,0,0,1
Gilmar,1,0,0,0,1
Gilleon,1,0,0,0,1
Gleneisha,1,0,0,0,1
Glenroy,1,0,0,0,1
Gloria And David,0,0,1,0,1
Golsana,1,0,0,0,1
Grand Villa Estates,1,0,0,0,1
Grainne,0,0,1,0,1
Grady & Cristina,1,0,0,0,1
Graciela,0,0,1,0,1
Gracie,1,0,0,0,1
Gracelyn,0,0,1,0,1
Gosia,1,0,0,0,1
Goran,0,0,1,0,1
Gonzo,1,0,0,0,1
Gonda,1,0,0,0,1
Goli,1,0,0,0,1
Gloria Joy,1,0,0,0,1
Golden Sugar,1,0,0,0,1
Gokhan,0,0,1,0,1
Gokche,1,0,0,0,1
Goenuel,1,0,0,0,1
Godson,1,0,0,0,1
Godshelter,1,0,0,0,1
Godlove,1,0,0,0,1
Glorya,0,0,1,0,1
Glory,0,0,1,0,1
Glorietta,1,0,0,0,1
Hadji,1,0,0,0,1
Hadley,1,0,0,0,1
Hafez,1,0,0,0,1
Haider,0,0,1,0,1
Helida,0,0,1,0,1
Helia,0,0,1,0,1
Helene,1,0,0,0,1
Helena & Greg,1,0,0,0,1
Helee,1,0,0,0,1
Heikki,1,0,0,0,1
Heike,1,0,0,0,1
Heidy,0,0,1,0,1
Heera,1,0,0,0,1
Heena,0,0,1,0,1
Heejin,1,0,0,0,1
Hedda,1,0,0,0,1
Hebert,0,0,1,0,1
Heaven,1,0,0,0,1
Heather Nadine,1,0,0,0,1
Heather Garcia,1,0,0,0,1
HeartStone,1,0,0,0,1
Heart,1,0,0,0,1
Hd,1,0,0,0,1
Haïssam,0,0,1,0,1
Hazuki,0,0,1,0,1
Haz,1,0,0,0,1
Hayley Lynn,1,0,0,0,1
Helma,1,0,0,0,1
Helo.,1,0,0,0,1
Heloise,0,0,1,0,1
Heri,0,0,1,0,1
Hifza,1,0,0,0,1
Hieu,0,0,1,0,1
Hiba,1,0,0,0,1
Hiasselen,0,0,1,0,1
Hezla,1,0,0,0,1
Hewah,1,0,0,0,1
Hessam,0,0,1,0,1
Herve,1,0,0,0,1
Heroni,0,0,1,0,1
Herman  F,0,0,1,0,1
Herby,1,0,0,0,1
Hemant,1,0,0,0,1
Herani And John,1,0,0,0,1
Heping,1,0,0,0,1
Henya,1,0,0,0,1
Henry D,0,0,1,0,1
Henry Alexander,1,0,0,0,1
Henrik,1,0,0,0,1
Henrietta,0,0,1,0,1
Henri-Leon,1,0,0,0,1
Henna,1,0,0,0,1
Hena,1,0,0,0,1
Hayara,1,0,0,0,1
Hayal,0,0,1,0,1
Hatsumi,0,0,1,0,1
Hally,1,0,0,0,1
Hande,1,0,0,0,1
Hancheng,0,0,1,0,1
Hanayo,1,0,0,0,1
Hanaa,1,0,0,0,1
HanJie,0,0,1,0,1
Hamza J,1,0,0,0,1
Hampton Inn Times,1,0,0,0,1
Hamid,1,0,0,0,1
Hamada,1,0,0,0,1
Halona,1,0,0,0,1
Hallie,1,0,0,0,1
Hanna Lois,1,0,0,0,1
Halliday,1,0,0,0,1
Halley,0,0,1,0,1
Halle,1,0,0,0,1
Halim,0,0,1,0,1
Hale,1,0,0,0,1
Hakeem,1,0,0,0,1
Haiying,1,0,0,0,1
Haiy,1,0,0,0,1
Hailey,1,0,0,0,1
Haidy,1,0,0,0,1
Hank,0,0,1,0,1
Hannah M,0,0,1,0,1
Hatnim,1,0,0,0,1
Harman,1,0,0,0,1
Hatim,1,0,0,0,1
Hasibur,0,0,1,0,1
Hashi,0,0,1,0,1
Hasan Can,0,0,1,0,1
Harvey,1,0,0,0,1
Harvery,1,0,0,0,1
Hart,1,0,0,0,1
Harry Smith,1,0,0,0,1
Harrington,1,0,0,0,1
Haroun,0,0,1,0,1
Harlee,1,0,0,0,1
Hannes,0,0,1,0,1
Harlan,0,0,1,0,1
Harish,1,0,0,0,1
Hardick,0,0,1,0,1
Harald,1,0,0,0,1
HaoXiang,0,0,1,0,1
Hao,0,0,1,0,1
Hanya,1,0,0,0,1
Hany,1,0,0,0,1
Hanson,0,0,1,0,1
Hansel,0,0,1,0,1
Janell,1,0,0,0,1
Janene,0,0,1,0,1
Janeth,1,0,0,0,1
K.,1,0,0,0,1
Kamali,1,0,0,0,1
Kamala,0,0,1,0,1
Kalyn,0,0,1,0,1
Kalween,0,0,1,0,1
Kalsang,0,0,1,0,1
Kalpana,1,0,0,0,1
Kalina,1,0,0,0,1
Kalim,0,0,1,0,1
Kalifa,0,0,1,0,1
Kalani,1,0,0,0,1
Kajsa,0,0,1,0,1
Kaiwei,1,0,0,0,1
Kaivan,0,0,1,0,1
Kaiti,1,0,0,0,1
Kait,0,0,1,0,1
Kailyn,0,0,1,0,1
Kaia,1,0,0,0,1
Kah,0,0,1,0,1
Kaedin,0,0,1,0,1
Kadon,1,0,0,0,1
Kade,1,0,0,0,1
K.C.,1,0,0,0,1
K.Arina,1,0,0,0,1
Kamerin,0,0,1,0,1
Kameryn & Rob,1,0,0,0,1
Kamilya,0,0,1,0,1
Karem,0,0,1,0,1
Karna,1,0,0,0,1
Karmesha,1,0,0,0,1
Karlyne,1,0,0,0,1
Karliin,1,0,0,0,1
Karlie,0,0,1,0,1
Karissa,1,0,0,0,1
Karina & Garrett,1,0,0,0,1
Karima,1,0,0,0,1
Karene,1,0,0,0,1
Karema,1,0,0,0,1
Karah,0,0,1,0,1
Kamini,0,0,1,0,1
Kappie,1,0,0,0,1
Kaori,1,0,0,0,1
Kanvar,1,0,0,0,1
Kangxin,0,0,1,0,1
Kang,0,0,1,0,1
Kane,1,0,0,0,1
Kandisann,0,0,1,0,1
Kanae,1,0,0,0,1
Kamroon,1,0,0,0,1
Kamran,1,0,0,0,1
K. Zovia,1,0,0,0,1
K&L,1,0,0,0,1
Jossy,0,0,1,0,1
K Alexandra,1,0,0,0,1
Juli,0,0,1,0,1
Jules Andre,1,0,0,0,1
Juhea,1,0,0,0,1
Juel,0,0,1,0,1
Judit,0,0,1,0,1
Judd,1,0,0,0,1
Judah,1,0,0,0,1
Juanli,1,0,0,0,1
Juanjo,1,0,0,0,1
Juan-Pablo,1,0,0,0,1
Juan Pablo,1,0,0,0,1
Juan Ignacio,1,0,0,0,1
Juan Alfredo,0,0,1,0,1
Joël,0,0,1,0,1
Joyann,1,0,0,0,1
Joy-Ann,1,0,0,0,1
Joy & Jesse,1,0,0,0,1
Jovenne Naldrey,1,0,0,0,1
Jovanny,1,0,0,0,1
Jovana,1,0,0,0,1
Jovan,1,0,0,0,1
Jov,1,0,0,0,1
Josè,1,0,0,0,1
Julia And Juan,1,0,0,0,1
Julia Marie,0,0,1,0,1
Julian & Fernanda,0,0,1,0,1
Junyuan,0,0,1,0,1
Jérôme,1,0,0,0,1
Jyllian,1,0,0,0,1
Jwajiku,0,0,1,0,1
Jutta,1,0,0,0,1
Justin You,1,0,0,0,1
Juss,0,0,1,0,1
Jurine,0,0,1,0,1
Jurij,1,0,0,0,1
Jure,1,0,0,0,1
Jupira,1,0,0,0,1
Junyi,0,0,1,0,1
Juliann,0,0,1,0,1
Junting,1,0,0,0,1
Juno,0,0,1,0,1
Jung,1,0,0,0,1
Jullien,0,0,1,0,1
Julliana,0,0,1,0,1
Jullenne,1,0,0,0,1
Julienne,1,0,0,0,1
Julie Ann,1,0,0,0,1
Juliano,0,0,1,0,1
Julianne,1,0,0,0,1
Karoliina,1,0,0,0,1
Karolina,0,0,1,0,1
Karron,0,0,1,0,1
Kartik,0,0,1,0,1
Kennedi,1,0,0,0,1
Keni,1,0,0,0,1
Kendrick,1,0,0,0,1
Kendel,1,0,0,0,1
Kemoni,1,0,0,0,1
Kemal,0,0,1,0,1
Kelon,0,0,1,0,1
Kellion,1,0,0,0,1
Kellianne,1,0,0,0,1
Kelley,0,1,0,0,1
Kellen,1,0,0,0,1
Kellee,1,0,0,0,1
Kele,1,0,0,0,1
Kelcey,1,0,0,0,1
Keke,0,0,0,1,1
Keith & Masa,1,0,0,0,1
Keisy,0,0,1,0,1
Keisuke,0,0,1,0,1
Keishera,1,0,0,0,1
Keir,1,0,0,0,1
Keilyn,0,0,1,0,1
Keily,1,0,0,0,1
Keiko & Ilya,1,0,0,0,1
Kenrick,1,0,0,0,1
Kento,1,0,0,0,1
Kenya,0,0,1,0,1
Kerry-Kay,0,0,1,0,1
Kevin + Casey,1,0,0,0,1
Ketnie,1,0,0,0,1
Kethy,1,0,0,0,1
Kethia,1,0,0,0,1
Ketanya,1,0,0,0,1
Kesina,1,0,0,0,1
Kesi,1,0,0,0,1
Kerwyn,0,0,1,0,1
Kerstin,0,0,1,0,1
KerryAnne,1,0,0,0,1
Kerrison,1,0,0,0,1
Kenza,0,0,1,0,1
Kerrie,1,0,0,0,1
Kerri & Steve,1,0,0,0,1
Kerreu,1,0,0,0,1
Kermoni,1,0,0,0,1
Kermit,0,0,1,0,1
Kerlie,1,0,0,0,1
Keri,1,0,0,0,1
Keren J,1,0,0,0,1
Keqing,1,0,0,0,1
Keona,1,0,0,0,1
Keiichiro,1,0,0,0,1
Kei,0,0,1,0,1
Kehinde,0,0,1,0,1
Katarzyna,0,0,1,0,1
Kati,1,0,0,0,1
Kathryn Joanna,1,0,0,0,1
Kathryn & Tobias,0,0,1,0,1
Kathrina,1,0,0,0,1
Kathlyn,1,0,0,0,1
Kathisha,1,0,0,0,1
Katherine E,1,0,0,0,1
Katherin,1,0,0,0,1
Katerine,0,0,1,0,1
Kate + Max,0,0,1,0,1
Kat Kat,1,0,0,0,1
Katie And Matt,1,0,0,0,1
Kasun,0,0,1,0,1
Kassim,0,0,1,0,1
Kassandra,1,0,0,0,1
Kassa,1,0,0,0,1
Kasra,1,0,0,0,1
Kasie,0,0,1,0,1
Kasia,1,0,0,0,1
Kashif,1,0,0,0,1
KasNasia,0,0,1,0,1
Kartika,0,0,1,0,1
Katiane,1,0,0,0,1
Katie And Perry,1,0,0,0,1
Kefentse,1,0,0,0,1
Kayu,1,0,0,0,1
Keeta,0,0,0,1,1
Keenan,0,0,1,0,1
Keely,1,0,0,0,1
Keefe,0,0,1,0,1
Kee,0,0,1,0,1
Kechel,0,0,0,1,1
Kd,1,0,0,0,1
Kc,0,0,1,0,1
Kazuna,1,0,0,0,1
Kazi,1,0,0,0,1
Kaytlin,0,0,1,0,1
Katka,1,0,0,0,1
Kaylin,0,0,1,0,1
Kaylen,0,0,1,0,1
Kayleen,0,0,1,0,1
Kaylee,0,0,1,0,1
Kayes,0,0,1,0,1
Kaycee,1,0,0,0,1
Kavya,1,0,0,0,1
Katurah,1,0,0,0,1
Katsiaryna,1,0,0,0,1
Katrien,0,0,1,0,1
Josue,1,0,0,0,1
Joss,0,0,1,0,1
Janette,1,0,0,0,1
Jean-Guy,0,0,1,0,1
Jeniel,0,0,1,0,1
Jenica,1,0,0,0,1
Jeni,1,0,0,0,1
Jenae,1,0,0,0,1
Jen & Isa,1,0,0,0,1
Jemme,1,0,0,0,1
Jemima,1,0,0,0,1
Jelina,0,0,1,0,1
Jelani,1,0,0,0,1
Jehnna,1,0,0,0,1
Jehanne,1,0,0,0,1
Jehad,1,0,0,0,1
Jefry,0,0,1,0,1
Jeeyoon,1,0,0,0,1
Jeevan,0,0,1,0,1
Jeannine,1,0,0,0,1
Jeannie & Everett,1,0,0,0,1
Jeannelle,1,0,0,0,1
Jeanne P,1,0,0,0,1
Jeanie,1,0,0,0,1
Jeaneth,1,0,0,0,1
JeanClaude,0,0,1,0,1
Jean-Noël,1,0,0,0,1
Jenn And Mike,1,0,0,0,1
Jennifer And Grace,1,0,0,0,1
Jennifer And Kenneth,1,0,0,0,1
Jesiah,1,0,0,0,1
Jeysi,1,0,0,0,1
Jeung,1,0,0,0,1
Jetsenia,1,0,0,0,1
Jet,0,0,1,0,1
Jesús,0,0,0,1,1
Jesus A,0,0,1,0,1
Jestina,0,0,1,0,1
Jessica/Fitz,0,0,1,0,1
Jessenia,1,0,0,0,1
Jesseca,0,0,1,0,1
Jeruschka,1,0,0,0,1
Jennille,0,0,1,0,1
Jeroy,1,0,0,0,1
Jernej,0,0,1,0,1
Jermain & Zübeyde,0,0,1,0,1
Jerimiah,1,0,0,0,1
Jerie,0,0,1,0,1
Jeremy & Erin,1,0,0,0,1
Jeremy & Angela,1,0,0,0,1
Jeremiah & Petra,1,0,0,0,1
Jerbean,0,0,1,0,1
Jenuine,1,0,0,0,1
Jean-Marc,1,0,0,0,1
Jean-Cosme,1,0,0,0,1
Joslin,1,0,0,0,1
Jean Robert,0,0,1,0,1
Jas,0,0,0,1,1
Jarrod,1,0,0,0,1
Jarred,0,0,1,0,1
Jarol E,0,0,1,0,1
Jarmel,0,0,1,0,1
Jarett,1,0,0,0,1
Jaran,1,0,0,0,1
Jaqui And Mark,1,0,0,0,1
Jaqueline,1,0,0,0,1
Jany,0,0,1,0,1
Janu,0,0,0,1,1
Janset,1,0,0,0,1
Jannike,1,0,0,0,1
Jannie,0,0,1,0,1
Jannick,1,0,0,0,1
Jannice,1,0,0,0,1
Jannes,1,0,0,0,1
Janli,0,0,1,0,1
Janis,1,0,0,0,1
Janicia,0,0,1,0,1
Janh,0,0,1,0,1
Jangho,0,0,1,0,1
Janeyjaney,1,0,0,0,1
Jasber,1,0,0,0,1
Jase,1,0,0,0,1
Jasen,0,0,1,0,1
Jayley,1,0,0,0,1
Jean Lucien,1,0,0,0,1
Jean Carlos,0,0,1,0,1
Jean And Wilson,1,0,0,0,1
Je0,0,0,1,0,1
Jd,0,0,1,0,1
Jb,1,0,0,0,1
Jazzmine,0,0,1,0,1
Jazil,1,0,0,0,1
Jaymes,0,0,0,1,1
Jaylin,1,0,0,0,1
Jaye (And Spike),0,0,1,0,1
Jasmine Étoile,1,0,0,0,1
Jayden,1,0,0,0,1
Jayar,1,0,0,0,1
Jay/Carolina Bastidas Family,0,0,1,0,1
Jaxon,1,0,0,0,1
Javiera Valentina,0,0,1,0,1
Javaughn,1,0,0,0,1
Jassmin,1,0,0,0,1
Jass,1,0,0,0,1
Jasper,0,0,1,0,1
Jason C,1,0,0,0,1
Jez,1,0,0,0,1
Jezelle,1,0,0,0,1
Jhacky,1,0,0,0,1
Jhonathan,1,0,0,0,1
Jonnice,1,0,0,0,1
Jonn,1,0,0,0,1
Jonlyn,1,0,0,0,1
Jonathan E,0,0,1,0,1
Jonas,1,0,0,0,1
Jonah_Soleil,1,0,0,0,1
Jolly,1,0,0,0,1
Jolene,1,0,0,0,1
Jolanda,1,0,0,0,1
Joi,1,0,0,0,1
Johnnet,0,0,1,0,1
Johnn,0,0,1,0,1
Johnelle,1,0,0,0,1
Johnathon,0,0,1,0,1
John Y María,0,0,1,0,1
John Paul,1,0,0,0,1
John Niño,1,0,0,0,1
John Michail,1,0,0,0,1
John Ed,1,0,0,0,1
John Arnold,1,0,0,0,1
John And Laurie,1,0,0,0,1
John (Tianqi),0,0,0,1,1
John & Siobhan,1,0,0,0,1
Jonnie,0,0,1,0,1
Jonnie Rose,1,0,0,0,1
Jonona,0,0,1,0,1
Jose Luís,1,0,0,0,1
Josiah,0,0,1,0,1
Josi,1,0,0,0,1
Joshua And Maritza,1,0,0,0,1
Josh Victor,1,0,0,0,1
Josh & Jessica,1,0,0,0,1
Josette,0,0,1,0,1
Joseph F,1,0,0,0,1
Joseph Amechi,0,0,1,0,1
Joselito,1,0,0,0,1
Josef,1,0,0,0,1
Jose H.,1,0,0,0,1
Jophiel,1,0,0,0,1
Jose Guillermo,1,0,0,0,1
Jose G,1,0,0,0,1
Jose Diego,0,0,1,0,1
Josandra,1,0,0,0,1
Jorma,1,0,0,0,1
Joris,1,0,0,0,1
Jorge Arturo,1,0,0,0,1
Jorey,0,0,1,0,1
Jordyn,1,0,0,0,1
Jordi,1,0,0,0,1
Johmary,1,0,0,0,1
Joharry,1,0,0,0,1
Johannes,0,0,1,0,1
Jieyu,0,0,1,0,1
Jinna,1,0,0,0,1
Jinn,0,0,1,0,1
Jingjing,0,0,1,0,1
Jina,1,0,0,0,1
Jin Ting,0,0,1,0,1
Jimmie,0,0,1,0,1
Jim & Barbara,1,0,0,0,1
Jill S,1,0,0,0,1
Jilbert,0,0,1,0,1
Jihwan,0,0,1,0,1
Jieun,0,0,1,0,1
Jinqiu,0,0,1,0,1
Jido,1,0,0,0,1
Jibari,1,0,0,0,1
Jib,1,0,0,0,1
Jiao,0,0,1,0,1
Jianren,1,0,0,0,1
Jiajia,0,0,1,0,1
Jiahua,1,0,0,0,1
Ji,0,0,1,0,1
Jhovana,0,0,1,0,1
Jhonattan,0,0,1,0,1
Jinny,0,0,1,0,1
Jinseo,1,0,0,0,1
Joel & Renee,0,0,1,0,1
Joao,1,0,0,0,1
Joei-Ann,1,0,0,0,1
Joedan,1,0,0,0,1
Joe & Maria,1,0,0,0,1
Joe & Jay,1,0,0,0,1
Jodil H.,1,0,0,0,1
Jodali,1,0,0,0,1
Jocelin,0,0,1,0,1
Joaquina,1,0,0,0,1
Joaquim,1,0,0,0,1
Joao Lucas,0,0,1,0,1
Joanna & Brian,1,0,0,0,1
Jinx,0,0,1,0,1
Joanabel,1,0,0,0,1
Joan D,1,0,0,0,1
Joachim,1,0,0,0,1
JoJo,1,0,0,0,1
JoAnn,1,0,0,0,1
Jo-Anne,1,0,0,0,1
Jiwoong,0,0,1,0,1
Jitabella,0,0,1,0,1
Jisoo,0,0,1,0,1
Jisho,1,0,0,0,1
진,1,0,0,0,1
