host_id,Entire home/apts,Private rooms,Shared rooms,Hotel Rooms,Total Listings
107434423,415,0,0,0,415
3223938,0,0,394,0,394
305240193,30,0,192,0,222
19303369,9,0,198,0,207
200239515,5,0,187,0,192
204704622,5,0,173,0,178
162280872,156,0,0,0,156
51501835,131,0,0,0,131
137358866,6,0,118,0,124
61391963,124,0,0,0,124
496944100,78,0,39,0,117
22541573,113,0,0,0,113
371972456,0,0,101,0,101
2867137,88,0,0,0,88
120762452,73,10,0,0,83
488616033,0,0,69,0,69
219517861,24,0,39,0,63
113723310,63,0,0,0,63
23772724,60,0,2,0,62
394817730,0,0,59,0,59
26377263,0,0,57,0,57
341908723,2,0,52,0,54
401202937,1,0,52,0,53
181490923,30,0,23,0,53
25138314,0,0,50,0,50
51548122,43,0,5,0,48
384532776,47,0,0,0,47
423873487,44,0,0,0,44
348619646,33,0,11,0,44
444007547,0,0,44,0,44
450580547,39,0,0,0,39
2119276,38,0,0,0,38
9293730,38,0,0,0,38
448326434,37,0,0,0,37
48005494,36,0,0,0,36
438952657,29,0,6,0,35
385129361,32,0,0,0,32
13347167,31,0,0,0,31
390535864,0,0,31,0,31
50760546,30,0,0,0,30
174792040,14,0,15,0,29
401709949,0,0,29,0,29
7503643,28,1,0,0,29
483027889,29,0,0,0,29
27181542,29,0,0,0,29
442029804,29,0,0,0,29
224414117,0,27,1,0,28
383332265,0,0,28,0,28
9864136,6,0,22,0,28
171697479,0,0,28,0,28
417504,16,3,8,0,27
380601266,27,0,0,0,27
546370,0,0,25,0,25
384559808,25,0,0,0,25
28260018,0,0,25,0,25
393897747,23,0,1,0,24
296605957,0,0,24,0,24
285727534,9,0,15,0,24
30532557,0,0,23,0,23
492402369,0,0,23,0,23
395671107,0,0,23,0,23
408979935,0,0,22,0,22
407304997,22,0,0,0,22
30283594,22,0,0,0,22
284337887,0,0,21,0,21
489756011,21,0,0,0,21
429454632,0,0,20,0,20
460919458,19,0,0,0,19
94214493,0,0,19,0,19
7245581,19,0,0,0,19
10149317,4,0,15,0,19
307001589,0,0,19,0,19
267272502,0,0,18,0,18
238989521,0,0,17,0,17
270122518,0,0,17,0,17
74488815,0,0,17,0,17
450161902,17,0,0,0,17
276878527,17,0,0,0,17
334611519,11,0,6,0,17
87639559,11,0,3,3,17
470859718,14,0,3,0,17
16480700,4,0,10,2,16
484277630,0,0,16,0,16
3250450,0,0,16,0,16
243288727,16,0,0,0,16
424334449,0,0,16,0,16
211549023,15,0,1,0,16
83786650,16,0,0,0,16
396629729,0,0,6,10,16
414068298,15,0,0,0,15
40385488,7,0,8,0,15
61408134,6,0,9,0,15
83143535,2,0,13,0,15
51589519,15,0,0,0,15
16437254,15,0,0,0,15
35998113,1,0,1,13,15
399865453,15,0,0,0,15
415840703,15,0,0,0,15
389697794,15,0,0,0,15
406175571,6,0,8,0,14
241676154,0,0,14,0,14
378112960,14,0,0,0,14
5162192,13,0,1,0,14
377241586,4,0,10,0,14
271275048,14,0,0,0,14
47554473,14,0,0,0,14
170568130,14,0,0,0,14
224047081,11,0,3,0,14
263720409,0,7,6,0,13
440921674,4,0,7,2,13
81585173,2,0,11,0,13
333057838,8,0,5,0,13
418449940,0,0,13,0,13
133802988,0,0,13,0,13
278925199,13,0,0,0,13
401937392,0,0,4,9,13
407284341,2,0,11,0,13
242322561,0,0,13,0,13
3603284,8,0,5,0,13
484932415,0,0,0,13,13
266797018,0,0,13,0,13
251455701,9,0,3,0,12
444732174,12,0,0,0,12
420088913,12,0,0,0,12
17770287,12,0,0,0,12
396629612,2,0,10,0,12
38592279,0,0,12,0,12
2822805,0,0,12,0,12
158969505,12,0,0,0,12
391942286,1,0,5,6,12
435050037,1,0,11,0,12
501232239,5,0,7,0,12
429826037,7,0,5,0,12
215759678,2,0,10,0,12
40523974,12,0,0,0,12
222580763,0,0,4,8,12
100238132,12,0,0,0,12
159598333,11,0,1,0,12
241889662,0,11,1,0,12
457828432,0,0,12,0,12
30509656,0,0,0,11,11
306009315,0,0,11,0,11
65809485,1,0,10,0,11
143127602,1,0,10,0,11
421108644,0,0,11,0,11
421089506,11,0,0,0,11
223087887,0,0,6,5,11
485492389,0,0,5,6,11
204348856,11,0,0,0,11
185979641,11,0,0,0,11
483056418,5,0,6,0,11
388603242,11,0,0,0,11
501064484,3,0,8,0,11
377246343,0,0,11,0,11
365342297,1,0,6,4,11
336581747,10,0,0,0,10
356623718,1,0,9,0,10
29582882,10,0,0,0,10
440316434,0,0,9,1,10
232251881,0,0,7,3,10
458591926,10,0,0,0,10
257995608,0,10,0,0,10
419091705,0,0,10,0,10
44851966,8,0,2,0,10
386345949,0,0,10,0,10
242152267,10,0,0,0,10
381698920,1,0,9,0,10
305997139,0,0,10,0,10
456589439,2,0,8,0,10
259169672,0,10,0,0,10
224815152,0,0,10,0,10
289122184,10,0,0,0,10
190154361,9,0,1,0,10
10194781,9,0,1,0,10
268598785,0,0,10,0,10
484940931,0,0,10,0,10
149768346,0,0,10,0,10
491198242,4,0,6,0,10
433696576,0,0,10,0,10
45416627,0,0,9,0,9
8309060,9,0,0,0,9
12485770,9,0,0,0,9
336064553,0,0,9,0,9
244817841,0,0,9,0,9
306295899,0,0,6,3,9
144688687,4,0,5,0,9
430520580,0,0,6,3,9
205745676,0,0,9,0,9
2930761,1,0,8,0,9
355770584,1,0,8,0,9
14103991,0,0,6,3,9
374576747,6,0,3,0,9
401096854,0,0,9,0,9
10387090,0,0,9,0,9
143052745,1,0,8,0,9
8792814,3,0,6,0,9
5615582,8,0,1,0,9
162927656,4,0,5,0,9
404355372,2,0,7,0,9
35524316,0,0,8,1,9
160940380,4,0,5,0,9
159355723,1,0,8,0,9
221913542,4,0,5,0,9
1997143,2,0,2,5,9
476568387,9,0,0,0,9
431476577,0,0,6,3,9
467996701,2,0,7,0,9
393474028,9,0,0,0,9
380332619,9,0,0,0,9
206778021,1,0,8,0,9
314151200,0,1,8,0,9
342139982,4,0,5,0,9
4852748,5,0,4,0,9
271308645,0,0,9,0,9
32368779,8,0,0,1,9
457152913,9,0,0,0,9
279775863,8,0,0,0,8
125620407,2,0,6,0,8
493024482,2,0,6,0,8
49704571,7,0,1,0,8
224532641,0,0,8,0,8
33867639,0,0,8,0,8
417166424,0,0,8,0,8
209279462,8,0,0,0,8
40176101,0,0,8,0,8
499074026,1,0,7,0,8
212164658,8,0,0,0,8
4765305,0,0,8,0,8
371795453,0,0,8,0,8
153340219,8,0,0,0,8
463464923,0,0,8,0,8
21265745,8,0,0,0,8
137129564,1,0,7,0,8
284548162,0,0,4,4,8
496932087,8,0,0,0,8
420975523,8,0,0,0,8
259066380,8,0,0,0,8
112740171,8,0,0,0,8
193502084,0,0,8,0,8
433203831,0,0,8,0,8
375864182,0,0,8,0,8
95303084,8,0,0,0,8
158181451,0,0,8,0,8
397598833,0,0,8,0,8
468527022,0,0,8,0,8
314533486,0,0,0,8,8
37821056,1,0,7,0,8
492149141,0,0,8,0,8
27673980,0,0,8,0,8
105379950,2,0,6,0,8
306001668,0,0,8,0,8
24273714,2,0,6,0,8
63417081,0,0,8,0,8
32446721,0,0,0,8,8
77063818,5,0,3,0,8
155440053,0,0,8,0,8
291033670,0,0,4,4,8
131476075,1,0,7,0,8
177174475,8,0,0,0,8
411034737,3,0,5,0,8
303020032,0,0,8,0,8
19758179,8,0,0,0,8
116382,1,0,7,0,8
293264001,0,0,4,4,8
229274328,5,0,3,0,8
151084261,0,0,8,0,8
263504959,1,0,7,0,8
1339545,8,0,0,0,8
30045574,8,0,0,0,8
37883321,1,0,7,0,8
15145088,8,0,0,0,8
480379890,5,0,3,0,8
345033748,0,0,8,0,8
33320745,8,0,0,0,8
9419684,8,0,0,0,8
397872858,0,0,8,0,8
3491890,8,0,0,0,8
436296663,0,0,0,7,7
161899037,7,0,0,0,7
465738350,7,0,0,0,7
220629418,2,0,5,0,7
15617507,3,0,4,0,7
209832412,7,0,0,0,7
441793133,0,0,7,0,7
26349246,7,0,0,0,7
462961904,7,0,0,0,7
141645843,1,0,6,0,7
261761196,0,0,7,0,7
147762665,0,0,7,0,7
32060911,1,0,6,0,7
57782700,7,0,0,0,7
420415528,7,0,0,0,7
228879817,0,0,7,0,7
434292556,0,0,7,0,7
411757269,0,0,7,0,7
475812927,0,0,7,0,7
411740512,7,0,0,0,7
231138233,0,0,7,0,7
475699129,0,0,7,0,7
407479321,3,0,4,0,7
48593753,7,0,0,0,7
334376746,0,0,7,0,7
382617662,7,0,0,0,7
124976191,2,0,5,0,7
74338125,0,0,7,0,7
228415932,0,0,7,0,7
449715737,0,0,7,0,7
193626078,3,0,4,0,7
165776960,7,0,0,0,7
27636707,7,0,0,0,7
49108760,0,0,7,0,7
204539,7,0,0,0,7
345938275,4,0,3,0,7
47430022,0,0,7,0,7
363928053,0,0,7,0,7
58234433,0,0,7,0,7
240482330,7,0,0,0,7
26535250,6,0,1,0,7
384249346,0,0,7,0,7
224733902,7,0,0,0,7
170964868,7,0,0,0,7
1556814,7,0,0,0,7
333305027,4,0,2,1,7
258289017,0,0,7,0,7
447538686,0,0,7,0,7
20405437,0,0,7,0,7
342060071,7,0,0,0,7
105878573,0,0,7,0,7
156047478,7,0,0,0,7
112901574,2,0,5,0,7
1033970,7,0,0,0,7
310670,6,0,1,0,7
95570540,7,0,0,0,7
1475015,7,0,0,0,7
1140882,0,0,7,0,7
488997576,0,0,7,0,7
295247374,2,0,5,0,7
48866651,7,0,0,0,7
224687317,5,0,2,0,7
24599552,3,0,4,0,7
251852817,0,0,0,7,7
242924411,7,0,0,0,7
231281049,0,0,7,0,7
132777237,3,0,4,0,7
6752504,7,0,0,0,7
9743617,7,0,0,0,7
2787,1,0,4,2,7
393076353,0,0,7,0,7
55922753,0,0,7,0,7
5735865,4,0,2,0,6
50052968,2,0,4,0,6
156948703,1,0,5,0,6
425647682,2,0,4,0,6
450814519,1,0,5,0,6
348034609,0,0,6,0,6
340101464,0,0,6,0,6
340038896,0,0,6,0,6
6880288,6,0,0,0,6
62605071,0,0,6,0,6
303911109,6,0,0,0,6
303133969,0,0,6,0,6
256972139,6,0,0,0,6
368465567,5,0,1,0,6
305387117,0,0,3,3,6
373790863,0,0,5,1,6
295128,0,0,6,0,6
387392238,0,0,6,0,6
488855227,0,0,5,1,6
5986790,0,0,6,0,6
476583892,0,0,6,0,6
479275106,0,0,2,4,6
619942,2,0,4,0,6
446366617,6,0,0,0,6
428639770,6,0,0,0,6
137522531,6,0,0,0,6
80479138,6,0,0,0,6
258230385,5,0,1,0,6
86327101,0,0,6,0,6
428141360,0,0,3,3,6
305489297,6,0,0,0,6
97328229,2,0,4,0,6
36793116,6,0,0,0,6
458074798,2,0,4,0,6
182980197,6,0,0,0,6
174492861,0,0,6,0,6
5853457,0,0,6,0,6
429788210,6,0,0,0,6
16151285,1,0,5,0,6
344299101,0,0,6,0,6
51426218,0,0,6,0,6
6966161,1,0,5,0,6
281700813,0,0,6,0,6
7557833,0,0,6,0,6
194142632,6,0,0,0,6
178473107,0,0,6,0,6
10415675,1,0,5,0,6
212484716,0,0,6,0,6
476353211,0,0,6,0,6
490840837,0,0,6,0,6
68787921,0,0,6,0,6
149151114,0,0,2,4,6
495796281,0,0,6,0,6
82889379,0,0,6,0,6
3716641,6,0,0,0,6
470173109,0,0,6,0,6
432233993,2,0,4,0,6
263331130,0,0,6,0,6
417275418,1,0,5,0,6
66326553,6,0,0,0,6
47782497,0,0,6,0,6
75248463,2,0,4,0,6
32167398,0,0,6,0,6
4888892,0,0,6,0,6
32164030,0,0,6,0,6
6724578,0,0,6,0,6
53725579,0,0,6,0,6
171136827,0,0,6,0,6
240078487,6,0,0,0,6
401277068,0,0,6,0,6
211136294,0,0,6,0,6
261761719,0,0,6,0,6
309612914,3,0,3,0,6
4483467,2,0,4,0,6
91806581,6,0,0,0,6
417839501,1,0,5,0,6
40317143,0,0,6,0,6
435081213,6,0,0,0,6
203982404,2,0,4,0,6
266533448,2,0,4,0,6
203890641,0,0,6,0,6
32908315,6,0,0,0,6
266989293,0,0,6,0,6
501966356,2,0,4,0,6
434697141,4,0,2,0,6
397160899,0,0,6,0,6
121399223,6,0,0,0,6
167270001,1,0,5,0,6
136812761,0,0,6,0,6
169413988,2,0,4,0,6
435369966,0,0,6,0,6
203266238,0,0,6,0,6
360085932,0,0,6,0,6
27741331,0,0,6,0,6
464389822,0,0,6,0,6
88566861,1,0,5,0,6
15231059,0,0,6,0,6
468881737,6,0,0,0,6
48684597,0,0,6,0,6
364867907,0,0,6,0,6
156583372,1,0,5,0,6
153988027,6,0,0,0,6
402187116,6,0,0,0,6
391726093,0,0,6,0,6
261016212,0,1,5,0,6
200047329,0,0,6,0,6
460419777,0,0,6,0,6
205760,6,0,0,0,6
364844663,5,0,0,0,5
47900722,3,0,2,0,5
406942662,0,0,5,0,5
8997485,5,0,0,0,5
188362851,0,0,5,0,5
13462855,4,0,1,0,5
371008926,5,0,0,0,5
12639098,4,0,1,0,5
102643721,2,0,3,0,5
421007927,5,0,0,0,5
26405086,3,0,2,0,5
373968580,0,0,4,1,5
430327041,5,0,0,0,5
113295877,0,0,5,0,5
15787004,0,0,5,0,5
10164435,0,0,5,0,5
436632302,0,0,5,0,5
216235179,0,0,4,1,5
62803,0,0,5,0,5
334383362,0,0,4,1,5
154302755,2,0,3,0,5
433145666,3,0,2,0,5
157870939,0,0,5,0,5
164291123,0,3,2,0,5
173362161,0,0,5,0,5
1494472,5,0,0,0,5
141931484,0,0,5,0,5
199578818,5,0,0,0,5
177038905,5,0,0,0,5
36935244,2,0,3,0,5
183127881,0,0,5,0,5
57885474,5,0,0,0,5
470849793,4,0,1,0,5
412948033,1,0,4,0,5
495021781,1,0,4,0,5
163362268,0,0,5,0,5
470366840,2,0,3,0,5
487732432,5,0,0,0,5
383797462,5,0,0,0,5
306996701,0,0,5,0,5
333256736,0,0,5,0,5
285988114,2,0,3,0,5
478260569,0,0,5,0,5
388575050,5,0,0,0,5
119692067,0,0,5,0,5
462877490,0,0,5,0,5
29582232,4,0,1,0,5
123527938,0,0,5,0,5
5962328,5,0,0,0,5
73570025,1,0,4,0,5
10633027,2,0,3,0,5
208365297,0,0,5,0,5
105616582,5,0,0,0,5
17264040,3,0,2,0,5
223917190,5,0,0,0,5
496566805,0,0,5,0,5
479639290,0,0,4,1,5
391286807,0,0,3,2,5
485546644,5,0,0,0,5
189625025,0,0,5,0,5
207622517,2,0,3,0,5
481405998,0,0,5,0,5
22420999,0,0,5,0,5
293753583,5,0,0,0,5
7365834,5,0,0,0,5
50448556,1,0,4,0,5
1609077,1,0,4,0,5
146776990,0,0,5,0,5
2559004,0,0,5,0,5
143882962,5,0,0,0,5
48183551,0,0,5,0,5
396973673,0,0,5,0,5
37694131,5,0,0,0,5
59156312,0,0,5,0,5
23510890,3,0,2,0,5
92561578,0,0,5,0,5
395806806,0,0,3,2,5
42814202,3,0,2,0,5
55948559,0,0,5,0,5
466440040,0,0,5,0,5
56283770,5,0,0,0,5
228263278,0,0,5,0,5
121851703,5,0,0,0,5
434043863,0,0,5,0,5
377953873,5,0,0,0,5
433716813,2,0,3,0,5
104836016,0,0,5,0,5
377647905,0,0,5,0,5
146005201,5,0,0,0,5
481018020,0,0,5,0,5
468195039,5,0,0,0,5
128246923,5,0,0,0,5
32545798,0,0,5,0,5
269045976,0,0,5,0,5
120974884,4,0,1,0,5
140276044,0,0,5,0,5
402215343,1,0,4,0,5
144008701,0,0,5,0,5
3562322,1,0,4,0,5
244082709,0,0,5,0,5
435891723,0,0,5,0,5
1172202,1,0,4,0,5
321252889,5,0,0,0,5
378759597,1,0,4,0,5
43044876,0,0,5,0,5
188973593,0,0,0,5,5
35935,0,0,5,0,5
490725380,1,0,4,0,5
4714927,0,0,5,0,5
3656008,5,0,0,0,5
50997424,5,0,0,0,5
24260658,0,0,5,0,5
424738135,0,0,5,0,5
194940666,5,0,0,0,5
371421385,0,0,5,0,5
33906660,0,0,5,0,5
156952896,0,0,5,0,5
390346114,5,0,0,0,5
31626212,0,0,5,0,5
147402286,1,0,0,4,5
141027957,5,0,0,0,5
45600001,0,0,5,0,5
138086216,5,0,0,0,5
245314318,0,5,0,0,5
260209224,5,0,0,0,5
381374171,0,0,5,0,5
445169561,0,0,5,0,5
40511252,1,0,4,0,5
134428157,5,0,0,0,5
471441645,5,0,0,0,5
87629139,2,0,3,0,5
5278391,2,0,3,0,5
52403444,5,0,0,0,5
247439246,0,0,5,0,5
139357580,0,0,5,0,5
444889759,0,0,5,0,5
35491667,5,0,0,0,5
306024152,0,0,5,0,5
25537142,0,0,5,0,5
156295223,5,0,0,0,5
325451328,3,0,2,0,5
31534322,0,0,5,0,5
79651295,0,0,5,0,5
230705060,5,0,0,0,5
306349662,0,0,5,0,5
2015914,0,0,5,0,5
492711196,5,0,0,0,5
17152076,2,0,3,0,5
261750091,0,5,0,0,5
493207893,0,0,4,1,5
142352236,5,0,0,0,5
175019394,0,0,5,0,5
461769511,0,0,5,0,5
431507708,0,0,5,0,5
305327549,5,0,0,0,5
376426580,2,0,3,0,5
493392784,0,0,4,1,5
231870747,0,0,5,0,5
186674718,5,0,0,0,5
493467806,2,0,2,1,5
446132894,0,0,5,0,5
393196534,0,0,5,0,5
284126288,0,0,5,0,5
441746363,0,0,5,0,5
128879778,0,0,5,0,5
91571876,5,0,0,0,5
59089906,5,0,0,0,5
47022650,5,0,0,0,5
1949282,0,0,5,0,5
150428984,1,0,4,0,5
41464891,0,0,5,0,5
392217081,5,0,0,0,5
345709132,0,0,5,0,5
119155499,0,0,5,0,5
330408656,5,0,0,0,5
52577963,5,0,0,0,5
114736959,5,0,0,0,5
35783912,0,0,1,4,5
890215,5,0,0,0,5
494585533,1,0,4,0,5
303771161,5,0,0,0,5
446908191,5,0,0,0,5
440469367,0,0,2,3,5
259776956,1,0,4,0,5
471160670,0,0,5,0,5
467100540,4,0,0,0,4
475785151,4,0,0,0,4
475775101,0,0,4,0,4
327409561,0,0,4,0,4
459418901,4,0,0,0,4
482399278,0,0,4,0,4
373077389,1,0,3,0,4
2788934,0,0,4,0,4
1182180,0,0,4,0,4
70410029,1,0,3,0,4
466989452,4,0,0,0,4
1234135,0,0,4,0,4
455426196,0,0,4,0,4
105074140,0,0,4,0,4
377953444,4,0,0,0,4
2675644,0,0,4,0,4
308165996,2,0,2,0,4
79060345,4,0,0,0,4
12589970,2,0,2,0,4
643120,1,0,3,0,4
339542193,1,0,3,0,4
455691328,3,0,1,0,4
480637402,0,0,4,0,4
425034221,4,0,0,0,4
464797341,0,0,4,0,4
300448271,0,0,4,0,4
21534672,2,0,2,0,4
382582503,0,0,4,0,4
473166605,1,0,3,0,4
373307437,3,0,1,0,4
248021206,0,0,4,0,4
107183778,3,0,1,0,4
316839533,4,0,0,0,4
212111101,1,0,3,0,4
68570119,0,0,4,0,4
373012338,0,0,4,0,4
320020592,4,0,0,0,4
25414207,0,0,4,0,4
465353472,1,0,3,0,4
1530310,0,0,4,0,4
110127852,0,0,4,0,4
10366837,1,0,3,0,4
472603377,4,0,0,0,4
298205971,1,0,3,0,4
410066428,4,0,0,0,4
461085634,2,0,2,0,4
318297491,4,0,0,0,4
475832490,1,0,3,0,4
25141383,1,0,3,0,4
454333811,1,0,3,0,4
456132010,4,0,0,0,4
305738569,0,0,4,0,4
236572440,1,0,3,0,4
566838,0,0,4,0,4
22800762,4,0,0,0,4
4232762,1,0,3,0,4
235585976,0,0,3,1,4
14719992,1,0,3,0,4
481108277,0,0,4,0,4
127983545,1,0,3,0,4
1260921,1,0,3,0,4
33622924,0,0,4,0,4
212147885,3,0,1,0,4
153524812,0,0,4,0,4
195034974,0,0,4,0,4
180277260,4,0,0,0,4
138205173,1,0,3,0,4
2928701,4,0,0,0,4
298747627,1,0,3,0,4
47784768,1,0,3,0,4
49293531,2,0,2,0,4
185889529,0,0,4,0,4
417707380,0,0,4,0,4
304261640,1,0,3,0,4
5945833,2,0,1,1,4
65671256,2,0,2,0,4
302743217,1,0,3,0,4
471345215,1,0,3,0,4
1024891,0,0,4,0,4
463027921,0,0,4,0,4
4083654,2,0,2,0,4
194377255,0,0,4,0,4
478717835,1,0,3,0,4
48863708,4,0,0,0,4
463235374,0,0,4,0,4
383229403,4,0,0,0,4
7136700,2,0,2,0,4
478732286,0,0,4,0,4
17266994,4,0,0,0,4
314049729,1,0,3,0,4
155400834,4,0,0,0,4
209504684,1,0,3,0,4
11189753,4,0,0,0,4
251398972,2,0,2,0,4
10580254,1,0,3,0,4
384307416,4,0,0,0,4
107953084,0,0,4,0,4
308799237,0,0,4,0,4
31675601,0,0,4,0,4
64456945,3,0,1,0,4
103392673,0,0,4,0,4
223374565,4,0,0,0,4
139572572,4,0,0,0,4
7065964,4,0,0,0,4
332644295,0,0,4,0,4
138515591,0,0,4,0,4
65109990,0,0,4,0,4
21074914,0,0,4,0,4
413243090,4,0,0,0,4
21020951,0,0,4,0,4
157337532,4,0,0,0,4
758441,0,0,4,0,4
79923089,4,0,0,0,4
240907115,4,0,0,0,4
250252296,4,0,0,0,4
475028559,1,0,3,0,4
247712971,0,0,4,0,4
238547463,0,0,4,0,4
42585587,0,0,4,0,4
30985759,0,0,4,0,4
139238261,4,0,0,0,4
422002010,4,0,0,0,4
12749467,4,0,0,0,4
128244964,0,0,4,0,4
376764698,0,0,4,0,4
78643953,4,0,0,0,4
331185230,2,0,2,0,4
154385604,3,0,1,0,4
322305644,0,0,3,1,4
144839232,1,0,3,0,4
11305944,4,0,0,0,4
251817531,1,0,3,0,4
244116720,0,0,4,0,4
422067855,0,0,4,0,4
65412308,1,0,3,0,4
467718253,4,0,0,0,4
37401126,0,0,4,0,4
48088611,4,0,0,0,4
418726582,1,0,3,0,4
326725787,4,0,0,0,4
243656503,0,0,4,0,4
468168420,0,0,4,0,4
373960546,1,0,3,0,4
182523684,1,0,3,0,4
469102619,4,0,0,0,4
302151163,0,0,4,0,4
302101015,0,0,4,0,4
411936329,0,0,4,0,4
65611806,1,0,3,0,4
1411399,1,0,3,0,4
457157525,1,0,3,0,4
4299040,0,0,4,0,4
417867731,4,0,0,0,4
6726656,1,0,3,0,4
469081668,0,0,4,0,4
7202412,4,0,0,0,4
6600911,0,0,4,0,4
5904463,1,0,3,0,4
129743937,0,0,4,0,4
185013240,0,0,0,4,4
420405708,1,0,3,0,4
1354796,0,0,4,0,4
471714486,4,0,0,0,4
423451497,4,0,0,0,4
238686010,2,0,2,0,4
5704932,0,0,4,0,4
4129805,4,0,0,0,4
2495677,0,0,3,1,4
445742022,3,0,1,0,4
229386490,1,0,3,0,4
45535181,1,0,3,0,4
438550739,4,0,0,0,4
43298076,0,0,4,0,4
148816013,0,0,4,0,4
2368191,4,0,0,0,4
438207643,0,0,4,0,4
18057505,4,0,0,0,4
45595980,4,0,0,0,4
204811322,4,0,0,0,4
428576478,4,0,0,0,4
201938100,4,0,0,0,4
488653607,0,0,4,0,4
45601111,0,0,4,0,4
96659533,0,0,4,0,4
175152359,0,0,4,0,4
8159536,0,0,4,0,4
398977872,0,0,4,0,4
438762718,0,0,4,0,4
135530716,1,0,3,0,4
489878101,0,0,4,0,4
24146326,2,0,1,1,4
20161085,0,0,4,0,4
19805631,0,0,4,0,4
137264725,1,0,3,0,4
161592215,4,0,0,0,4
26602392,0,0,4,0,4
263502162,4,0,0,0,4
14902860,4,0,0,0,4
169873853,4,0,0,0,4
445492801,3,0,1,0,4
292204,4,0,0,0,4
215488365,0,0,4,0,4
292630,1,0,3,0,4
365141716,4,0,0,0,4
229149668,4,0,0,0,4
347502164,3,0,1,0,4
176710208,4,0,0,0,4
358356356,0,0,4,0,4
406193264,0,0,4,0,4
114178652,3,0,1,0,4
257802323,0,0,4,0,4
232782962,0,0,4,0,4
220574429,0,0,4,0,4
487584136,4,0,0,0,4
126247863,0,0,4,0,4
437113809,4,0,0,0,4
15718962,4,0,0,0,4
113986628,1,0,3,0,4
358903800,0,0,4,0,4
3236595,0,1,3,0,4
286772500,4,0,0,0,4
2219255,4,0,0,0,4
398614581,4,0,0,0,4
51716739,4,0,0,0,4
284110817,0,0,4,0,4
398622781,4,0,0,0,4
96741258,4,0,0,0,4
284603393,0,0,4,0,4
141362503,0,0,4,0,4
91111113,4,0,0,0,4
206451695,0,0,4,0,4
148725429,3,0,1,0,4
8998154,2,0,2,0,4
51913277,0,0,4,0,4
488107498,0,0,4,0,4
96891607,1,0,3,0,4
197515217,4,0,0,0,4
14855509,4,0,0,0,4
369602375,0,0,4,0,4
369817284,4,0,0,0,4
497746652,0,0,4,0,4
13318184,0,0,4,0,4
9922972,0,0,4,0,4
264728394,4,0,0,0,4
491906787,0,0,4,0,4
134601877,4,0,0,0,4
28722667,0,0,4,0,4
491695460,1,0,3,0,4
274452385,2,0,2,0,4
352710338,0,0,4,0,4
491347586,4,0,0,0,4
227081166,1,0,3,0,4
75458625,0,0,4,0,4
3436710,0,0,4,0,4
230403448,4,0,0,0,4
443187309,4,0,0,0,4
278008007,0,0,4,0,4
162171692,4,0,0,0,4
209460,2,0,2,0,4
162142087,0,0,4,0,4
95331018,4,0,0,0,4
72704510,3,0,1,0,4
52722718,2,0,2,0,4
492049263,0,0,4,0,4
230609871,0,0,4,0,4
8637211,0,0,4,0,4
39277795,0,0,4,0,4
275535991,0,0,4,0,4
75395247,4,0,0,0,4
216304678,0,0,4,0,4
2415525,2,0,2,0,4
350254795,0,0,4,0,4
350252704,4,0,0,0,4
350231483,0,0,4,0,4
124142417,0,0,4,0,4
262060162,1,0,3,0,4
230947125,0,0,4,0,4
142447586,0,0,4,0,4
276829981,4,0,0,0,4
162109689,4,0,0,0,4
494285165,2,0,2,0,4
347560493,0,0,4,0,4
430121024,0,0,3,1,4
430092283,0,0,4,0,4
443979299,0,0,4,0,4
490257632,0,0,4,0,4
355258878,0,0,4,0,4
272763930,0,0,4,0,4
355450429,4,0,0,0,4
201757076,0,0,3,1,4
256161,1,0,3,0,4
4462261,0,0,4,0,4
91646104,4,0,0,0,4
279648327,0,0,4,0,4
347719349,1,0,2,1,4
117287,0,0,4,0,4
113709,1,0,3,0,4
272342845,2,0,2,0,4
3339701,0,0,4,0,4
163094301,2,0,2,0,4
260618374,0,4,0,0,4
272824348,0,0,4,0,4
490863611,0,0,4,0,4
430599829,0,0,4,0,4
354162373,1,0,3,0,4
40339422,0,0,4,0,4
20086738,1,0,3,0,4
432000371,2,0,2,0,4
440233245,2,0,2,0,4
53877127,2,0,2,0,4
260577152,0,4,0,0,4
494684035,0,0,4,0,4
8338942,0,0,1,3,4
278985545,1,0,3,0,4
490412669,3,0,1,0,4
28270349,1,0,2,1,4
354785010,0,0,4,0,4
7896850,4,0,0,0,4
431183293,2,0,2,0,4
435080344,4,0,0,0,4
233485864,1,0,3,0,4
268198789,0,0,4,0,4
3179968,0,0,4,0,4
291026998,2,0,2,0,4
56916811,0,0,3,1,4
159541257,1,0,3,0,4
40828217,2,0,2,0,4
121612198,0,0,4,0,4
465866457,2,0,2,0,4
62100368,4,0,0,0,4
98726662,0,0,4,0,4
268398473,0,0,4,0,4
39921605,2,0,2,0,4
133288905,4,0,0,0,4
426952784,0,0,4,0,4
207195903,0,0,4,0,4
255526462,0,0,4,0,4
92900025,4,0,0,0,4
19612095,0,0,4,0,4
485479101,0,0,4,0,4
164518602,0,0,4,0,4
206952308,4,0,0,0,4
256610276,1,0,3,0,4
450104410,1,0,3,0,4
133197429,2,0,2,0,4
61842904,4,0,0,0,4
143513836,0,0,4,0,4
435361795,1,0,3,0,4
27648573,2,0,2,0,4
36641,0,0,4,0,4
492457,0,0,4,0,4
37046945,4,0,0,0,4
9289171,4,0,0,0,4
40875021,4,0,0,0,4
39648442,4,0,0,0,4
133123832,4,0,0,0,4
294733575,0,0,4,0,4
99392252,0,0,4,0,4
483378389,0,0,4,0,4
342002500,1,0,3,0,4
71176668,0,0,4,0,4
39553567,4,0,0,0,4
435377805,4,0,0,0,4
291653222,0,0,4,0,4
1650330,0,0,4,0,4
50760404,1,0,3,0,4
484779743,4,0,0,0,4
266755066,0,0,4,0,4
74331597,0,0,4,0,4
266726110,0,0,4,0,4
294887247,4,0,0,0,4
73873252,1,0,3,0,4
452763106,4,0,0,0,4
217621677,1,0,3,0,4
289948179,4,0,0,0,4
363403952,0,0,4,0,4
340938089,0,0,4,0,4
9130040,0,0,4,0,4
266380288,4,0,0,0,4
256966373,4,0,0,0,4
1699871,2,0,2,0,4
83627325,2,0,2,0,4
74885349,4,0,0,0,4
269305936,0,4,0,0,4
206722794,4,0,0,0,4
14046864,1,0,3,0,4
10134825,1,0,3,0,4
293491218,0,0,4,0,4
501536849,0,0,4,0,4
12246186,2,0,2,0,4
406760220,1,0,3,0,4
44018877,4,0,0,0,4
359526434,4,0,0,0,4
486817584,0,0,4,0,4
266092932,4,0,0,0,4
408996132,4,0,0,0,4
22577148,0,0,4,0,4
168619140,1,0,3,0,4
24641078,4,0,0,0,4
397243580,0,0,4,0,4
44123062,0,0,4,0,4
408801405,4,0,0,0,4
81274648,0,0,4,0,4
425972289,4,0,0,0,4
54275,0,0,4,0,4
436048247,4,0,0,0,4
394977252,1,0,3,0,4
289199951,2,0,2,0,4
179383012,1,0,3,0,4
434276514,4,0,0,0,4
36234811,1,0,3,0,4
26354652,0,0,4,0,4
15919349,4,0,0,0,4
408016532,0,0,4,0,4
71009894,2,0,2,0,4
76396985,0,0,4,0,4
395965505,1,0,3,0,4
24715671,4,0,0,0,4
342873987,0,0,4,0,4
145722686,0,0,3,0,3
353406425,0,0,3,0,3
15123868,2,0,1,0,3
16399971,1,0,2,0,3
44924379,0,0,3,0,3
440148941,0,0,3,0,3
104134325,2,0,1,0,3
431986439,3,0,0,0,3
204746258,3,0,0,0,3
89158311,1,0,2,0,3
149296850,0,0,2,1,3
36383387,3,0,0,0,3
189421403,3,0,0,0,3
47633041,3,0,0,0,3
91548150,1,0,2,0,3
441345245,2,0,1,0,3
89162637,1,0,2,0,3
14482375,1,0,2,0,3
441071545,3,0,0,0,3
37459618,2,0,1,0,3
47658174,3,0,0,0,3
352021160,1,0,2,0,3
441039059,0,0,1,2,3
2320031,3,0,0,0,3
352422868,2,0,1,0,3
44992001,0,0,3,0,3
461848161,2,0,1,0,3
2050338,3,0,0,0,3
130777278,3,0,0,0,3
21250331,0,0,3,0,3
24294060,0,0,3,0,3
73098313,0,0,3,0,3
465545416,3,0,0,0,3
465479887,1,0,2,0,3
94713722,1,0,2,0,3
2052361,2,0,1,0,3
22305520,3,0,0,0,3
22129776,1,0,2,0,3
434472879,3,0,0,0,3
1260413,1,0,2,0,3
191552674,0,0,3,0,3
4265630,3,0,0,0,3
2350326,1,0,2,0,3
209549523,0,0,2,1,3
44502437,3,0,0,0,3
44350279,0,0,3,0,3
437502426,2,0,0,1,3
92974704,0,0,3,0,3
37563411,1,0,2,0,3
359911244,0,0,3,0,3
15270760,3,0,0,0,3
67377627,3,0,0,0,3
365090021,0,0,3,0,3
136024214,3,0,0,0,3
376871232,0,0,3,0,3
437920425,3,0,0,0,3
463217904,3,0,0,0,3
4241953,0,0,3,0,3
322199612,3,0,0,0,3
89211125,3,0,0,0,3
437369234,0,0,3,0,3
16514175,3,0,0,0,3
432868716,3,0,0,0,3
73857837,0,0,3,0,3
103810735,2,0,1,0,3
241454071,0,0,3,0,3
74906838,2,0,1,0,3
2343138,3,0,0,0,3
190915917,0,0,3,0,3
103841276,3,0,0,0,3
15009272,0,0,3,0,3
227872371,3,0,0,0,3
436311597,3,0,0,0,3
93011199,0,0,3,0,3
420297717,3,0,0,0,3
43825074,0,0,3,0,3
203068035,0,0,3,0,3
130971031,0,0,3,0,3
4770121,3,0,0,0,3
365301635,0,0,3,0,3
33074274,0,0,3,0,3
92720308,0,0,3,0,3
4719170,0,0,3,0,3
241945355,3,0,0,0,3
241963980,1,0,2,0,3
92714156,0,0,3,0,3
2265770,1,0,2,0,3
136230287,0,0,3,0,3
4264890,3,0,0,0,3
148102066,0,0,3,0,3
24191602,3,0,0,0,3
462385248,0,0,3,0,3
366142747,0,0,3,0,3
421601513,0,0,3,0,3
104125942,0,0,3,0,3
439763939,0,0,3,0,3
4691967,0,0,3,0,3
154506785,3,0,0,0,3
103450258,3,0,0,0,3
147972663,0,0,3,0,3
324599806,1,0,2,0,3
154042156,0,0,3,0,3
4765858,0,0,3,0,3
138770550,3,0,0,0,3
201875657,0,0,3,0,3
93938503,0,0,3,0,3
154037433,0,0,3,0,3
435273407,0,0,3,0,3
4548229,3,0,0,0,3
2373740,0,0,3,0,3
321240668,0,0,3,0,3
67587078,3,0,0,0,3
68139551,0,0,3,0,3
228590032,3,0,0,0,3
435266047,3,0,0,0,3
439378297,3,0,0,0,3
1568269,2,0,1,0,3
89769986,0,0,3,0,3
431018108,0,0,3,0,3
441736253,0,0,3,0,3
15789646,3,0,0,0,3
456814111,1,0,2,0,3
45937956,3,0,0,0,3
342821708,0,0,3,0,3
97853468,0,0,3,0,3
1493123,3,0,0,0,3
342502879,0,0,3,0,3
334592074,0,0,3,0,3
1668930,1,0,2,0,3
450200036,0,0,3,0,3
15811194,0,0,3,0,3
225530795,0,0,3,0,3
456472724,0,0,3,0,3
101285959,0,0,3,0,3
42676520,1,0,2,0,3
450547497,3,0,0,0,3
371382100,0,0,3,0,3
233992920,0,0,3,0,3
42682752,0,0,3,0,3
225790094,0,0,3,0,3
207777872,1,0,2,0,3
341887879,1,0,2,0,3
70007560,1,0,2,0,3
14811787,1,0,2,0,3
343050628,1,0,2,0,3
343127628,0,0,3,0,3
344223705,2,0,1,0,3
427946717,0,0,3,0,3
194196062,0,0,2,1,3
427878013,1,0,2,0,3
4399103,3,0,0,0,3
101653570,0,0,3,0,3
370725742,3,0,0,0,3
14818218,2,0,1,0,3
5416971,2,0,1,0,3
448665899,0,0,3,0,3
42561290,0,0,3,0,3
45857976,1,0,2,0,3
4386682,0,0,3,0,3
5447617,3,0,0,0,3
206714649,0,0,3,0,3
226201658,3,0,0,0,3
225400206,0,0,2,1,3
131976173,0,0,3,0,3
343450886,3,0,0,0,3
237406328,3,0,0,0,3
343381111,3,0,0,0,3
1698391,1,0,2,0,3
71381787,3,0,0,0,3
450955146,0,0,3,0,3
11308947,0,0,3,0,3
373480843,0,0,3,0,3
1539848,1,0,2,0,3
371784614,3,0,0,0,3
90463984,3,0,0,0,3
338412156,3,0,0,0,3
151880786,2,0,1,0,3
34177401,0,0,3,0,3
454216204,2,0,1,0,3
34353017,0,0,3,0,3
454164649,0,0,3,0,3
340285441,0,0,3,0,3
1539749,0,0,3,0,3
371911830,0,0,3,0,3
11379822,0,0,3,0,3
454029808,3,0,0,0,3
235548617,0,0,3,0,3
37072479,2,0,1,0,3
235200338,0,0,3,0,3
339083618,3,0,0,0,3
24771677,3,0,0,0,3
339192135,0,0,3,0,3
5717334,1,0,2,0,3
453666092,0,0,3,0,3
339436944,0,0,3,0,3
207013855,0,0,3,0,3
452039185,0,0,3,0,3
5577926,1,0,1,1,3
15835028,1,0,2,0,3
424685230,3,0,0,0,3
427067962,1,0,2,0,3
194843581,0,0,3,0,3
90334134,0,0,3,0,3
146275359,0,0,3,0,3
76451380,0,0,3,0,3
1635983,0,0,3,0,3
70060476,3,0,0,0,3
146342086,0,0,3,0,3
225889604,0,0,3,0,3
15838559,0,0,3,0,3
337879004,0,0,3,0,3
100672521,0,0,3,0,3
15845173,3,0,0,0,3
70095320,0,0,3,0,3
98868983,3,0,0,0,3
11369454,3,0,0,0,3
425208249,0,0,0,3,3
454771905,2,0,1,0,3
46167132,3,0,0,0,3
132883674,1,0,2,0,3
34431283,1,0,2,0,3
427954433,0,0,3,0,3
5971264,1,0,2,0,3
197372149,0,0,3,0,3
33612342,0,0,3,0,3
1398639,0,0,3,0,3
1401835,0,0,3,0,3
460051201,3,0,0,0,3
89580862,0,0,1,2,3
36732553,0,0,3,0,3
239139334,0,0,3,0,3
430352020,2,0,1,0,3
423062857,3,0,0,0,3
3625735,0,0,3,0,3
72497941,3,0,0,0,3
443680128,0,0,3,0,3
443335070,0,0,3,0,3
339584418,3,0,0,0,3
36741644,3,0,0,0,3
459778513,0,0,3,0,3
47351539,3,0,0,0,3
21500972,0,0,3,0,3
330196322,1,0,2,0,3
68967630,0,0,3,0,3
1900800,1,0,2,0,3
1417757,3,0,0,0,3
11769840,0,0,3,0,3
12720552,0,0,3,0,3
460368490,0,0,3,0,3
43438475,3,0,0,0,3
11123552,0,0,3,0,3
33403059,1,0,2,0,3
1367316,2,0,1,0,3
1369577,3,0,0,0,3
327347956,0,0,3,0,3
89331516,2,0,1,0,3
5117939,1,0,2,0,3
1978551,1,0,2,0,3
422268900,0,0,3,0,3
327961860,0,0,3,0,3
15503780,1,0,2,0,3
239844232,2,0,1,0,3
460436304,0,0,3,0,3
231010965,3,0,0,0,3
145825873,3,0,0,0,3
192483383,2,0,1,0,3
45232769,0,0,3,0,3
349262538,1,0,2,0,3
231150375,0,0,3,0,3
102618751,3,0,0,0,3
24530713,0,0,3,0,3
6136511,1,0,2,0,3
33500990,0,0,3,0,3
75566701,0,0,3,0,3
6059621,0,0,3,0,3
101736132,0,0,3,0,3
4310378,0,0,3,0,3
1785800,0,0,3,0,3
458813192,0,0,3,0,3
423459702,0,0,3,0,3
96664487,3,0,0,0,3
131777975,0,0,3,0,3
458785444,3,0,0,0,3
71852500,3,0,0,0,3
147202249,0,0,3,0,3
71817943,3,0,0,0,3
345626278,0,0,3,0,3
16211060,3,0,0,0,3
428686533,2,0,1,0,3
146132198,0,0,3,0,3
75981937,2,0,1,0,3
345231956,3,0,0,0,3
101862886,3,0,0,0,3
91016269,3,0,0,0,3
5378922,1,0,2,0,3
90930266,0,0,3,0,3
69390579,3,0,0,0,3
197400421,1,0,2,0,3
45735004,3,0,0,0,3
331591329,3,0,0,0,3
69246339,3,0,0,0,3
14614459,1,0,2,0,3
208667188,3,0,0,0,3
45400201,1,0,2,0,3
23982388,3,0,0,0,3
45404393,2,0,1,0,3
227037845,3,0,0,0,3
11757212,0,0,3,0,3
5229579,0,0,3,0,3
199147185,0,0,3,0,3
444802532,0,0,3,0,3
24561040,0,0,3,0,3
445040933,0,0,3,0,3
368010652,3,0,0,0,3
91122315,3,0,0,0,3
2453666,1,0,2,0,3
346903753,0,0,3,0,3
445463950,0,0,2,1,3
37273608,2,0,1,0,3
14898658,0,0,3,0,3
459136924,0,0,3,0,3
1810885,0,0,2,1,3
429095657,0,0,3,0,3
14637971,0,0,3,0,3
147210078,0,0,3,0,3
1240820,3,0,0,0,3
433841620,3,0,0,0,3
210032296,3,0,0,0,3
29358602,1,0,2,0,3
405671301,3,0,0,0,3
326495,2,0,1,0,3
488146762,0,0,3,0,3
3261533,3,0,0,0,3
220480440,0,0,3,0,3
258243498,0,0,3,0,3
3886532,0,0,3,0,3
51954926,0,0,3,0,3
488556209,0,0,3,0,3
126397762,0,0,2,1,3
220305458,0,0,3,0,3
314941,3,0,0,0,3
405091843,3,0,0,0,3
29349060,0,0,3,0,3
283836642,1,0,2,0,3
404960164,1,0,2,0,3
488737581,0,0,3,0,3
283607135,1,0,2,0,3
285016445,3,0,0,0,3
51850937,0,0,3,0,3
3894475,1,0,2,0,3
487965479,0,0,3,0,3
406570749,0,0,3,0,3
176950781,3,0,0,0,3
487317619,0,0,3,0,3
40703442,2,0,1,0,3
60828137,0,0,0,3,3
17893521,0,0,3,0,3
13225047,1,0,2,0,3
7985095,3,0,0,0,3
406163945,2,0,1,0,3
487803588,0,0,3,0,3
389706319,0,0,3,0,3
114238471,3,0,0,0,3
331579,0,0,3,0,3
285523117,3,0,0,0,3
29518662,1,0,2,0,3
285283438,3,0,0,0,3
329271,0,0,3,0,3
390560570,3,0,0,0,3
3864301,3,0,0,0,3
52136347,3,0,0,0,3
280475502,3,0,0,0,3
215837608,1,0,2,0,3
489935910,0,0,3,0,3
265152,1,0,2,0,3
219738858,3,0,0,0,3
140623121,1,0,2,0,3
3820014,0,0,3,0,3
9917136,0,0,3,0,3
279906986,0,0,3,0,3
260537,0,0,3,0,3
8288419,0,0,3,0,3
124985291,0,0,3,0,3
173857407,3,0,0,0,3
59795431,2,0,1,0,3
161863161,1,0,2,0,3
254846,3,0,0,0,3
173685298,0,2,1,0,3
260258030,0,0,3,0,3
403724650,0,0,3,0,3
390939824,0,0,3,0,3
488801886,0,0,3,0,3
8245652,2,0,1,0,3
26555925,2,0,1,0,3
258884392,3,0,0,0,3
283057520,0,0,3,0,3
174986751,0,0,3,0,3
40532977,0,0,3,0,3
29278028,0,0,3,0,3
282625150,3,0,0,0,3
3851843,0,0,3,0,3
259207391,0,0,3,0,3
29219991,1,0,2,0,3
259229690,3,0,0,0,3
18170444,0,0,3,0,3
215556105,1,0,2,0,3
282655,3,0,0,0,3
125323558,1,0,2,0,3
278393,0,0,3,0,3
489735315,3,0,0,0,3
38815234,0,0,3,0,3
7920086,0,0,3,0,3
250735,1,0,2,0,3
293448141,0,0,3,0,3
3136103,0,0,3,0,3
483628357,3,0,0,0,3
387784105,1,0,2,0,3
7580102,1,0,2,0,3
255448841,0,0,3,0,3
524733,1,0,2,0,3
387845873,3,0,0,0,3
519554,1,0,2,0,3
484159181,3,0,0,0,3
86020908,0,0,3,0,3
293238741,3,0,0,0,3
388056806,0,0,3,0,3
30102777,3,0,0,0,3
30080463,2,0,1,0,3
179026754,2,0,1,0,3
179017459,1,0,2,0,3
407838784,0,0,3,0,3
3158364,0,0,3,0,3
483477192,1,0,2,0,3
255234351,0,3,0,0,3
214171931,2,0,1,0,3
483214440,3,0,0,0,3
38593087,0,0,3,0,3
62668424,3,0,0,0,3
409170142,0,0,3,0,3
180154611,0,0,3,0,3
214135354,0,0,2,1,3
482738574,1,0,2,0,3
482750058,0,0,3,0,3
482784187,0,0,3,0,3
50618720,3,0,0,0,3
566660,0,0,3,0,3
408976756,0,0,3,0,3
179778880,0,0,3,0,3
86622957,3,0,0,0,3
296574695,1,0,2,0,3
62533391,0,0,3,0,3
110858930,3,0,0,0,3
483205753,0,0,3,0,3
81015025,1,0,2,0,3
40874834,0,0,3,0,3
484563604,0,0,3,0,3
486231750,3,0,0,0,3
126503835,0,0,3,0,3
288477095,3,0,0,0,3
486475604,3,0,0,0,3
140293912,2,0,1,0,3
486626650,0,0,3,0,3
61175876,1,0,2,0,3
486648462,1,0,2,0,3
288162140,2,0,1,0,3
3213737,0,0,3,0,3
160326327,1,0,1,1,3
40711894,0,0,2,1,3
81359949,0,0,3,0,3
17862696,3,0,0,0,3
51524470,0,0,3,0,3
377151,3,0,0,0,3
29658719,2,0,1,0,3
20302754,1,0,2,0,3
81325020,2,0,1,0,3
407052322,0,0,3,0,3
484656502,1,0,2,0,3
256817214,1,0,2,0,3
51033911,3,0,0,0,3
178521104,0,0,3,0,3
112546119,0,0,3,0,3
7714461,0,0,3,0,3
463061,0,0,3,0,3
484906252,0,0,3,0,3
3179866,3,0,0,0,3
178272943,1,0,2,0,3
388433334,0,0,3,0,3
23219783,3,0,0,0,3
61558856,0,0,3,0,3
26326392,0,0,3,0,3
51339469,3,0,0,0,3
51351678,0,0,2,1,3
485846513,1,0,2,0,3
289154444,2,0,1,0,3
7813520,0,0,3,0,3
402799430,0,0,3,0,3
279230537,3,0,0,0,3
253753123,0,0,3,0,3
54921733,2,0,1,0,3
269860794,3,0,0,0,3
65212,0,0,3,0,3
9553670,3,0,0,0,3
398277756,3,0,0,0,3
269664482,3,0,0,0,3
398191111,0,0,3,0,3
398073234,3,0,0,0,3
61042,0,0,3,0,3
498905143,3,0,0,0,3
399275862,2,0,1,0,3
9532490,1,0,1,1,3
3672774,3,0,0,0,3
83974928,0,0,3,0,3
499393784,0,0,3,0,3
168465501,3,0,0,0,3
268613328,0,3,0,0,3
57023844,0,0,3,0,3
500199803,3,0,0,0,3
9052422,3,0,0,0,3
13486673,0,0,3,0,3
67778,0,0,3,0,3
3530446,3,0,0,0,3
54407723,0,0,3,0,3
271561133,0,0,3,0,3
119987770,0,0,3,0,3
3709510,0,0,3,0,3
496664883,0,0,3,0,3
85330,2,0,1,0,3
264092618,0,0,3,0,3
120245209,2,0,1,0,3
270631254,0,0,3,0,3
394333507,2,0,1,0,3
163625145,0,0,3,0,3
496944241,1,0,2,0,3
163625251,3,0,0,0,3
394602143,3,0,0,0,3
497338419,1,0,2,0,3
394603762,3,0,0,0,3
9598889,1,0,2,0,3
122726779,3,0,0,0,3
13639385,1,0,2,0,3
268362077,0,0,3,0,3
23533897,0,0,3,0,3
9284163,0,0,3,0,3
16866,1,0,2,0,3
266764027,0,3,0,0,3
266741420,0,3,0,0,3
11481,3,0,0,0,3
9328763,3,0,0,0,3
9744,1,0,2,0,3
266645207,0,0,3,0,3
266609191,1,0,2,0,3
396622736,3,0,0,0,3
166713328,0,0,3,0,3
217786217,0,0,3,0,3
396369764,3,0,0,0,3
3621183,3,0,0,0,3
2845,3,0,0,0,3
266083019,0,0,3,0,3
122044895,3,0,0,0,3
165607672,0,0,3,0,3
19312868,0,0,3,0,3
268347722,0,0,3,0,3
165323807,0,0,3,0,3
42273,3,0,0,0,3
9207223,0,0,3,0,3
217326324,1,0,2,0,3
167636238,1,0,2,0,3
500586832,0,0,3,0,3
9501531,0,0,3,0,3
55450195,3,0,0,0,3
167563640,0,0,3,0,3
13611255,3,0,0,0,3
267735490,3,0,0,0,3
217910985,1,0,2,0,3
27848,0,0,3,0,3
501140151,0,0,0,3,3
264984346,2,0,1,0,3
397259778,0,0,3,0,3
167241670,0,0,3,0,3
23193,0,0,3,0,3
271581236,3,0,0,0,3
54378184,3,0,0,0,3
116839989,3,0,0,0,3
19990362,0,0,3,0,3
3388950,0,0,3,0,3
3777978,0,0,3,0,3
53179388,3,0,0,0,3
40245658,1,0,2,0,3
117932348,3,0,0,0,3
275996876,0,0,1,2,3
82363341,1,0,2,0,3
177846,1,0,2,0,3
219333557,1,0,2,0,3
495879533,2,0,1,0,3
13792543,0,0,3,0,3
84810879,2,0,1,0,3
275800186,2,0,1,0,3
166634,0,0,3,0,3
165045,0,0,3,0,3
19962052,2,0,1,0,3
58453451,0,0,3,0,3
393016479,0,0,3,0,3
401904837,0,0,3,0,3
8518665,0,0,3,0,3
85006028,1,0,2,0,3
491814036,3,0,0,0,3
23334165,3,0,0,0,3
240048,3,0,0,0,3
278744903,3,0,0,0,3
490745099,3,0,0,0,3
228858,0,0,3,0,3
162021586,0,0,3,0,3
490876980,0,0,3,0,3
3360618,0,0,3,0,3
39162543,1,0,2,0,3
210746,0,0,3,0,3
3363720,0,0,3,0,3
59225752,0,0,3,0,3
402195263,3,0,0,0,3
172851546,0,0,3,0,3
491605940,0,0,3,0,3
59101644,3,0,0,0,3
193488,0,0,3,0,3
9777215,3,0,0,0,3
8681710,1,0,2,0,3
401050673,0,0,3,0,3
393411688,3,0,0,0,3
119301523,0,0,3,0,3
3734637,0,0,3,0,3
400013151,0,0,3,0,3
127292,3,0,0,0,3
8826175,3,0,0,0,3
272775635,0,0,3,0,3
263266237,1,0,2,0,3
163329653,3,0,0,0,3
28223424,3,0,0,0,3
18865030,3,0,0,0,3
216641760,3,0,0,0,3
3722715,1,0,2,0,3
272305353,0,0,2,1,3
9669675,0,0,3,0,3
123518076,3,0,0,0,3
163421878,0,0,3,0,3
57574248,0,3,0,0,3
170649558,0,0,3,0,3
53845269,0,0,3,0,3
28460706,3,0,0,0,3
400615103,3,0,0,0,3
19931875,2,0,1,0,3
493370318,0,0,3,0,3
493460739,0,0,3,0,3
393051877,1,0,2,0,3
400944908,0,0,3,0,3
18679866,3,0,0,0,3
26953965,0,0,3,0,3
8730173,1,0,2,0,3
53686964,0,0,2,1,3
274118210,1,0,2,0,3
216456504,1,0,2,0,3
273971514,3,0,0,0,3
262570325,3,0,0,0,3
262657892,3,0,0,0,3
19894139,2,0,1,0,3
53821850,2,0,1,0,3
262685334,0,0,3,0,3
110361431,0,0,3,0,3
112932058,3,0,0,0,3
20790185,0,0,3,0,3
313257412,0,0,3,0,3
250358007,0,0,3,0,3
66658078,3,0,0,0,3
244544373,0,0,3,0,3
10777921,3,0,0,0,3
250263013,0,0,3,0,3
469522437,3,0,0,0,3
413827534,0,0,3,0,3
25665185,1,0,2,0,3
107412747,3,0,0,0,3
64660747,3,0,0,0,3
21091779,0,0,3,0,3
107296819,3,0,0,0,3
6655776,1,0,2,0,3
476553626,0,0,3,0,3
249649095,0,0,3,0,3
6586697,0,0,3,0,3
32332007,1,0,2,0,3
313011393,0,0,3,0,3
49725054,0,0,3,0,3
157258551,1,0,2,0,3
66451125,0,0,3,0,3
107187341,3,0,0,0,3
157258161,0,0,3,0,3
66410588,0,0,3,0,3
414139170,3,0,0,0,3
128793815,0,0,3,0,3
48899796,0,0,3,0,3
1002452,0,0,3,0,3
130030703,3,0,0,0,3
475752211,0,0,3,0,3
1093220,1,0,2,0,3
4077993,1,0,2,0,3
477464208,3,0,0,0,3
417740213,3,0,0,0,3
468947930,0,0,3,0,3
251704655,3,0,0,0,3
314410176,3,0,0,0,3
108249932,3,0,0,0,3
302423456,0,0,3,0,3
31241183,0,0,3,0,3
478712063,0,0,3,0,3
302586724,0,0,3,0,3
41941061,3,0,0,0,3
4185135,3,0,0,0,3
727585,3,0,0,0,3
478596025,0,0,3,0,3
3011547,3,0,0,0,3
469253894,1,0,2,0,3
12866178,0,0,3,0,3
251217819,3,0,0,0,3
478513445,0,0,3,0,3
222581357,0,0,3,0,3
383843731,3,0,0,0,3
478199990,0,0,3,0,3
303320919,3,0,0,0,3
182989977,0,0,3,0,3
22926868,0,0,3,0,3
107915864,2,0,1,0,3
31376201,0,0,3,0,3
379993600,3,0,0,0,3
188212054,3,0,0,0,3
25697284,1,0,2,0,3
183239892,1,0,2,0,3
475628873,3,0,0,0,3
79499558,0,0,3,0,3
306576465,1,0,2,0,3
10621098,1,0,2,0,3
310565256,1,0,2,0,3
946943,3,0,0,0,3
310556889,0,0,3,0,3
415690678,3,0,0,0,3
38013656,3,0,0,0,3
310458391,0,0,3,0,3
25341839,3,0,0,0,3
12898987,1,0,2,0,3
471922429,0,0,3,0,3
185908506,1,0,2,0,3
942252,0,0,3,0,3
381702628,0,0,3,0,3
308956896,1,0,2,0,3
472893117,0,0,3,0,3
472821470,0,0,3,0,3
49101398,2,0,1,0,3
472806253,3,0,0,0,3
16954768,0,0,3,0,3
472640880,0,0,3,0,3
106440448,3,0,0,0,3
6770631,0,0,3,0,3
16978120,0,0,3,0,3
381486556,0,0,3,0,3
156484505,0,0,3,0,3
247013511,0,0,3,0,3
41773438,1,0,2,0,3
88326292,3,0,0,0,3
416381658,2,0,1,0,3
918087,1,0,2,0,3
41658748,3,0,0,0,3
88043058,0,0,3,0,3
380496008,3,0,0,0,3
247900596,3,0,0,0,3
6928782,1,0,2,0,3
87889145,2,0,1,0,3
312697286,3,0,0,0,3
17103966,2,0,1,0,3
248743490,0,0,3,0,3
382317267,1,0,2,0,3
245002893,1,0,2,0,3
145002203,3,0,0,0,3
14290739,3,0,0,0,3
470977670,1,0,2,0,3
32220047,3,0,0,0,3
12950555,1,0,2,0,3
17074459,1,0,2,0,3
31805306,0,0,3,0,3
25282898,0,0,3,0,3
14362471,2,0,1,0,3
105762561,1,0,2,0,3
248133997,1,0,2,0,3
860636,0,0,3,0,3
861330,1,0,2,0,3
25308624,2,0,1,0,3
110346349,0,0,3,0,3
17056215,3,0,0,0,3
10712727,1,0,1,1,3
32162495,3,0,0,0,3
185683441,1,0,2,0,3
156302619,2,0,1,0,3
79298323,0,0,3,0,3
6753765,1,0,0,2,3
7157099,1,0,2,0,3
310205815,0,0,3,0,3
30585124,0,0,3,0,3
30616879,0,0,3,0,3
63272360,3,0,0,0,3
642004,3,0,0,0,3
67097676,3,0,0,0,3
317247873,0,0,3,0,3
30895980,2,0,1,0,3
317540555,0,0,3,0,3
50364039,3,0,0,0,3
181710793,1,0,2,0,3
611109,1,0,2,0,3
1171497,1,0,2,0,3
88685097,1,0,2,0,3
419348361,3,0,0,0,3
63403077,0,0,3,0,3
480314541,3,0,0,0,3
467836473,0,0,3,0,3
188886232,1,0,2,0,3
23091281,0,0,3,0,3
224314967,0,0,3,0,3
253526523,3,0,0,0,3
467927303,0,0,3,0,3
154949847,3,0,0,0,3
109327526,3,0,0,0,3
467974528,0,0,3,0,3
10384906,0,0,3,0,3
467083339,1,0,2,0,3
481034810,0,0,3,0,3
1192672,0,0,3,0,3
37718300,3,0,0,0,3
466975236,1,0,2,0,3
32772480,3,0,0,0,3
25168888,1,0,2,0,3
481150531,0,0,3,0,3
316005726,0,0,3,0,3
252633425,0,0,3,0,3
480704914,3,0,0,0,3
67045498,3,0,0,0,3
23909946,0,0,3,0,3
7285648,0,0,3,0,3
299128204,3,0,0,0,3
252604696,0,0,3,0,3
6586128,3,0,0,0,3
213111794,0,0,3,0,3
10402380,0,0,3,0,3
87215632,3,0,0,0,3
104626152,0,0,3,0,3
109671307,1,0,2,0,3
182100068,3,0,0,0,3
42069602,3,0,0,0,3
182363374,0,0,3,0,3
1141935,0,0,3,0,3
108699045,3,0,0,0,3
314467728,0,0,3,0,3
31175000,3,0,0,0,3
66837596,0,0,3,0,3
30542864,0,0,3,0,3
104277076,3,0,0,0,3
109016966,1,0,2,0,3
479765490,3,0,0,0,3
479755663,0,0,3,0,3
479247710,1,0,2,0,3
80262218,1,0,2,0,3
37808742,3,0,0,0,3
63813702,2,0,1,0,3
31083231,0,0,3,0,3
384861601,1,0,2,0,3
50266813,0,0,3,0,3
10348207,0,0,3,0,3
210040180,0,0,2,1,3
32922532,3,0,0,0,3
189404055,0,0,3,0,3
301831302,0,0,3,0,3
297794139,0,0,3,0,3
319061072,2,0,1,0,3
6583272,3,0,0,0,3
63749946,2,0,1,0,3
700224,3,0,0,0,3
227179489,0,0,2,0,2
377577659,1,0,1,0,2
24278208,1,0,1,0,2
217844544,0,0,2,0,2
138994918,0,0,2,0,2
4500999,0,0,2,0,2
3752523,2,0,0,0,2
84562269,0,0,2,0,2
366557107,2,0,0,0,2
37715380,2,0,0,0,2
24175837,0,0,2,0,2
377827583,0,0,2,0,2
364248132,0,0,2,0,2
3737351,0,0,2,0,2
393305761,0,0,2,0,2
37678939,0,0,2,0,2
223719350,1,0,1,0,2
13524368,2,0,0,0,2
36665302,2,0,0,0,2
380972311,2,0,0,0,2
224301575,0,0,2,0,2
378375077,2,0,0,0,2
37703550,0,0,2,0,2
12327430,2,0,0,0,2
4509849,2,0,0,0,2
4167027,1,0,1,0,2
13419129,2,0,0,0,2
395949423,0,0,2,0,2
224315550,0,0,2,0,2
37915862,2,0,0,0,2
224340103,0,0,2,0,2
366413815,2,0,0,0,2
84562428,0,0,2,0,2
393283611,2,0,0,0,2
37918574,1,0,1,0,2
4271822,2,0,0,0,2
366337052,2,0,0,0,2
89158733,0,0,2,0,2
12806055,1,0,1,0,2
92178097,0,0,2,0,2
141547523,0,0,2,0,2
12821514,1,0,1,0,2
4633085,1,0,1,0,2
227890058,1,0,1,0,2
39395765,2,0,0,0,2
4212631,2,0,0,0,2
395029025,2,0,0,0,2
4264065,1,0,1,0,2
394970040,2,0,0,0,2
24258807,2,0,0,0,2
23909694,1,0,1,0,2
395015552,0,0,2,0,2
91851098,2,0,0,0,2
88450280,2,0,0,0,2
364495516,2,0,0,0,2
218526982,1,0,1,0,2
23582893,1,0,1,0,2
4181378,2,0,0,0,2
378886166,2,0,0,0,2
12879538,1,0,1,0,2
91846623,2,0,0,0,2
12856103,0,0,2,0,2
3696506,1,0,1,0,2
377261591,2,0,0,0,2
88576580,0,0,2,0,2
394880853,2,0,0,0,2
23566374,2,0,0,0,2
379126767,2,0,0,0,2
88945872,1,0,1,0,2
394671767,0,0,2,0,2
12864943,1,0,1,0,2
394849063,0,0,2,0,2
394768007,1,0,1,0,2
364506884,2,0,0,0,2
218289083,1,0,0,1,2
364597810,2,0,0,0,2
39543399,0,0,2,0,2
13492085,0,0,2,0,2
12387523,0,0,2,0,2
394177265,2,0,0,0,2
378665358,0,0,2,0,2
13501779,2,0,0,0,2
91734926,2,0,0,0,2
138526119,2,0,0,0,2
39371342,2,0,0,0,2
23548583,2,0,0,0,2
380511537,0,0,2,0,2
4170464,0,0,2,0,2
4543792,0,0,2,0,2
365309485,2,0,0,0,2
4524130,2,0,0,0,2
141135638,2,0,0,0,2
3662122,1,0,1,0,2
380729610,2,0,0,0,2
3660702,0,0,2,0,2
3734323,0,0,2,0,2
3663218,0,0,2,0,2
364330890,2,0,0,0,2
136984427,1,0,1,0,2
224402698,2,0,0,0,2
4562182,2,0,0,0,2
227919091,2,0,0,0,2
227647873,2,0,0,0,2
393754684,1,0,1,0,2
13499885,0,0,2,0,2
3711584,0,0,2,0,2
380492496,2,0,0,0,2
365347511,0,0,2,0,2
12834599,0,0,2,0,2
3664485,0,0,0,2,2
364428427,0,0,2,0,2
12838834,0,0,2,0,2
39448176,1,0,1,0,2
372755385,2,0,0,0,2
85172591,2,0,0,0,2
366584539,0,0,1,1,2
221204634,2,0,0,0,2
388759271,2,0,0,0,2
385091169,2,0,0,0,2
24009463,2,0,0,0,2
86213000,2,0,0,0,2
3921700,1,0,1,0,2
385131981,2,0,0,0,2
4381778,2,0,0,0,2
371071446,0,0,2,0,2
377934109,2,0,0,0,2
12556197,1,0,1,0,2
3922831,1,0,1,0,2
13244076,0,0,2,0,2
4041109,1,0,1,0,2
4040811,1,0,1,0,2
373729963,2,0,0,0,2
37144916,0,0,2,0,2
23831365,2,0,0,0,2
140241933,0,0,2,0,2
388289391,0,0,2,0,2
23829716,2,0,0,0,2
388190137,2,0,0,0,2
388178312,0,0,2,0,2
23834677,2,0,0,0,2
371041988,2,0,0,0,2
23722110,2,0,0,0,2
87372185,0,0,2,0,2
226664611,2,0,0,0,2
24000784,1,0,1,0,2
12531773,0,0,2,0,2
222430446,1,0,1,0,2
4058709,1,0,1,0,2
38819962,2,0,0,0,2
222426321,2,0,0,0,2
220601248,0,0,2,0,2
90153911,2,0,0,0,2
226414996,2,0,0,0,2
370961448,2,0,0,0,2
226230372,0,0,2,0,2
37188098,0,0,2,0,2
4392159,1,0,1,0,2
226205088,2,0,0,0,2
87397826,0,0,2,0,2
225420039,0,0,2,0,2
373999338,2,0,0,0,2
3905432,0,0,2,0,2
384583884,0,0,2,0,2
384584994,1,0,1,0,2
388071431,2,0,0,0,2
4375988,0,0,2,0,2
4039777,2,0,0,0,2
87065585,2,0,0,0,2
137817563,2,0,0,0,2
38530455,1,0,1,0,2
37077716,2,0,0,0,2
3975734,2,0,0,0,2
3977023,0,0,2,0,2
372284502,2,0,0,0,2
372811671,0,0,2,0,2
23788168,0,0,2,0,2
86887132,2,0,0,0,2
24033902,0,0,2,0,2
4358400,2,0,0,0,2
372445085,0,0,2,0,2
221839786,0,0,2,0,2
386408403,0,0,0,2,2
38604449,0,0,2,0,2
37083908,2,0,0,0,2
221844597,2,0,0,0,2
386678438,0,0,2,0,2
372574956,2,0,0,0,2
13098292,1,0,1,0,2
3992566,0,0,2,0,2
371995396,2,0,0,0,2
13125944,0,0,2,0,2
388024070,2,0,0,0,2
13063145,2,0,0,0,2
87183086,0,0,2,0,2
387999551,2,0,0,0,2
3948855,1,0,1,0,2
3952200,2,0,0,0,2
13143585,1,0,1,0,2
38404959,0,0,2,0,2
371490719,0,0,2,0,2
387885886,2,0,0,0,2
38407862,0,0,2,0,2
371501812,0,0,2,0,2
37044025,2,0,0,0,2
385647750,0,0,2,0,2
90429772,0,0,2,0,2
387699039,2,0,0,0,2
37058836,1,0,1,0,2
139712252,2,0,0,0,2
221434490,0,0,2,0,2
387493702,0,0,2,0,2
139838320,2,0,0,0,2
221574115,0,0,1,1,2
385782494,0,0,2,0,2
389805358,2,0,0,0,2
139528206,2,0,0,0,2
12446529,0,0,2,0,2
219521175,0,0,2,0,2
391891939,2,0,0,0,2
3801683,2,0,0,0,2
89361094,2,0,0,0,2
375470611,1,0,1,0,2
219519216,2,0,0,0,2
375394646,2,0,0,0,2
3805240,0,0,2,0,2
4296251,0,0,2,0,2
381930015,2,0,0,0,2
391579286,2,0,0,0,2
12715154,0,0,2,0,2
4314440,0,0,2,0,2
85191443,0,0,2,0,2
225011474,2,0,0,0,2
85202871,2,0,0,0,2
4464205,0,0,2,0,2
367571306,2,0,0,0,2
227052258,0,0,2,0,2
139165159,0,0,2,0,2
89680730,0,0,2,0,2
382149624,0,0,2,0,2
89715420,1,0,1,0,2
36728751,2,0,0,0,2
375687526,2,0,0,0,2
23898129,0,0,2,0,2
89337192,1,0,1,0,2
3752933,0,0,2,0,2
13406954,0,0,2,0,2
3758471,0,0,2,0,2
4148248,2,0,0,0,2
4279384,0,0,2,0,2
4492236,1,0,1,0,2
392563222,0,0,2,0,2
12906385,0,0,2,0,2
37987441,0,0,2,0,2
219347424,1,0,1,0,2
36711390,0,0,2,0,2
3776550,0,0,2,0,2
227161651,2,0,0,0,2
139127299,2,0,0,0,2
13358864,0,0,2,0,2
23952819,2,0,0,0,2
4481005,0,0,2,0,2
91427536,1,0,1,0,2
223558519,0,0,2,0,2
3792860,2,0,0,0,2
3799199,1,0,1,0,2
4120523,1,0,1,0,2
87983379,2,0,0,0,2
367954857,2,0,0,0,2
4430927,0,0,2,0,2
369104627,2,0,0,0,2
382918364,2,0,0,0,2
382990330,2,0,0,0,2
369226179,2,0,0,0,2
85560653,0,0,2,0,2
390359155,0,0,2,0,2
12986426,2,0,0,0,2
374799676,0,0,2,0,2
3876092,0,0,2,0,2
4089511,2,0,0,0,2
90043913,0,0,2,0,2
13006166,1,0,1,0,2
23700673,0,0,2,0,2
390243588,2,0,0,0,2
4422962,2,0,0,0,2
220415923,1,0,1,0,2
225283096,0,0,2,0,2
90117794,1,0,1,0,2
38294216,0,0,2,0,2
389848232,0,0,2,0,2
369416627,2,0,0,0,2
12508991,0,0,2,0,2
36830075,0,0,2,0,2
39097380,2,0,0,0,2
368722719,0,0,2,0,2
382191358,1,0,1,0,2
23863809,1,0,1,0,2
85336401,1,0,1,0,2
367986829,0,0,2,0,2
382471468,2,0,0,0,2
3842134,0,0,2,0,2
219930693,0,0,2,0,2
3851320,2,0,0,0,2
87814281,0,0,2,0,2
4303663,1,0,1,0,2
382750991,0,0,2,0,2
368084012,2,0,0,0,2
139318196,1,0,1,0,2
140470401,2,0,0,0,2
390588257,2,0,0,0,2
37267657,0,0,2,0,2
223147583,2,0,0,0,2
225118276,0,0,2,0,2
36818817,0,0,2,0,2
4440548,1,0,1,0,2
3861404,0,0,2,0,2
56197328,1,0,1,0,2
102410496,2,0,0,0,2
4657612,2,0,0,0,2
111158974,2,0,0,0,2
7475363,0,0,2,0,2
296771080,0,0,2,0,2
127560222,0,0,2,0,2
254372359,2,0,0,0,2
26080800,1,0,1,0,2
110871178,2,0,0,0,2
10312394,1,0,1,0,2
10312167,2,0,0,0,2
295370107,2,0,0,0,2
127345864,2,0,0,0,2
295225889,0,0,2,0,2
294947030,0,0,2,0,2
292434893,0,0,1,1,2
7577288,1,0,1,0,2
255420742,1,0,1,0,2
111293940,0,0,2,0,2
255787023,0,0,2,0,2
7610841,1,0,1,0,2
127113351,2,0,0,0,2
293746147,1,0,1,0,2
10263251,2,0,0,0,2
255845850,2,0,0,0,2
127080012,1,0,1,0,2
111723789,2,0,0,0,2
7474069,1,0,1,0,2
110506181,1,0,1,0,2
254112876,0,0,2,0,2
110461101,2,0,0,0,2
299411542,0,0,2,0,2
109913814,1,0,1,0,2
299047468,0,0,2,0,2
109930093,0,0,2,0,2
298841502,2,0,0,0,2
127847762,2,0,0,0,2
127721863,2,0,0,0,2
110157122,0,0,2,0,2
253332603,0,0,2,0,2
26024053,0,0,2,0,2
7389707,1,0,0,1,2
297826852,0,0,2,0,2
127618565,0,0,2,0,2
297673205,0,0,2,0,2
253690060,1,0,1,0,2
7427325,1,0,1,0,2
30494797,1,0,1,0,2
253814755,0,0,2,0,2
297311545,0,0,2,0,2
26045887,0,0,2,0,2
297240751,0,0,2,0,2
7455706,0,0,2,0,2
297222629,0,0,2,0,2
10243387,1,0,1,0,2
30054890,0,0,2,0,2
114216912,1,0,1,0,2
257569145,0,0,2,0,2
29817997,0,0,2,0,2
288624351,0,0,2,0,2
26376271,2,0,0,0,2
7850260,2,0,0,0,2
29740456,0,0,2,0,2
113469347,2,0,0,0,2
287546971,0,0,2,0,2
26389845,0,0,2,0,2
113675886,0,0,2,0,2
29659188,2,0,0,0,2
257487417,0,0,2,0,2
113892395,0,0,2,0,2
292070896,0,0,2,0,2
286945536,0,0,2,0,2
7939437,1,0,1,0,2
257640921,0,0,2,0,2
7952814,1,0,1,0,2
286713684,1,0,1,0,2
286710754,2,0,0,0,2
286228252,2,0,0,0,2
257773717,0,0,2,0,2
10061009,1,0,1,0,2
7979680,2,0,0,0,2
10055751,1,0,1,0,2
256877591,0,0,2,0,2
113121846,1,0,1,0,2
7801481,0,0,2,0,2
289858949,2,0,0,0,2
7659349,0,0,2,0,2
10236340,0,0,2,0,2
10234050,2,0,0,0,2
291868811,0,0,2,0,2
10220753,0,0,2,0,2
112335936,0,0,2,0,2
26255832,1,0,1,0,2
112452087,0,0,2,0,2
26271616,0,0,2,0,2
291168522,2,0,0,0,2
291093876,2,0,0,0,2
7728790,0,0,2,0,2
112773863,1,0,1,0,2
112814443,2,0,0,0,2
7752638,1,0,0,1,2
256462453,1,0,1,0,2
112909067,2,0,0,0,2
7760617,2,0,0,0,2
126614438,2,0,0,0,2
7772526,2,0,0,0,2
29876409,0,0,2,0,2
7777783,0,0,2,0,2
290103444,0,0,2,0,2
30751774,1,0,1,0,2
7309378,0,0,2,0,2
25944182,0,0,2,0,2
31658624,0,0,2,0,2
106921037,1,0,1,0,2
307566664,0,0,2,0,2
128940676,0,0,2,0,2
31747645,0,0,2,0,2
31680304,0,0,2,0,2
107040079,0,0,2,0,2
306592549,1,0,1,0,2
306482362,2,0,0,0,2
10577784,1,0,1,0,2
107082851,0,0,2,0,2
128895953,0,0,2,0,2
6950389,0,0,2,0,2
25915648,0,0,2,0,2
248880851,0,0,2,0,2
305718497,2,0,0,0,2
31621291,0,0,1,1,2
305537389,2,0,0,0,2
249525924,0,0,2,0,2
10557507,2,0,0,0,2
107275235,1,0,1,0,2
249757880,0,0,2,0,2
25608298,0,0,2,0,2
305136585,2,0,0,0,2
305090694,1,0,1,0,2
106899231,2,0,0,0,2
6902927,1,0,1,0,2
31796843,0,0,2,0,2
307784227,0,0,2,0,2
6801314,2,0,0,0,2
246923606,2,0,0,0,2
31919780,2,0,0,0,2
129396046,2,0,0,0,2
31916657,2,0,0,0,2
247446830,0,0,2,0,2
31895696,2,0,0,0,2
247502306,0,0,2,0,2
31884399,2,0,0,0,2
308736652,2,0,0,0,2
308730623,2,0,0,0,2
10630723,2,0,0,0,2
106569357,2,0,0,0,2
25461543,1,0,1,0,2
106634512,1,0,1,0,2
106660574,0,0,2,0,2
129263359,2,0,0,0,2
308339340,2,0,0,0,2
31851704,0,0,2,0,2
106756395,0,0,1,1,2
10612293,0,0,2,0,2
129158371,0,0,2,0,2
307970900,0,0,2,0,2
304559935,2,0,0,0,2
7021059,1,0,1,0,2
10549294,1,0,1,0,2
302138294,0,0,2,0,2
10456845,1,0,1,0,2
128300825,0,0,2,0,2
301720129,2,0,0,0,2
31174103,0,0,2,0,2
128284544,2,0,0,0,2
10450748,2,0,0,0,2
7195403,1,0,1,0,2
7198128,0,0,2,0,2
108719570,1,0,1,0,2
7219450,0,0,2,0,2
301049251,2,0,0,0,2
10432817,0,0,2,0,2
10428997,1,0,1,0,2
300812117,2,0,0,0,2
300551054,0,0,0,2,2
252356839,1,0,1,0,2
7252221,0,0,2,0,2
7257682,1,0,1,0,2
30892592,2,0,0,0,2
30848788,0,0,2,0,2
128086219,0,0,2,0,2
299955284,0,0,2,0,2
7289570,2,0,0,0,2
10457300,2,0,0,0,2
302205591,0,0,2,0,2
107462006,2,0,0,0,2
302283311,2,0,0,0,2
25687903,2,0,0,0,2
7028737,0,0,2,0,2
10534508,2,0,0,0,2
31469635,0,0,2,0,2
304199796,2,0,0,0,2
107578852,0,0,2,0,2
250294796,0,0,2,0,2
10529251,0,0,2,0,2
250376883,0,0,2,0,2
303867618,2,0,0,0,2
7073209,0,0,2,0,2
128565429,2,0,0,0,2
128517263,0,0,2,0,2
25718914,0,0,2,0,2
250772683,0,0,2,0,2
303320045,1,0,1,0,2
25753120,0,0,2,0,2
108023873,2,0,0,0,2
251166866,0,0,2,0,2
302903408,2,0,0,0,2
302847508,0,0,2,0,2
251428213,2,0,0,0,2
25770205,2,0,0,0,2
7988149,1,0,1,0,2
7989399,0,0,2,0,2
136285709,0,0,2,0,2
264240981,0,0,2,0,2
123472158,2,0,0,0,2
8925493,0,0,2,0,2
8925763,2,0,0,0,2
271378458,0,0,2,0,2
263994272,1,0,1,0,2
8961407,2,0,0,0,2
8977158,2,0,0,0,2
27962518,0,0,2,0,2
270414511,1,0,1,0,2
8993084,1,0,1,0,2
270372514,2,0,0,0,2
8998779,1,0,1,0,2
9545089,2,0,0,0,2
9006067,1,0,1,0,2
270318441,0,0,2,0,2
264393536,2,0,0,0,2
9030453,0,0,2,0,2
270130811,0,0,2,0,2
27895636,2,0,0,0,2
9051298,1,0,0,1,2
264569855,0,0,2,0,2
123048179,2,0,0,0,2
27863482,2,0,0,0,2
9070754,0,0,2,0,2
27084741,0,0,2,0,2
119936528,1,0,1,0,2
9642814,0,0,2,0,2
263937485,1,0,1,0,2
118751485,0,0,2,0,2
273984177,2,0,0,0,2
8732694,2,0,0,0,2
8736641,0,0,2,0,2
28375704,0,0,2,0,2
123672154,0,0,2,0,2
273424772,2,0,0,0,2
9725785,0,0,2,0,2
8783166,0,0,2,0,2
262874199,2,0,0,0,2
123634626,2,0,0,0,2
273301089,0,0,2,0,2
119447491,0,0,2,0,2
272888515,0,0,2,0,2
26996515,0,0,1,1,2
119592255,0,0,2,0,2
8852676,2,0,0,0,2
27061510,0,0,2,0,2
9679192,0,0,2,0,2
8857591,2,0,0,0,2
28190733,0,0,2,0,2
8869512,0,0,2,0,2
8893700,2,0,0,0,2
9072771,0,0,2,0,2
269609725,2,0,0,0,2
125914985,2,0,0,0,2
266800860,2,0,0,0,2
121379512,0,0,2,0,2
27325352,2,0,0,0,2
27336207,2,0,0,0,2
121544270,2,0,0,0,2
27375469,1,0,1,0,2
267112113,1,0,1,0,2
267033835,1,0,1,0,2
267028253,0,0,2,0,2
9285314,2,0,0,0,2
27378293,0,0,2,0,2
266819898,2,0,0,0,2
265413038,0,0,2,0,2
9090698,2,0,0,0,2
266651586,2,0,0,0,2
121771546,0,0,2,0,2
266577166,0,0,2,0,2
265420923,0,0,2,0,2
266559178,2,0,0,0,2
121809482,1,0,1,0,2
265424495,0,0,2,0,2
266390808,1,0,0,1,2
266360944,0,0,2,0,2
27382789,2,0,0,0,2
121917249,0,0,2,0,2
264990100,2,0,0,0,2
27610676,2,0,0,0,2
27615247,2,0,0,0,2
9234456,0,0,2,0,2
269375752,2,0,0,0,2
9537721,1,0,1,0,2
9119678,0,0,2,0,2
9524360,2,0,0,0,2
122877644,2,0,0,0,2
268857972,1,0,1,0,2
27277459,2,0,0,0,2
264850701,2,0,0,0,2
9510011,2,0,0,0,2
27717006,0,0,2,0,2
268611281,0,0,2,0,2
27698539,1,0,1,0,2
268399048,0,0,2,0,2
268397728,0,0,2,0,2
268218366,0,0,2,0,2
27664722,0,0,2,0,2
9209691,2,0,0,0,2
9209820,2,0,0,0,2
121246340,2,0,0,0,2
9215509,2,0,0,0,2
27636450,1,0,1,0,2
27634654,0,0,2,0,2
9226879,0,0,2,0,2
118700852,0,0,2,0,2
8725682,1,0,1,0,2
274584744,2,0,0,0,2
29003805,0,0,2,0,2
29241227,2,0,0,0,2
26597048,2,0,0,0,2
282167702,1,0,1,0,2
9952523,2,0,0,0,2
8207362,0,0,2,0,2
26671786,0,0,2,0,2
259468466,0,0,2,0,2
280929444,0,0,2,0,2
116056294,1,0,1,0,2
116067987,2,0,0,0,2
9933134,2,0,0,0,2
280387425,0,0,2,0,2
8697041,0,0,2,0,2
8259529,2,0,0,0,2
280253653,0,0,2,0,2
28980313,2,0,0,0,2
8265050,2,0,0,0,2
9919024,1,0,1,0,2
116404073,2,0,0,0,2
116482644,0,0,2,0,2
116695735,2,0,0,0,2
9897124,1,0,1,0,2
8308648,0,0,2,0,2
8312621,2,0,0,0,2
259063599,2,0,0,0,2
9989761,0,0,1,1,2
125545452,1,0,1,0,2
283338112,2,0,0,0,2
29510402,1,0,1,0,2
285088479,0,0,2,0,2
26479712,1,0,1,0,2
257985993,2,0,0,0,2
284960492,2,0,0,0,2
29472753,1,0,1,0,2
125817047,1,0,1,0,2
125711943,2,0,0,0,2
114667843,2,0,0,0,2
284563606,2,0,0,0,2
114828297,1,0,1,0,2
125687221,0,0,2,0,2
284286042,0,0,2,0,2
8113165,1,0,1,0,2
8115401,1,0,1,0,2
8115522,0,0,2,0,2
284064678,1,0,1,0,2
8124038,0,0,2,0,2
26538766,1,0,0,1,2
115057851,2,0,0,0,2
8133558,1,0,1,0,2
115136074,1,0,1,0,2
258806401,2,0,0,0,2
8325020,0,0,2,0,2
279024287,1,0,1,0,2
260396179,2,0,0,0,2
117598640,0,0,2,0,2
8548430,1,0,1,0,2
8552126,2,0,0,0,2
117675375,0,0,2,0,2
261632622,0,0,2,0,2
124279642,2,0,0,0,2
261682551,2,0,0,0,2
8581058,0,0,2,0,2
8594019,0,0,2,0,2
8595112,0,0,2,0,2
8612450,1,0,1,0,2
8616291,0,0,2,0,2
8630543,2,0,0,0,2
8636732,1,0,1,0,2
28584269,1,0,1,0,2
124028462,0,0,2,0,2
275402693,0,0,2,0,2
28576665,2,0,0,0,2
28574655,2,0,0,0,2
123977712,0,0,2,0,2
275135522,0,0,2,0,2
118419433,0,0,2,0,2
274792241,0,0,2,0,2
28449397,0,0,2,0,2
276704855,2,0,0,0,2
28707701,1,0,1,0,2
28823649,2,0,0,0,2
28709982,1,0,1,0,2
116885950,0,0,2,0,2
8351424,1,0,1,0,2
116985862,1,0,1,0,2
28808740,0,0,2,0,2
8366233,0,0,2,0,2
8384058,2,0,0,0,2
8387407,0,0,2,0,2
124710422,0,0,2,0,2
117195769,0,0,2,0,2
124702572,2,0,0,0,2
260861596,0,2,0,0,2
8441265,1,0,1,0,2
260987211,0,0,2,0,2
8452639,0,0,2,0,2
8457214,1,0,1,0,2
277698942,0,0,2,0,2
277657060,0,0,2,0,2
277413518,2,0,0,0,2
8504385,1,0,1,0,2
277225496,2,0,0,0,2
8515724,0,0,2,0,2
9843389,0,0,2,0,2
261427783,0,0,2,0,2
129499210,0,0,2,0,2
6792120,2,0,0,0,2
6787261,1,0,1,0,2
5354308,2,0,0,0,2
346223188,2,0,0,0,2
5319354,1,0,1,0,2
96479013,2,0,0,0,2
5325134,2,0,0,0,2
96571275,0,0,2,0,2
96589640,1,0,1,0,2
96712147,1,0,1,0,2
5342802,0,0,2,0,2
34992043,0,0,2,0,2
34991003,0,0,2,0,2
5352610,1,0,1,0,2
34943122,1,0,1,0,2
133918254,0,0,2,0,2
96892684,0,0,2,0,2
133975955,1,0,1,0,2
5369117,0,0,2,0,2
232772243,1,0,1,0,2
34913162,2,0,0,0,2
97044757,1,0,1,0,2
24614094,0,0,2,0,2
97106009,2,0,0,0,2
97127885,2,0,0,0,2
344531954,0,0,2,0,2
11625123,2,0,0,0,2
5317082,0,0,2,0,2
134140323,2,0,0,0,2
96379938,0,0,2,0,2
35100060,2,0,0,0,2
134370506,0,0,2,0,2
24558222,1,0,1,0,2
347497076,0,0,1,1,2
24559370,1,0,1,0,2
5268758,2,0,0,0,2
96148809,2,0,0,0,2
5281237,0,0,2,0,2
347044503,0,0,2,0,2
231846634,0,0,0,2,2
35174506,0,0,2,0,2
96202808,1,0,1,0,2
346849574,0,0,2,0,2
96219565,2,0,0,0,2
11725608,0,0,2,0,2
134180270,2,0,0,0,2
346712699,2,0,0,0,2
134170699,0,0,2,0,2
5300413,0,0,2,0,2
231959634,0,0,2,0,2
5302735,2,0,0,0,2
24580977,2,0,0,0,2
24589216,1,0,1,0,2
5309160,2,0,0,0,2
344437843,2,0,0,0,2
344340194,2,0,0,0,2
6786361,0,0,2,0,2
234755971,2,0,0,0,2
24738407,2,0,0,0,2
234416636,0,0,2,0,2
34400734,1,0,1,0,2
132844782,2,0,0,0,2
234539932,0,0,2,0,2
11457662,2,0,0,0,2
24761711,2,0,0,0,2
34386241,2,0,0,0,2
132784640,0,0,2,0,2
5652395,0,0,2,0,2
340212196,0,0,2,0,2
24765924,0,0,2,0,2
344320464,2,0,0,0,2
99547346,2,0,0,0,2
5679552,1,0,1,0,2
340064506,2,0,0,0,2
339827309,0,0,2,0,2
99644584,2,0,0,0,2
34274867,0,0,2,0,2
5707158,0,0,1,1,2
339365455,1,0,1,0,2
99665421,0,0,2,0,2
24789838,0,0,2,0,2
99791908,0,0,2,0,2
34457315,2,0,0,0,2
341331305,0,0,2,0,2
133004690,2,0,0,0,2
234234513,1,0,1,0,2
5414067,2,0,0,0,2
34861728,0,0,2,0,2
133812877,0,0,2,0,2
344029666,0,0,2,0,2
233207914,2,0,0,0,2
97538710,1,0,1,0,2
97543375,0,0,2,0,2
233360418,0,0,2,0,2
233422217,0,0,2,0,2
343526940,2,0,0,0,2
133602911,0,0,2,0,2
11571496,2,0,0,0,2
342996270,2,0,0,0,2
342847741,2,0,0,0,2
5499953,1,0,1,0,2
342223816,1,0,1,0,2
133299438,0,0,2,0,2
5551314,0,0,2,0,2
5555793,1,0,1,0,2
34595916,2,0,0,0,2
5586949,2,0,0,0,2
34556469,0,0,2,0,2
234214434,1,0,1,0,2
11767749,1,0,1,0,2
348032287,0,0,2,0,2
231452775,1,0,1,0,2
36063879,1,0,1,0,2
93231383,2,0,0,0,2
12150056,2,0,0,0,2
358583657,0,0,2,0,2
36093196,0,0,2,0,2
93339222,2,0,0,0,2
4848317,1,0,1,0,2
358151054,2,0,0,0,2
358089614,0,0,2,0,2
4878363,0,0,2,0,2
357993424,0,0,2,0,2
357914975,0,0,2,0,2
357523705,0,0,2,0,2
5214644,2,0,0,0,2
12123995,2,0,0,0,2
36053172,2,0,0,0,2
357452194,0,0,2,0,2
357279975,2,0,0,0,2
93526944,2,0,0,0,2
93567450,2,0,0,0,2
93732420,1,0,1,0,2
12104046,2,0,0,0,2
135710202,2,0,0,0,2
229454644,2,0,0,0,2
4932876,2,0,0,0,2
358933697,0,0,2,0,2
359075187,0,0,2,0,2
12156706,1,0,1,0,2
93148942,0,0,2,0,2
92322271,0,0,2,0,2
4666670,1,0,1,0,2
24291213,0,0,2,0,2
12264492,1,0,0,1,2
362780658,1,0,1,0,2
12258594,1,0,1,0,2
92588965,2,0,0,0,2
24298733,0,0,2,0,2
362207874,0,0,2,0,2
12248031,1,0,1,0,2
12245536,0,0,2,0,2
12233355,1,0,1,0,2
4715188,2,0,0,0,2
360991167,0,0,2,0,2
228608906,0,0,2,0,2
360573155,0,0,2,0,2
4769886,1,0,1,0,2
92841026,1,0,1,0,2
36242952,0,0,2,0,2
12211018,2,0,0,0,2
12190039,1,0,1,0,2
93070950,0,0,2,0,2
359474540,0,0,2,0,2
4936720,0,0,2,0,2
94048062,1,0,1,0,2
356380817,2,0,0,0,2
5075103,0,0,2,0,2
230713737,0,0,2,0,2
35528708,0,0,2,0,2
11866840,0,0,2,0,2
5120169,0,0,2,0,2
349860058,0,0,2,0,2
11837926,0,0,2,0,2
11824700,1,0,1,0,2
24525564,2,0,0,0,2
134521683,0,0,2,0,2
35412557,1,0,1,0,2
5159449,2,0,0,0,2
35391290,2,0,0,0,2
95572265,0,0,2,0,2
24532289,0,0,2,0,2
5166944,0,0,2,0,2
348427562,2,0,0,0,2
348328077,2,0,0,0,2
24544724,2,0,0,0,2
35355701,2,0,0,0,2
11773839,0,0,2,0,2
5192686,0,0,2,0,2
35331837,0,0,2,0,2
5202854,1,0,1,0,2
5076827,2,0,0,0,2
351236426,2,0,0,0,2
229695499,0,0,2,0,2
35558695,0,0,2,0,2
94219511,0,0,2,0,2
355590174,2,0,0,0,2
4964682,2,0,0,0,2
229858536,2,0,0,0,2
4970027,2,0,0,0,2
11998560,1,0,1,0,2
135320687,0,0,2,0,2
230025652,0,0,2,0,2
11975404,0,0,2,0,2
35819315,2,0,0,0,2
4983320,0,0,2,0,2
354111570,1,0,1,0,2
230108889,0,0,2,0,2
35736676,0,0,2,0,2
94536810,0,0,2,0,2
94684854,2,0,0,0,2
5023498,1,0,0,1,2
352220665,0,0,2,0,2
351914727,2,0,0,0,2
351763192,0,0,2,0,2
351734350,2,0,0,0,2
35594166,0,0,2,0,2
351489331,0,0,2,0,2
338850187,2,0,0,0,2
34184387,0,0,2,0,2
338738466,0,0,2,0,2
10900144,2,0,0,0,2
319622263,0,0,1,1,2
104238268,2,0,0,0,2
319296673,2,0,0,0,2
319093849,0,0,2,0,2
6407054,1,0,1,0,2
6410979,1,0,1,0,2
319049221,2,0,0,0,2
104403379,1,0,1,0,2
10909829,2,0,0,0,2
242631139,0,0,2,0,2
318548277,0,0,2,0,2
104721305,1,0,1,0,2
6264251,2,0,0,0,2
130476089,0,0,2,0,2
243009708,0,0,2,0,2
6472334,1,0,1,0,2
317737966,2,0,0,0,2
317238830,0,0,2,0,2
243267345,2,0,0,0,2
6489574,2,0,0,0,2
10856865,2,0,0,0,2
104946561,0,0,2,0,2
10843764,1,0,1,0,2
243489304,0,0,2,0,2
319633263,2,0,0,0,2
10933956,1,0,1,0,2
319990351,2,0,0,0,2
6387355,1,0,1,0,2
11039369,1,0,1,0,2
25059970,2,0,0,0,2
11027691,2,0,0,0,2
324273359,2,0,0,0,2
33200173,1,0,1,0,2
324156441,0,0,2,0,2
324004844,2,0,0,0,2
103713745,2,0,0,0,2
241378877,0,0,2,0,2
323626028,1,0,1,0,2
6298158,1,0,1,0,2
25077909,0,0,2,0,2
322791021,0,0,2,0,2
103850896,0,0,2,0,2
322352856,2,0,0,0,2
6319915,2,0,0,0,2
103865219,2,0,0,0,2
103907184,0,0,2,0,2
6343048,0,0,2,0,2
6346333,1,0,1,0,2
25096301,1,0,1,0,2
33053740,0,0,2,0,2
6384454,2,0,0,0,2
130322100,1,0,1,0,2
25182524,0,0,2,0,2
10828579,2,0,0,0,2
313661879,1,0,1,0,2
10775192,0,0,2,0,2
313251698,0,0,2,0,2
313104002,2,0,0,0,2
6677425,0,0,0,2,2
32301367,1,0,1,0,2
312661846,2,0,0,0,2
312573023,0,0,2,0,2
32295605,1,0,1,0,2
10737943,1,0,1,0,2
245003299,2,0,0,0,2
32226468,1,0,1,0,2
311750205,0,0,2,0,2
311607537,0,0,2,0,2
6726364,1,0,1,0,2
10700613,1,0,1,0,2
6757915,1,0,1,0,2
25344446,0,0,2,0,2
6762247,1,0,1,0,2
129643632,2,0,0,0,2
25355233,1,0,1,0,2
6778614,0,0,1,1,2
32084117,1,0,1,0,2
6781477,2,0,0,0,2
313614300,2,0,0,0,2
6642777,0,0,2,0,2
32625342,0,0,2,0,2
6632440,0,0,2,0,2
6524762,1,1,0,0,2
32617252,2,0,0,0,2
10806025,0,0,2,0,2
6542295,0,0,2,0,2
10795846,0,0,2,0,2
105310740,2,0,0,0,2
6556716,2,0,0,0,2
6558917,2,0,0,0,2
10795069,0,0,2,0,2
10789331,0,0,2,0,2
244438661,1,0,1,0,2
10786181,2,0,0,0,2
314560315,0,0,2,0,2
244453286,2,0,0,0,2
244473721,2,0,0,0,2
6602545,0,0,2,0,2
10784441,2,0,0,0,2
314325074,2,0,0,0,2
32441059,2,0,0,0,2
314253814,2,0,0,0,2
6618100,2,0,0,0,2
244505851,0,0,2,0,2
32405588,1,0,1,0,2
324429663,2,0,0,0,2
131103701,1,0,1,0,2
100112994,0,0,2,0,2
101643312,1,0,1,0,2
237277331,0,0,2,0,2
334495442,0,0,2,0,2
334363415,2,0,0,0,2
101435219,2,0,0,0,2
101498908,1,0,1,0,2
33871880,1,0,1,0,2
101499766,0,0,2,0,2
101573638,0,0,2,0,2
11274299,0,0,2,0,2
237715800,2,0,0,0,2
101618737,0,0,2,0,2
101695430,0,0,2,0,2
324748144,0,0,2,0,2
333292277,0,0,2,0,2
131858158,2,0,0,0,2
101776118,2,0,0,0,2
332905063,2,0,0,0,2
24918898,0,0,2,0,2
24934866,0,0,2,0,2
332212831,0,0,2,0,2
332191967,2,0,0,0,2
332126165,0,0,2,0,2
238312504,1,0,1,0,2
331715199,2,0,0,0,2
101262003,0,0,2,0,2
335126650,2,0,0,0,2
132356199,2,0,0,0,2
335920793,0,0,2,0,2
34161028,0,0,2,0,2
235681234,2,0,0,0,2
11381675,1,0,1,0,2
337846634,1,0,1,0,2
337780960,2,0,0,0,2
236334741,1,0,1,0,2
100573908,2,0,0,0,2
100758295,0,0,2,0,2
236607813,0,0,2,0,2
34004724,1,0,1,0,2
5790041,0,0,2,0,2
336576760,2,0,0,0,2
100935364,0,0,2,0,2
5800619,2,0,0,0,2
236671534,2,0,0,0,2
5810195,0,0,2,0,2
132435618,2,0,0,0,2
33988602,1,0,1,0,2
5822377,1,0,0,1,2
33977124,0,0,2,0,2
101110337,0,0,2,0,2
132371684,0,0,2,0,2
5851210,2,0,0,0,2
331603166,0,0,2,0,2
102122853,0,0,2,0,2
11206175,1,0,1,0,2
24981245,1,0,1,0,2
11127879,1,0,1,0,2
102763353,2,0,0,0,2
102799406,2,0,0,0,2
33432369,0,0,2,0,2
6182854,2,0,0,0,2
131476068,0,0,2,0,2
326668977,0,0,2,0,2
326205628,0,0,2,0,2
102896902,0,0,2,0,2
6203953,2,0,0,0,2
131180798,1,0,1,0,2
240207968,0,0,2,0,2
325616993,0,0,2,0,2
240306801,2,0,0,0,2
6228539,0,0,2,0,2
240472978,0,0,2,0,2
325264952,0,0,2,0,2
103345244,0,0,2,0,2
240504372,2,0,0,0,2
240594389,2,0,0,0,2
6246766,0,0,2,0,2
324933354,2,0,0,0,2
324906509,0,0,2,0,2
6146050,0,0,2,0,2
11134859,2,0,0,0,2
33675739,0,0,2,0,2
33510623,2,0,0,0,2
102251640,0,0,2,0,2
238940472,0,0,2,0,2
6049738,0,0,2,0,2
330751531,2,0,0,0,2
33648474,1,0,1,0,2
131649335,1,0,1,0,2
6057887,0,0,2,0,2
102367981,0,0,2,0,2
102383709,0,0,2,0,2
33607986,0,0,2,0,2
329941458,2,0,0,0,2
6080376,0,0,2,0,2
6086114,0,0,2,0,2
6088518,2,0,0,0,2
329475936,2,0,0,0,2
11167829,0,0,2,0,2
239351588,1,0,1,0,2
33527075,0,0,2,0,2
6110471,0,0,2,0,2
239503360,0,0,2,0,2
33518883,0,0,2,0,2
24981215,2,0,0,0,2
328859297,1,0,1,0,2
83651013,0,0,2,0,2
3233986,0,0,2,0,2
141615596,0,0,1,1,2
1220404,2,0,0,0,2
467022563,0,0,2,0,2
67069129,2,0,0,0,2
21194343,2,0,0,0,2
466889396,1,0,0,1,2
466798662,2,0,0,0,2
466759693,0,0,2,0,2
48418910,0,0,2,0,2
189075482,1,0,1,0,2
466700068,2,0,0,0,2
1215853,2,0,0,0,2
466699592,2,0,0,0,2
48410883,0,0,2,0,2
466634879,2,0,0,0,2
467064305,2,0,0,0,2
466611558,1,0,0,1,2
189199682,2,0,0,0,2
1226950,0,0,2,0,2
466454290,2,0,0,0,2
154763419,1,0,1,0,2
466380076,1,0,0,1,2
16596728,2,0,0,0,2
67252331,2,0,0,0,2
48282875,1,0,1,0,2
67254249,0,0,2,0,2
1239078,2,0,0,0,2
67261284,0,0,2,0,2
467026948,0,0,2,0,2
1188194,0,0,2,0,2
444548275,0,0,2,0,2
188741104,1,0,1,0,2
155223823,1,0,1,0,2
1106323,0,0,2,0,2
16722827,1,0,1,0,2
469080688,2,0,0,0,2
188425827,2,0,0,0,2
66813379,2,0,0,0,2
66821136,2,0,0,0,2
21130089,2,0,0,0,2
155152907,0,0,2,0,2
468406450,0,0,2,0,2
48638439,2,0,0,0,2
155125855,0,0,2,0,2
1141610,2,0,0,0,2
16640515,0,0,2,0,2
1142068,0,0,2,0,2
1162642,1,0,1,0,2
467855405,0,0,2,0,2
48588253,1,0,1,0,2
16677326,0,0,2,0,2
467600659,0,0,2,0,2
467482767,0,0,2,0,2
67036224,1,0,1,0,2
467292475,2,0,0,0,2
67054932,0,0,2,0,2
21183428,2,0,0,0,2
467168751,2,0,0,0,2
465736664,0,0,2,0,2
48258863,0,0,2,0,2
189597520,2,0,0,0,2
16396714,1,0,1,0,2
462422092,2,0,0,0,2
1334808,1,0,1,0,2
462188368,0,0,2,0,2
191924030,0,0,2,0,2
462089617,2,0,0,0,2
47769520,1,0,1,0,2
21426910,2,0,0,0,2
47696665,1,0,1,0,2
153664925,0,0,2,0,2
68327820,1,0,1,0,2
192181166,0,0,2,0,2
1354727,0,0,2,0,2
21444167,2,0,0,0,2
154629695,0,0,2,0,2
47653589,2,0,0,0,2
16392320,2,0,0,0,2
1360296,1,0,1,0,2
461544669,0,0,2,0,2
68437552,2,0,0,0,2
1364042,2,0,0,0,2
47604445,2,0,0,0,2
1366310,0,0,2,0,2
461340832,2,0,0,0,2
461257467,2,0,0,0,2
153555756,1,0,1,0,2
192383231,0,0,2,0,2
68256720,1,0,1,0,2
191804394,1,0,1,0,2
153956930,2,0,0,0,2
462733314,0,0,2,0,2
465273276,0,0,2,0,2
1261480,0,0,2,0,2
67395042,0,0,2,0,2
48170471,1,0,1,0,2
189816889,0,0,2,0,2
464933442,0,0,2,0,2
154482593,2,0,0,0,2
464746313,2,0,0,0,2
67651553,2,0,0,0,2
21315876,1,0,1,0,2
21327210,1,0,1,0,2
16543733,2,0,0,0,2
48076117,0,0,2,0,2
190174537,2,0,0,0,2
464320122,0,0,2,0,2
67859646,0,0,2,0,2
154239561,1,0,1,0,2
47988351,0,0,2,0,2
154201505,2,0,0,0,2
154184894,0,0,2,0,2
154158582,2,0,0,0,2
1302029,1,0,1,0,2
21382844,1,0,1,0,2
16439835,2,0,0,0,2
1304390,0,0,2,0,2
16725437,1,0,1,0,2
1103131,1,0,1,0,2
1038989,0,0,2,0,2
185029671,2,0,0,0,2
835112,0,0,2,0,2
475127789,0,0,2,0,2
836911,2,0,0,0,2
838704,2,0,0,0,2
474973421,2,0,0,0,2
840868,1,0,1,0,2
474967067,0,0,2,0,2
20912691,2,0,0,0,2
65258815,1,0,1,0,2
474852151,2,0,0,0,2
49500419,2,0,0,0,2
185022050,2,0,0,0,2
474215514,1,0,1,0,2
65604249,0,0,2,0,2
864735,2,0,0,0,2
473978913,2,0,0,0,2
473963067,0,0,2,0,2
473877264,2,0,0,0,2
867225,0,0,2,0,2
473870007,2,0,0,0,2
869880,1,0,1,0,2
49348826,2,0,0,0,2
185724116,2,0,0,0,2
17048787,1,0,1,0,2
873273,1,0,1,0,2
17026738,2,0,0,0,2
65059624,1,0,1,0,2
65031483,0,0,2,0,2
831185,2,0,0,0,2
157141199,0,0,2,0,2
183604908,0,0,2,0,2
183610844,0,0,2,0,2
785524,2,0,0,0,2
20843936,0,0,2,0,2
790872,1,0,1,0,2
49736436,2,0,0,0,2
797814,1,0,1,0,2
184009385,2,0,0,0,2
64802660,2,0,0,0,2
801975,2,0,0,0,2
476278288,2,0,0,0,2
184130293,0,0,2,0,2
157236586,0,0,2,0,2
476218709,0,0,2,0,2
806774,1,0,0,1,2
64887490,2,0,0,0,2
807642,1,0,1,0,2
64889149,2,0,0,0,2
64898741,1,0,1,0,2
814747,2,0,0,0,2
476120458,0,0,2,0,2
815977,2,0,0,0,2
475963154,1,0,1,0,2
820011,2,0,0,0,2
17125263,0,0,2,0,2
473479462,0,0,2,0,2
473454112,0,0,2,0,2
21105084,1,0,0,1,2
470533537,2,0,0,0,2
471344658,1,0,1,0,2
471303517,2,0,0,0,2
49015331,2,0,0,0,2
48985309,0,0,2,0,2
971075,1,0,1,0,2
16883036,0,0,2,0,2
66352142,2,0,0,0,2
48949937,2,0,0,0,2
16869971,0,0,2,0,2
470867572,2,0,0,0,2
16865342,0,0,2,0,2
48911266,1,0,1,0,2
21058022,0,0,2,0,2
473378930,2,0,0,0,2
1010435,2,0,0,0,2
155935757,2,0,0,0,2
470044717,2,0,0,0,2
155812868,2,0,0,0,2
1018472,0,0,2,0,2
155791040,2,0,0,0,2
21090508,0,0,0,2,2
187870198,0,0,2,0,2
187908347,2,0,0,0,2
1029021,2,0,0,0,2
16782573,2,0,0,0,2
1034976,1,0,1,0,2
186985759,0,0,2,0,2
16916853,2,0,0,0,2
16918947,2,0,0,0,2
156255637,0,0,2,0,2
473152486,2,0,0,0,2
156716488,0,0,2,0,2
473024130,2,0,0,0,2
186136214,0,0,2,0,2
905272,2,0,0,0,2
472615050,2,0,0,0,2
472607067,0,0,2,0,2
909577,0,0,2,0,2
472442549,2,0,0,0,2
156548486,0,0,2,0,2
20985328,0,0,2,0,2
16965049,2,0,0,0,2
919218,0,0,2,0,2
49164956,0,0,2,0,2
472089689,0,0,2,0,2
923465,1,0,1,0,2
49128620,0,0,2,0,2
927028,0,0,2,0,2
186668589,0,0,2,0,2
471864210,0,0,2,0,2
943367,0,0,2,0,2
471850331,2,0,0,0,2
471837613,2,0,0,0,2
65976155,0,0,2,0,2
21014758,0,0,2,0,2
461074296,2,0,0,0,2
192390368,2,0,0,0,2
1386685,1,0,1,0,2
449756091,2,0,0,0,2
1653951,2,0,0,0,2
450754682,2,0,0,0,2
196631263,1,0,1,0,2
450642351,2,0,0,0,2
71276635,0,0,0,2,2
450477387,2,0,0,0,2
450443676,2,0,0,0,2
15810320,0,0,2,0,2
1663967,0,0,2,0,2
15805343,1,0,1,0,2
449868905,2,0,0,0,2
1680212,1,0,1,0,2
71368439,0,0,2,0,2
151253018,2,0,0,0,2
21787440,0,0,2,0,2
15778416,1,0,1,0,2
196770644,2,0,0,0,2
151421618,2,0,0,0,2
71400423,1,0,1,0,2
449377263,2,0,0,0,2
449206723,2,0,0,0,2
449205102,2,0,0,0,2
196915362,2,0,0,0,2
45859087,0,0,2,0,2
151284868,2,0,0,0,2
151273556,2,0,0,0,2
196609694,2,0,0,0,2
196557649,2,0,0,0,2
71176935,0,0,2,0,2
1641537,0,0,2,0,2
21705530,2,0,0,0,2
452685778,1,0,1,0,2
21725994,2,0,0,0,2
15895218,1,0,1,0,2
21734605,1,0,1,0,2
452436662,2,0,0,0,2
196059058,2,0,0,0,2
1602951,2,0,0,0,2
70878068,0,0,2,0,2
70959022,2,0,0,0,2
21743283,0,0,2,0,2
196247979,2,0,0,0,2
451893722,0,0,2,0,2
451866608,2,0,0,0,2
1621363,2,0,0,0,2
21772781,2,0,0,0,2
451571061,2,0,0,0,2
451410902,2,0,0,0,2
196448309,2,0,0,0,2
451356592,2,0,0,0,2
71149842,0,0,2,0,2
196476281,0,0,2,0,2
451169544,0,0,2,0,2
451138689,0,0,2,0,2
46066063,0,0,2,0,2
1709876,1,0,1,0,2
45845050,0,0,2,0,2
70671555,0,0,2,0,2
445621543,2,0,0,0,2
71864149,1,0,0,1,2
21934258,1,0,1,0,2
21935479,1,0,1,0,2
445893943,0,0,2,0,2
150883804,2,0,0,0,2
198522134,0,0,2,0,2
1798193,1,0,1,0,2
21940966,1,0,1,0,2
1800512,1,0,1,0,2
15625009,0,0,2,0,2
1805238,0,0,2,0,2
21942044,0,0,2,0,2
45503479,0,0,2,0,2
15740819,1,0,1,0,2
198871095,2,0,0,0,2
445415288,2,0,0,0,2
45467925,2,0,0,0,2
21963202,1,0,1,0,2
1834769,2,0,0,0,2
150565606,0,0,2,0,2
444941541,0,0,2,0,2
1844352,0,0,2,0,2
1849974,1,0,1,0,2
444887787,0,0,2,0,2
444792557,0,0,2,0,2
444681334,0,0,2,0,2
1780076,0,0,2,0,2
446490301,0,0,2,0,2
71853402,0,0,2,0,2
446770142,2,0,0,0,2
1715301,1,0,1,0,2
448752983,2,0,0,0,2
448653723,0,0,2,0,2
21841949,0,0,1,1,2
71540842,1,0,1,0,2
45774302,0,0,2,0,2
1732559,0,0,2,0,2
45731391,1,0,1,0,2
447930128,0,0,2,0,2
15687009,1,0,1,0,2
447898729,2,0,0,0,2
447895924,0,0,2,0,2
45697749,1,0,1,0,2
71644219,0,0,2,0,2
15681707,2,0,0,0,2
45694156,1,0,1,0,2
1748382,2,0,0,0,2
71717596,2,0,0,0,2
197489882,0,0,2,0,2
197516314,0,0,2,0,2
45632792,0,0,2,0,2
447235921,2,0,0,0,2
1760610,2,0,0,0,2
1761578,0,0,2,0,2
197826997,1,0,1,0,2
452864652,0,0,1,1,2
1571120,1,0,1,0,2
1387286,0,0,2,0,2
458234215,2,0,0,0,2
1442860,2,0,0,0,2
47049546,0,0,2,0,2
1443812,2,0,0,0,2
458777714,2,0,0,0,2
21536998,0,0,2,0,2
1447684,0,0,2,0,2
47023469,1,0,1,0,2
21544501,0,0,2,0,2
46979077,0,0,2,0,2
46976876,1,0,1,0,2
152877297,1,0,1,0,2
458299783,0,0,2,0,2
1466422,2,0,0,0,2
194571019,0,0,2,0,2
457840330,0,0,2,0,2
16176030,2,0,0,0,2
457594429,2,0,0,0,2
69469129,0,0,2,0,2
46860545,2,0,0,0,2
69533355,1,0,1,0,2
457391491,2,0,0,0,2
69545272,0,0,2,0,2
1483451,2,0,0,0,2
21575456,1,0,1,0,2
457300342,2,0,0,0,2
152708570,1,0,1,0,2
458810054,0,0,2,0,2
47050813,0,0,2,0,2
69243005,0,0,2,0,2
1436482,1,0,1,0,2
460627420,0,0,2,0,2
460421451,2,0,0,0,2
1395530,1,0,1,0,2
192729578,1,0,1,0,2
192747450,1,0,1,0,2
460084452,2,0,0,0,2
68907781,1,0,1,0,2
459946669,2,0,0,0,2
13546922,0,0,2,0,2
459925707,2,0,0,0,2
459915744,2,0,0,0,2
1409262,2,0,0,0,2
1410714,2,0,0,0,2
68934594,2,0,0,0,2
16289089,1,0,1,0,2
193364875,1,0,1,0,2
193485559,0,0,1,1,2
47219962,2,0,0,0,2
459534804,0,0,2,0,2
16257970,0,0,2,0,2
193529865,0,0,2,0,2
16245414,2,0,0,0,2
459248803,2,0,0,0,2
1432322,2,0,0,0,2
16237288,0,0,1,1,2
21594748,1,0,1,0,2
1486872,2,0,0,0,2
15929157,0,0,2,0,2
454031557,0,0,2,0,2
195024069,1,0,1,0,2
16066061,0,0,2,0,2
195034008,2,0,0,0,2
1527966,2,0,0,0,2
1528912,0,0,2,0,2
1531125,1,0,1,0,2
70176549,0,0,2,0,2
454352655,0,0,2,0,2
454345669,2,0,0,0,2
21650611,2,0,0,0,2
70249788,0,0,2,0,2
195205358,1,0,1,0,2
70394670,0,0,2,0,2
69683180,1,0,1,0,2
70396243,2,0,0,0,2
152331348,2,0,0,0,2
70505953,1,0,1,0,2
152202371,0,0,2,0,2
21679450,0,0,2,0,2
152101490,0,0,2,0,2
46374641,1,0,1,0,2
453491250,2,0,0,0,2
152098453,0,0,2,0,2
15940253,0,0,2,0,2
1568517,0,0,2,0,2
195517789,0,0,2,0,2
455208592,2,0,0,0,2
21628945,1,0,1,0,2
455342215,2,0,0,0,2
195000564,1,0,1,0,2
16145840,1,0,1,0,2
69715276,0,0,2,0,2
194588972,2,0,0,0,2
21599728,0,0,2,0,2
1495039,2,0,0,0,2
16139880,2,0,0,0,2
1495355,0,0,2,0,2
152639417,2,0,0,0,2
69794747,2,0,0,0,2
1497427,1,0,1,0,2
46708895,2,0,0,0,2
456189131,0,0,2,0,2
1499484,2,0,0,0,2
46707487,1,0,1,0,2
456035465,2,0,0,0,2
69841552,2,0,0,0,2
1507779,2,0,0,0,2
70007950,0,0,2,0,2
1512462,1,0,0,1,2
1512565,0,0,2,0,2
455683614,2,0,0,0,2
152599955,2,0,0,0,2
1516600,2,0,0,0,2
1516920,1,0,1,0,2
455492966,0,0,2,0,2
20841092,0,0,2,0,2
157295347,0,0,2,0,2
476842003,2,0,0,0,2
491738844,2,0,0,0,2
171825960,1,0,1,0,2
162546036,2,0,0,0,2
492261278,2,0,0,0,2
181376,0,0,2,0,2
18582746,2,0,0,0,2
53199312,2,0,0,0,2
172113555,2,0,0,0,2
185745,2,0,0,0,2
18562674,0,0,2,0,2
172422032,0,0,2,0,2
52995061,0,0,2,0,2
491898524,0,0,2,0,2
52862385,1,0,1,0,2
490636456,0,0,2,0,2
172703338,0,0,2,0,2
59215768,2,0,0,0,2
491207383,2,0,0,0,2
172857908,0,0,2,0,2
59281169,1,0,1,0,2
172889902,0,0,2,0,2
208565,2,0,0,0,2
172895347,0,0,2,0,2
216191,1,0,1,0,2
20084270,2,0,0,0,2
173249074,0,0,2,0,2
490798197,2,0,0,0,2
53300414,0,0,2,0,2
58782992,2,0,0,0,2
492545385,2,0,0,0,2
19981094,0,0,2,0,2
171051361,2,0,0,0,2
493915241,2,0,0,0,2
53710434,1,0,1,0,2
493769528,0,0,1,1,2
147513,2,0,0,0,2
19902271,1,0,1,0,2
148231,1,0,1,0,2
493622242,0,0,2,0,2
493615431,2,0,0,0,2
19912320,0,0,2,0,2
19924289,2,0,0,0,2
171198420,0,0,2,0,2
53610697,2,0,0,0,2
157795,0,0,1,1,2
58403098,0,0,2,0,2
53491381,0,0,2,0,2
53477287,0,0,2,0,2
58410241,0,0,2,0,2
171543177,0,0,2,0,2
168525,0,0,2,0,2
169927,1,0,1,0,2
492736193,0,0,2,0,2
53369750,0,0,2,0,2
170510,2,0,0,0,2
492698813,0,0,2,0,2
20087667,2,0,0,0,2
236421,0,0,2,0,2
53781263,1,0,1,0,2
290908,2,0,0,0,2
276291,2,0,0,0,2
277379,0,0,2,0,2
59996301,2,0,0,0,2
60059749,0,0,2,0,2
60069248,1,0,1,0,2
283944,1,0,1,0,2
161534360,2,0,0,0,2
18171303,0,0,2,0,2
161510806,0,0,2,0,2
174811960,0,0,2,0,2
20170845,0,0,2,0,2
290845,0,0,2,0,2
489204850,0,0,2,0,2
490629557,2,0,0,0,2
489124684,2,0,0,0,2
20177472,1,0,1,0,2
175116422,2,0,0,0,2
175142050,0,0,2,0,2
488861381,0,0,2,0,2
488786670,2,0,0,0,2
488760226,1,0,1,0,2
306739,2,0,0,0,2
488685319,1,0,1,0,2
60350045,2,0,0,0,2
488672147,2,0,0,0,2
312722,1,0,1,0,2
489745246,2,0,0,0,2
489804886,1,0,1,0,2
59974573,2,0,0,0,2
489912515,2,0,0,0,2
18397763,2,0,0,0,2
173325979,0,0,2,0,2
241593,0,0,2,0,2
490473962,2,0,0,0,2
173373234,2,0,0,0,2
490391690,2,0,0,0,2
490358470,2,0,0,0,2
248490,1,0,1,0,2
173406651,1,0,1,0,2
161976329,2,0,0,0,2
59642348,2,0,0,0,2
251842,2,0,0,0,2
20114391,0,0,2,0,2
173708969,0,0,2,0,2
490227353,1,0,1,0,2
257541,0,0,2,0,2
258072,2,0,0,0,2
59824375,2,0,0,0,2
59905333,2,0,0,0,2
174093944,0,0,2,0,2
52474491,0,0,2,0,2
161742462,2,0,0,0,2
18227787,2,0,0,0,2
174383553,0,0,2,0,2
489921200,2,0,0,0,2
162921021,0,0,2,0,2
170810121,1,0,1,0,2
161135042,1,0,1,0,2
56878925,0,0,1,1,2
501710063,2,0,0,0,2
501601598,2,0,0,0,2
501589992,0,0,2,0,2
25183,2,0,0,0,2
165136941,0,0,2,0,2
164883120,0,0,2,0,2
55535568,1,0,1,0,2
31378,1,0,0,1,2
167598053,2,0,0,0,2
500580883,0,0,2,0,2
56784103,2,0,0,0,2
19233353,0,0,2,0,2
19200188,1,0,1,0,2
57186170,2,0,0,0,2
19195540,0,0,2,0,2
46978,0,0,2,0,2
500249074,2,0,0,0,2
47532,0,0,2,0,2
52697,0,0,2,0,2
53621,2,0,0,0,2
57070933,0,0,2,0,2
168429942,0,0,2,0,2
164303137,0,0,2,0,2
57155587,0,0,2,0,2
499129543,2,0,0,0,2
19070143,1,0,1,0,2
501882200,2,0,0,0,2
21823,2,0,0,0,2
55689124,2,0,0,0,2
19528144,1,0,1,0,2
166262295,2,0,0,0,2
19483885,0,0,2,0,2
19418202,1,0,1,0,2
56120055,0,0,2,0,2
4396,0,0,2,0,2
166672703,0,0,2,0,2
56265076,0,0,2,0,2
7355,0,0,2,0,2
7356,0,0,2,0,2
56338076,1,0,1,0,2
55858529,0,0,2,0,2
55847468,2,0,0,0,2
166877861,2,0,0,0,2
166920306,0,0,2,0,2
19370447,1,0,1,0,2
15038,1,0,1,0,2
19349568,2,0,0,0,2
55813598,0,0,1,1,2
19342672,1,0,1,0,2
502304706,0,0,2,0,2
16104,0,0,2,0,2
166968827,2,0,0,0,2
17297,0,0,2,0,2
17571,0,0,2,0,2
55718379,2,0,0,0,2
57165692,2,0,0,0,2
19655868,0,0,2,0,2
137814,0,0,2,0,2
495337073,0,0,2,0,2
496558533,2,0,0,0,2
18919268,0,0,2,0,2
169800089,0,0,2,0,2
94669,0,0,2,0,2
495999194,2,0,0,0,2
18886157,0,0,2,0,2
100288,1,0,1,0,2
495564291,2,0,0,0,2
169899040,0,0,2,0,2
103729,2,0,0,0,2
57641560,2,0,0,0,2
57643057,0,0,2,0,2
495317223,0,0,2,0,2
498559328,0,0,2,0,2
19808319,1,0,1,0,2
170212480,1,0,1,0,2
495040066,0,0,2,0,2
495011202,0,0,2,0,2
163251048,2,0,0,0,2
124357,1,0,1,0,2
54122907,2,0,0,0,2
19866189,2,0,0,0,2
494743523,2,0,0,0,2
494493701,1,0,1,0,2
494380925,2,0,0,0,2
137347,0,0,2,0,2
496583857,1,0,1,0,2
169584006,0,0,2,0,2
54526346,2,0,0,0,2
87105,2,0,0,0,2
19053159,0,0,2,0,2
498237429,2,0,0,0,2
57257950,2,0,0,0,2
63613,0,0,2,0,2
64442,0,0,2,0,2
163905917,0,0,2,0,2
169075332,1,0,1,0,2
498068370,0,0,2,0,2
19015886,1,0,1,0,2
68428,0,0,2,0,2
169166409,0,0,2,0,2
18999923,2,0,0,0,2
19708200,0,0,2,0,2
54736855,2,0,0,0,2
57328653,0,0,2,0,2
54658419,0,0,2,0,2
75857,2,0,0,0,2
18970667,2,0,0,0,2
163703392,0,0,2,0,2
82277,2,0,0,0,2
163621622,2,0,0,0,2
496897466,2,0,0,0,2
57455831,2,0,0,0,2
83257,0,0,2,0,2
496817580,0,0,2,0,2
314582,0,0,2,0,2
175696926,0,0,2,0,2
779474,2,0,0,0,2
63158102,0,0,2,0,2
50455642,0,0,2,0,2
611716,1,0,1,0,2
20587708,2,0,0,0,2
481408294,2,0,0,0,2
17466612,0,0,2,0,2
481334353,2,0,0,0,2
20600569,0,0,2,0,2
158625100,0,0,2,0,2
63103263,1,0,1,0,2
481155093,0,0,2,0,2
622855,1,0,1,0,2
481103546,2,0,0,0,2
626876,0,0,2,0,2
657869,0,0,1,1,2
627217,2,0,0,0,2
158445364,2,0,0,0,2
17430718,2,0,0,0,2
63227531,2,0,0,0,2
158406020,0,0,2,0,2
50374022,1,0,1,0,2
480748439,2,0,0,0,2
17428203,2,0,0,0,2
50366054,2,0,0,0,2
480486864,2,0,0,0,2
17412395,2,0,0,0,2
480361422,2,0,0,0,2
20568490,0,0,2,0,2
17494958,2,0,0,0,2
602359,2,0,0,0,2
17495586,0,0,2,0,2
179661186,0,0,2,0,2
159027993,0,0,2,0,2
550317,1,0,1,0,2
551055,0,0,2,0,2
62535444,2,0,0,0,2
483017091,2,0,0,0,2
50686888,2,0,0,0,2
50686800,0,0,2,0,2
62587696,0,0,2,0,2
179951095,0,0,2,0,2
62659791,0,0,2,0,2
573065,1,0,1,0,2
20539345,2,0,0,0,2
50588394,0,0,2,0,2
50577859,1,0,1,0,2
482321076,0,0,2,0,2
158922261,0,0,2,0,2
481967469,0,0,2,0,2
62745867,2,0,0,0,2
50523735,2,0,0,0,2
588270,2,0,0,0,2
593135,2,0,0,0,2
158781381,2,0,0,0,2
62787599,2,0,0,0,2
62828813,0,0,2,0,2
158212655,0,0,2,0,2
50309871,2,0,0,0,2
483218603,1,0,1,0,2
157393936,0,0,2,0,2
182964421,2,0,0,0,2
17249397,1,0,0,1,2
738918,2,0,0,0,2
739539,0,0,2,0,2
17249370,0,0,2,0,2
742100,2,0,0,0,2
157481445,0,0,2,0,2
183059897,2,0,0,0,2
477886839,0,0,2,0,2
745069,0,0,2,0,2
64471880,0,0,2,0,2
756173,0,0,2,0,2
183360807,1,0,1,0,2
63486878,2,0,0,0,2
758655,2,0,0,0,2
759883,1,0,1,0,2
477167456,2,0,0,0,2
64568710,0,0,2,0,2
477160462,0,0,2,0,2
49831860,0,0,2,0,2
477098391,0,0,2,0,2
772148,0,0,2,0,2
64609445,1,0,1,0,2
49820034,2,0,0,0,2
64630560,0,0,2,0,2
157301360,2,0,0,0,2
64119235,0,0,2,0,2
50032395,0,0,2,0,2
478592369,2,0,0,0,2
478608087,2,0,0,0,2
50292584,2,0,0,0,2
181876326,0,0,2,0,2
158092208,2,0,0,0,2
63721846,1,0,1,0,2
50238586,2,0,0,0,2
681225,0,0,2,0,2
182152235,1,0,1,0,2
479544280,2,0,0,0,2
690079,1,0,1,0,2
697442,2,0,0,0,2
17344471,1,0,1,0,2
157703622,2,0,0,0,2
479058559,2,0,0,0,2
705199,0,0,2,0,2
182602964,1,0,1,0,2
64018594,0,0,2,0,2
64033956,1,0,1,0,2
17272284,1,0,1,0,2
712590,1,0,1,0,2
478731894,0,0,2,0,2
718349,2,0,0,0,2
182793168,0,0,2,0,2
182869653,2,0,0,0,2
478622592,2,0,0,0,2
50045329,2,0,0,0,2
179657707,0,0,2,0,2
20518729,1,0,1,0,2
175728949,0,0,2,0,2
369015,1,0,1,0,2
176950173,2,0,0,0,2
60847286,0,0,2,0,2
176951326,2,0,0,0,2
51595867,0,0,2,0,2
60908748,0,0,2,0,2
487205556,2,0,0,0,2
361855,2,0,0,0,2
361989,2,0,0,0,2
487186006,0,0,2,0,2
60915621,1,0,0,1,2
51549763,2,0,0,0,2
160432866,1,0,1,0,2
486957891,0,0,2,0,2
160097529,0,0,2,0,2
51528392,1,0,1,0,2
17867234,0,0,2,0,2
17866326,0,0,2,0,2
20311036,1,0,1,0,2
389899,2,0,0,0,2
51468488,2,0,0,0,2
51459559,0,0,2,0,2
61156701,0,0,2,0,2
393473,2,0,0,0,2
61263200,0,0,2,0,2
61278683,0,0,2,0,2
17840677,0,0,2,0,2
176899233,0,0,0,2,2
20278196,0,0,2,0,2
487604591,0,0,2,0,2
17896580,2,0,0,0,2
161081229,0,0,2,0,2
18008678,1,0,1,0,2
320538,2,0,0,0,2
51985960,0,0,2,0,2
488461005,0,0,2,0,2
17985595,1,0,1,0,2
488242825,0,0,2,0,2
488168010,0,0,2,0,2
488152765,2,0,0,0,2
60532076,2,0,0,0,2
17968481,1,0,1,0,2
327033,2,0,0,0,2
327673,2,0,0,0,2
160614016,2,0,0,0,2
329436,2,0,0,0,2
487869122,0,0,2,0,2
60617669,2,0,0,0,2
331328,2,0,0,0,2
51758985,0,0,2,0,2
17943391,2,0,0,0,2
60666744,0,0,2,0,2
487718285,0,0,2,0,2
487705729,0,0,2,0,2
346183,0,0,2,0,2
176809727,1,0,1,0,2
61324573,0,0,2,0,2
486007573,2,0,0,0,2
535632,1,0,1,0,2
515095,0,0,2,0,2
178696800,1,0,1,0,2
484334138,2,0,0,0,2
178924110,0,0,2,0,2
484299616,2,0,0,0,2
20447869,0,0,2,0,2
62028227,2,0,0,0,2
20448671,0,0,2,0,2
484178441,0,0,1,1,2
507966,2,0,0,0,2
483976430,2,0,0,0,2
17622034,0,0,2,0,2
514261,0,0,2,0,2
20484008,1,0,1,0,2
51380878,0,0,2,0,2
518931,2,0,0,0,2
521819,1,0,1,0,2
17613914,0,0,2,0,2
17602501,0,0,2,0,2
483724739,0,0,2,0,2
483634479,0,0,2,0,2
50770601,0,0,2,0,2
529546,0,0,2,0,2
159154462,1,0,0,1,2
62320685,2,0,0,0,2
20518366,1,0,1,0,2
17581024,1,0,1,0,2
61875246,0,0,2,0,2
20438455,0,0,2,0,2
17726658,2,0,0,0,2
484692810,2,0,0,0,2
413447,0,0,2,0,2
51372003,0,0,2,0,2
485964619,0,0,2,0,2
485827054,0,0,2,0,2
420111,0,0,2,0,2
17819910,1,0,1,0,2
61463458,0,0,2,0,2
485579699,2,0,0,0,2
427184,1,0,1,0,2
61541256,0,0,2,0,2
17782625,2,0,0,0,2
178083627,0,0,2,0,2
61625798,0,0,2,0,2
438133,2,0,0,0,2
438593,1,0,1,0,2
178244787,1,0,1,0,2
61696564,0,0,1,1,2
61726152,1,0,1,0,2
20433973,0,0,2,0,2
455017,0,0,2,0,2
178330434,0,0,2,0,2
61831388,2,0,0,0,2
178435649,1,0,1,0,2
51024536,1,0,1,0,2
51024366,0,0,2,0,2
45404928,1,0,1,0,2
1406432,0,0,2,0,2
9420221,2,0,0,0,2
407908633,0,0,2,0,2
2409072,0,0,2,0,2
2413714,2,0,0,0,2
430979376,0,0,2,0,2
2420592,0,0,2,0,2
430854617,0,0,2,0,2
80933709,2,0,0,0,2
147675745,2,0,0,0,2
40905570,0,0,2,0,2
205684793,2,0,0,0,2
2522815,2,0,0,0,2
43452533,0,0,2,0,2
430052851,2,0,0,0,2
429999434,0,0,2,0,2
429941031,2,0,0,0,2
2446219,0,0,2,0,2
407949665,1,0,1,0,2
429776033,2,0,0,0,2
408059360,0,0,2,0,2
40867860,0,0,2,0,2
14942276,2,0,0,0,2
431414343,1,0,1,0,2
43600815,0,0,2,0,2
418569010,0,0,2,0,2
43719073,0,0,0,2,2
43714712,1,0,1,0,2
2374190,1,0,1,0,2
407057335,0,0,2,0,2
81320394,1,0,1,0,2
143168311,0,0,2,0,2
3201337,1,0,1,0,2
75234771,0,0,2,0,2
432084618,2,0,0,0,2
3191371,0,0,2,0,2
13968825,0,0,2,0,2
75294999,2,0,0,0,2
75302217,2,0,0,0,2
407298976,0,0,2,0,2
407354015,2,0,0,0,2
43601551,0,0,2,0,2
429454593,2,0,0,0,2
14019268,1,0,1,0,2
214187963,2,0,0,0,2
76192815,2,0,0,0,2
14076492,0,0,2,0,2
43194941,0,0,2,0,2
3097033,1,0,1,0,2
409693867,0,0,2,0,2
43194795,2,0,0,0,2
206642978,2,0,0,0,2
2511668,1,0,1,0,2
143833762,2,0,0,0,2
143865128,1,0,1,0,2
206655576,1,0,1,0,2
2518984,2,0,0,0,2
427723275,2,0,0,0,2
427705801,0,0,2,0,2
206691134,0,0,2,0,2
41121817,0,0,2,0,2
2520125,2,0,0,0,2
427458930,2,0,0,0,2
206538133,0,0,0,2,2
409039411,2,0,0,0,2
408360819,0,0,2,0,2
75998454,2,0,0,0,2
40972641,0,0,2,0,2
80827479,0,0,2,0,2
429419108,0,0,2,0,2
14895284,1,0,1,0,2
23162890,0,0,2,0,2
147291440,2,0,0,0,2
23156390,2,0,0,0,2
428979450,2,0,0,0,2
206258817,2,0,0,0,2
428789957,2,0,0,0,2
14038931,2,0,0,0,2
428733045,0,0,2,0,2
206288086,2,0,0,0,2
428703947,2,0,0,0,2
206313609,2,0,0,0,2
428437504,0,0,2,0,2
3120671,0,0,2,0,2
406606560,0,0,2,0,2
204915695,0,0,2,0,2
3229596,1,0,1,0,2
15147054,0,0,2,0,2
44216429,1,0,1,0,2
81959456,0,0,2,0,2
2269766,2,0,0,0,2
74215453,0,0,2,0,2
2270624,1,0,1,0,2
44152990,2,0,0,0,2
13874798,1,0,1,0,2
148130354,2,0,0,0,2
44087298,0,0,2,0,2
434274067,1,0,1,0,2
215512685,1,0,1,0,2
434144340,2,0,0,0,2
44057707,0,0,2,0,2
22307859,2,0,0,0,2
433972903,0,0,2,0,2
3294438,0,0,0,2,2
404763698,2,0,0,0,2
3315563,2,0,0,0,2
44223001,0,0,2,0,2
433901226,2,0,0,0,2
2264004,2,0,0,0,2
148470827,0,0,1,1,2
82119233,2,0,0,0,2
82115963,1,0,1,0,2
435795916,0,0,2,0,2
44303500,1,0,1,0,2
435772116,0,0,2,0,2
15185649,2,0,0,0,2
82088787,2,0,0,0,2
82083094,0,0,2,0,2
74112289,0,0,2,0,2
403062824,2,0,0,0,2
82027819,2,0,0,0,2
216032427,1,0,1,0,2
2260600,1,0,1,0,2
435101401,2,0,0,0,2
74160866,2,0,0,0,2
40490484,2,0,0,0,2
433944579,2,0,0,0,2
433807530,0,0,2,0,2
406603166,0,0,2,0,2
81636631,1,0,1,0,2
432495159,2,0,0,0,2
40636399,1,0,1,0,2
143040555,0,0,2,0,2
147983579,2,0,0,0,2
3256433,2,0,0,0,2
143059409,0,0,2,0,2
143084679,0,0,2,0,2
2361069,1,0,1,0,2
204855081,2,0,0,0,2
432486528,2,0,0,0,2
43756609,0,0,2,0,2
432419385,2,0,0,0,2
75173477,0,0,2,0,2
406333104,1,0,1,0,2
3246916,2,0,0,0,2
13933851,0,0,2,0,2
3237504,2,0,0,0,2
43817869,1,0,1,0,2
2356449,1,0,1,0,2
22309428,0,0,2,0,2
432679252,1,0,1,0,2
74541079,2,0,0,0,2
3285978,0,0,2,0,2
74623507,0,0,2,0,2
43963802,2,0,0,0,2
404908789,2,0,0,0,2
204205146,0,0,2,0,2
2329581,0,0,2,0,2
2332618,1,0,1,0,2
204545471,1,0,1,0,2
3278848,0,0,2,0,2
204733512,0,0,2,0,2
204733968,1,0,1,0,2
215186098,0,0,2,0,2
75034279,0,0,2,0,2
204773816,2,0,0,0,2
432811481,2,0,0,0,2
204780303,0,0,2,0,2
80567578,2,0,0,0,2
43103479,2,0,0,0,2
40371157,0,0,2,0,2
2736755,0,0,2,0,2
2723138,2,0,0,0,2
42295490,0,0,2,0,2
22733486,0,0,2,0,2
209306758,0,0,2,0,2
421638103,2,0,0,0,2
2730883,1,0,1,0,2
22954228,0,0,2,0,2
42243297,1,0,1,0,2
415885305,2,0,0,0,2
14804867,0,0,2,0,2
415974026,2,0,0,0,2
145578174,1,0,1,0,2
2742629,0,0,2,0,2
420837401,0,0,2,0,2
420813560,2,0,0,0,2
420759524,2,0,0,0,2
79089979,0,0,2,0,2
416152960,0,0,2,0,2
22730283,0,0,2,0,2
422053884,2,0,0,0,2
422064086,2,0,0,0,2
14577537,2,0,0,0,2
145878384,0,0,2,0,2
145872703,0,0,2,0,2
422735667,0,0,2,0,2
2948064,0,0,2,0,2
422624029,2,0,0,0,2
42413378,2,0,0,0,2
422579287,0,0,2,0,2
211595859,2,0,0,0,2
2695451,0,0,2,0,2
414924887,0,0,2,0,2
415121156,2,0,0,0,2
79305630,2,0,0,0,2
42389158,2,0,0,0,2
42329946,2,0,0,0,2
22720650,2,0,0,0,2
77750223,0,0,2,0,2
422234306,0,0,2,0,2
42154911,0,0,1,1,2
211334103,1,0,1,0,2
14320524,1,0,1,0,2
419416316,2,0,0,0,2
145285876,0,0,2,0,2
22827111,0,0,2,0,2
2843998,1,0,1,0,2
417850661,2,0,0,0,2
417930174,2,0,0,0,2
419181958,2,0,0,0,2
419043125,2,0,0,0,2
418957463,2,0,0,0,2
418115272,2,0,0,0,2
418867492,2,0,0,0,2
418761982,0,0,2,0,2
2837163,0,0,2,0,2
2834840,1,0,1,0,2
14399467,1,0,1,0,2
418217922,2,0,0,0,2
418315426,0,0,2,0,2
418612583,1,0,1,0,2
417707701,0,0,2,0,2
417634125,2,0,0,0,2
22904933,0,0,2,0,2
2790890,0,0,2,0,2
416756899,2,0,0,0,2
22780462,2,0,0,0,2
144857346,2,0,0,0,2
417186426,0,0,2,0,2
417192804,0,0,2,0,2
209887985,0,0,2,0,2
145082728,2,0,0,0,2
145146182,2,0,0,0,2
420011533,2,0,0,0,2
209921907,2,0,0,0,2
2876700,2,0,0,0,2
78339088,1,0,1,0,2
41922913,2,0,0,0,2
419834692,1,0,1,0,2
78408136,2,0,0,0,2
42076125,0,0,1,1,2
42076010,0,0,2,0,2
41578662,2,0,0,0,2
211823412,2,0,0,0,2
22685487,0,0,2,0,2
3045637,2,0,0,0,2
207205519,2,0,0,0,2
3043126,0,0,2,0,2
3038856,0,0,1,1,2
14157138,1,0,1,0,2
41329387,2,0,0,0,2
41339282,0,0,2,0,2
144119993,0,0,2,0,2
425779086,0,0,2,0,2
3020145,1,0,1,0,2
212689019,0,0,2,0,2
425502493,2,0,0,0,2
41398005,2,0,0,0,2
2591842,0,0,2,0,2
2597159,2,0,0,0,2
425338694,2,0,0,0,2
76878519,2,0,0,0,2
425007642,0,0,2,0,2
144017474,2,0,0,0,2
23055253,0,0,2,0,2
76943965,2,0,0,0,2
144006321,0,0,2,0,2
410110418,2,0,0,0,2
213181307,2,0,0,0,2
80470317,2,0,0,0,2
2542683,0,0,2,0,2
3073952,2,0,0,0,2
3073250,1,0,1,0,2
410184548,2,0,0,0,2
426540801,2,0,0,0,2
143979755,2,0,0,0,2
2558779,0,0,2,0,2
426369684,2,0,0,0,2
41217631,0,0,2,0,2
410521823,0,0,2,0,2
41261306,0,0,2,0,2
410595519,1,0,1,0,2
3053987,2,0,0,0,2
213014559,2,0,0,0,2
3007477,1,0,1,0,2
14176488,0,0,0,2,2
2955215,2,0,0,0,2
2653479,2,0,0,0,2
2968774,1,0,0,1,2
414079399,2,0,0,0,2
423535172,2,0,0,0,2
22658749,0,0,2,0,2
2657430,0,0,2,0,2
414121196,2,0,0,0,2
212058279,0,0,2,0,2
42523215,0,0,2,0,2
41557022,1,0,1,0,2
2673168,1,0,1,0,2
208610094,0,0,1,1,2
14278133,0,0,2,0,2
2676438,2,0,0,0,2
2680820,0,0,2,0,2
423200663,0,0,2,0,2
414539549,2,0,0,0,2
423104195,2,0,0,0,2
42540396,0,0,2,0,2
79641851,2,0,0,0,2
412796426,0,0,2,0,2
423884624,0,0,2,0,2
42729298,0,0,2,0,2
412998473,2,0,0,0,2
424577451,2,0,0,0,2
77010815,0,0,2,0,2
77011788,2,0,0,0,2
79753770,2,0,0,0,2
14214034,2,0,0,0,2
424296351,2,0,0,0,2
42657456,2,0,0,0,2
424163498,2,0,0,0,2
424150408,0,0,2,0,2
2640773,2,0,0,0,2
42605385,0,0,2,0,2
2979971,1,0,1,0,2
424020866,1,0,1,0,2
212262028,2,0,0,0,2
2647578,0,0,2,0,2
82170330,1,0,1,0,2
406616783,2,0,0,0,2
142500682,2,0,0,0,2
22171095,2,0,0,0,2
15356710,0,0,2,0,2
440220965,2,0,0,0,2
82920107,2,0,0,0,2
399414325,2,0,0,0,2
201447930,1,0,1,0,2
440060338,0,0,2,0,2
439597117,0,0,2,0,2
399379000,2,0,0,0,2
40085320,0,0,2,0,2
149131919,2,0,0,0,2
13717740,1,0,1,0,2
399868350,0,0,2,0,2
15336136,0,0,2,0,2
22175061,2,0,0,0,2
44875433,2,0,0,0,2
82921914,0,0,2,0,2
22210080,1,0,1,0,2
440648976,2,0,0,0,2
441043633,1,0,1,0,2
398867059,2,0,0,0,2
22103146,0,0,2,0,2
398931042,2,0,0,0,2
149380359,1,0,1,0,2
440785448,0,0,2,0,2
44926625,2,0,0,0,2
13716326,2,0,0,0,2
216917414,0,0,2,0,2
23401472,1,0,1,0,2
3508047,0,0,2,0,2
23390186,1,0,1,0,2
73183897,2,0,0,0,2
22158091,1,0,1,0,2
73496118,0,0,2,0,2
399986109,2,0,0,0,2
40124500,0,0,1,1,2
44682387,2,0,0,0,2
401032717,2,0,0,0,2
3417321,0,0,2,0,2
44695225,2,0,0,0,2
13779268,2,0,0,0,2
216375039,0,0,2,0,2
438371312,2,0,0,0,2
82406306,0,0,2,0,2
439415632,0,0,2,0,2
15282203,2,0,0,0,2
40236384,0,0,2,0,2
82392155,1,0,1,0,2
2157189,0,0,2,0,2
44660079,1,0,1,0,2
73640551,0,0,2,0,2
438634584,2,0,0,0,2
438777361,0,0,2,0,2
2138902,0,0,2,0,2
2137595,2,0,0,0,2
148993903,2,0,0,0,2
439023889,2,0,0,0,2
3440653,2,0,0,0,2
23370431,0,0,2,0,2
216586866,1,0,1,0,2
73564528,2,0,0,0,2
400223681,2,0,0,0,2
15313500,2,0,0,0,2
73511705,2,0,0,0,2
44781865,1,0,1,0,2
201813089,2,0,0,0,2
439414066,2,0,0,0,2
82854298,0,0,2,0,2
2035021,2,0,0,0,2
83102592,2,0,0,0,2
73066515,1,0,1,0,2
45241930,2,0,0,0,2
39808438,2,0,0,0,2
45314325,0,0,2,0,2
22020703,0,0,2,0,2
150141586,2,0,0,0,2
15538932,1,0,1,0,2
150121776,0,0,2,0,2
72602373,0,0,2,0,2
397299731,2,0,0,0,2
443059996,1,0,1,0,2
442956929,0,0,2,0,2
83422715,2,0,0,0,2
1939209,0,0,2,0,2
442715701,0,0,2,0,2
83377687,2,0,0,0,2
83523066,2,0,0,0,2
443495311,0,0,2,0,2
1911615,1,0,1,0,2
396940563,2,0,0,0,2
443550954,1,0,1,0,2
443693087,0,0,2,0,2
396808869,2,0,0,0,2
83585937,0,0,2,0,2
22010249,0,0,2,0,2
444084387,2,0,0,0,2
3605048,2,0,0,0,2
13561853,1,0,1,0,2
199419170,0,0,2,0,2
1879389,1,0,1,0,2
15569250,0,0,2,0,2
217591735,0,0,2,0,2
444415151,0,0,1,1,2
3587751,1,0,1,0,2
45204053,1,0,1,0,2
141853769,2,0,0,0,2
83147028,0,0,2,0,2
3548411,2,0,0,0,2
200621725,0,0,2,0,2
441901811,0,0,2,0,2
200625983,2,0,0,0,2
39972598,0,0,2,0,2
1995636,1,1,0,0,2
22088164,1,0,1,0,2
72687291,2,0,0,0,2
398408597,2,0,0,0,2
22089863,0,0,2,0,2
15445748,0,0,2,0,2
13670148,0,0,2,0,2
200950980,2,0,0,0,2
441489344,2,0,0,0,2
39956905,0,0,2,0,2
442098041,2,0,0,0,2
141799915,2,0,0,0,2
13664245,0,0,2,0,2
45100854,0,0,2,0,2
72811351,0,0,2,0,2
141785145,0,0,2,0,2
397775202,1,0,1,0,2
200426688,2,0,0,0,2
442527965,2,0,0,0,2
3567433,0,0,2,0,2
1947974,0,0,2,0,2
217293060,2,0,0,0,2
22058409,0,0,2,0,2
3571821,0,0,1,1,2
217362657,2,0,0,0,2
3579116,1,0,1,0,2
2163625,1,0,1,0,2
418441364,2,0,0,0,2
2208993,1,0,1,0,2
73676875,2,0,0,0,2
3363749,0,0,2,0,2
22251283,2,0,0,0,2
437162526,2,0,0,0,2
40316314,0,0,2,0,2
401942966,0,0,2,0,2
3375455,0,0,2,0,2
436785758,1,0,1,0,2
402257342,0,0,1,1,2
15198359,0,0,2,0,2
40332331,2,0,0,0,2
13795760,1,0,1,0,2
437390203,2,0,0,0,2
3363799,2,0,0,0,2
44547688,0,0,2,0,2
437531027,0,0,2,0,2
3398280,0,0,2,0,2
436339796,0,0,1,1,2
435994605,1,0,1,0,2
402317081,0,0,2,0,2
148599649,0,0,2,0,2
2173706,2,0,0,0,2
438014463,2,0,0,0,2
436579802,2,0,0,0,2
3371859,0,0,2,0,2
148787736,2,0,0,0,2
40307510,2,0,0,0,2
40336543,0,0,2,0,2
44460139,2,0,0,0,2
73670220,2,0,0,0,2
2203885,2,0,0,0,2
82390466,0,0,2,0,2
435914865,2,0,0,0,2
15235299,0,0,2,0,2
2206506,1,0,1,0,2
162567904,1,0,0,0,1
162714234,1,0,0,0,1
123597784,1,0,0,0,1
140503168,0,0,1,0,1
139200985,1,0,0,0,1
165193108,1,0,0,0,1
162554140,0,0,0,1,1
124001241,0,0,1,0,1
162781227,1,0,0,0,1
159542498,1,0,0,0,1
162572530,1,0,0,0,1
144560007,0,0,1,0,1
141808415,1,0,0,0,1
126627262,1,0,0,0,1
122459915,0,0,1,0,1
139306955,1,0,0,0,1
126625033,0,0,1,0,1
159540426,0,0,1,0,1
126626529,1,0,0,0,1
165292438,1,0,0,0,1
142591435,1,0,0,0,1
163200338,1,0,0,0,1
123905640,1,0,0,0,1
165615843,0,0,1,0,1
141754466,1,0,0,0,1
144683380,1,0,0,0,1
141764004,0,0,1,0,1
159437398,1,0,0,0,1
159482696,0,0,1,0,1
165448425,0,0,1,0,1
159494837,0,0,1,0,1
126691775,1,0,0,0,1
123953239,1,0,0,0,1
141765510,0,0,1,0,1
144647925,0,0,1,0,1
126687208,0,0,1,0,1
162840256,1,0,0,0,1
122377983,1,0,0,0,1
144602805,1,0,0,0,1
163189326,1,0,0,0,1
142716783,1,0,0,0,1
126656181,1,0,0,0,1
140599227,0,0,1,0,1
139195158,0,0,1,0,1
122454735,0,0,1,0,1
159495469,1,0,0,0,1
126641287,0,0,1,0,1
144600637,1,0,0,0,1
162784512,0,0,1,0,1
164847238,0,0,1,0,1
144522384,1,0,0,0,1
122650568,1,0,0,0,1
139511753,1,0,0,0,1
139479838,1,0,0,0,1
164637779,1,0,0,0,1
144347177,1,0,0,0,1
144328518,1,0,0,0,1
160100170,1,0,0,0,1
160175680,1,0,0,0,1
164602924,0,0,1,0,1
162546695,0,0,1,0,1
144317997,0,0,1,0,1
160187991,0,0,1,0,1
164549734,0,0,1,0,1
139503928,0,0,1,0,1
160194786,1,0,0,0,1
160233319,1,0,0,0,1
159571314,1,0,0,0,1
160306249,0,0,1,0,1
160322636,0,0,1,0,1
122708518,1,0,0,0,1
164540504,1,0,0,0,1
140476993,1,0,0,0,1
144267505,1,0,0,0,1
141885075,1,0,0,0,1
141400974,0,0,1,0,1
141384185,1,0,0,0,1
141371258,1,0,0,0,1
126501524,1,0,0,0,1
141927279,1,0,0,0,1
126473908,1,0,0,0,1
144376495,1,0,0,0,1
164668733,1,0,0,0,1
140847083,0,0,1,0,1
144465401,1,0,0,0,1
140501422,1,0,0,0,1
164821432,0,0,1,0,1
159592932,1,0,0,0,1
164750816,1,0,0,0,1
159608581,0,0,1,0,1
164696190,1,0,0,0,1
163083101,1,0,0,0,1
164692592,1,0,0,0,1
144490686,1,0,0,0,1
164692370,0,0,1,0,1
159747439,1,0,0,0,1
141407777,1,0,0,0,1
141839911,0,0,1,0,1
142719866,1,0,0,0,1
126592760,1,0,0,0,1
122679380,1,0,0,0,1
140500767,1,0,0,0,1
159757254,0,0,1,0,1
122696032,1,0,0,0,1
126582789,1,0,0,0,1
144485210,0,0,1,0,1
140497439,1,0,0,0,1
126538085,1,0,0,0,1
139329404,1,0,0,0,1
160050819,1,0,0,0,1
160055033,1,0,0,0,1
160057164,0,0,1,0,1
126798178,0,0,1,0,1
159395523,1,0,0,0,1
126844198,0,0,1,0,1
141713689,1,0,0,0,1
127583166,0,0,1,0,1
140821239,0,0,1,0,1
162933359,0,0,1,0,1
166247807,1,0,0,0,1
122363368,1,0,0,0,1
127570065,1,0,0,0,1
145187951,0,0,1,0,1
123787287,1,0,0,0,1
140798168,1,0,0,0,1
127545011,0,0,1,0,1
162963425,1,0,0,0,1
159023062,1,0,0,0,1
138914016,0,0,1,0,1
145173841,1,0,0,0,1
126906679,0,0,1,0,1
162974717,0,0,1,0,1
127539184,1,0,0,0,1
127449724,0,0,1,0,1
162980623,1,0,0,0,1
140671636,0,0,1,0,1
166199588,0,0,1,0,1
140640991,1,0,0,0,1
159142440,0,0,1,0,1
145041366,1,0,0,0,1
127375531,1,0,0,0,1
138994120,0,0,1,0,1
144866025,0,0,1,0,1
166115856,1,0,0,0,1
159014806,0,0,1,0,1
159014432,1,0,0,0,1
159009468,0,0,1,0,1
145199414,0,0,1,0,1
138831526,1,0,0,0,1
166286543,1,0,0,0,1
158764663,1,0,0,0,1
122079426,0,0,1,0,1
127628491,1,0,0,0,1
158799692,1,0,0,0,1
145245549,0,0,1,0,1
158872351,1,0,0,0,1
158901887,1,0,0,0,1
122094341,1,0,0,0,1
122118705,0,0,1,0,1
145219249,1,0,0,0,1
166260679,0,0,1,0,1
122120711,1,0,0,0,1
122204600,0,0,1,0,1
122283834,0,0,1,0,1
158970159,1,0,0,0,1
123776081,1,0,0,0,1
162914079,0,0,1,0,1
158974584,1,0,0,0,1
138898375,1,0,0,0,1
127606713,0,0,1,0,1
145200005,1,0,0,0,1
122294799,0,0,1,0,1
142502018,1,0,0,0,1
127586030,0,0,1,0,1
159006650,0,0,1,0,1
162913222,0,0,1,0,1
144863286,0,0,1,0,1
141540860,1,0,0,0,1
127080266,1,0,0,0,1
141527490,0,0,1,0,1
144792052,1,0,0,0,1
141414918,1,0,0,0,1
144699715,1,0,0,0,1
162864084,1,0,0,0,1
163047898,1,0,0,0,1
123862187,1,0,0,0,1
159358124,1,0,0,0,1
159362106,0,0,1,0,1
159369488,0,0,1,0,1
162863801,1,0,0,0,1
141746424,0,0,1,0,1
140614593,1,0,0,0,1
142528184,0,0,1,0,1
127065148,0,0,1,0,1
163058941,1,0,0,0,1
139135366,1,0,0,0,1
127046909,1,0,0,0,1
126984603,0,0,1,0,1
164537600,1,0,0,0,1
122372251,0,0,1,0,1
144687633,1,0,0,0,1
126922318,0,0,1,0,1
144687507,0,0,1,0,1
123894644,1,0,0,0,1
139138585,1,0,0,0,1
126917625,0,0,1,0,1
144792161,1,0,0,0,1
127112667,1,0,0,0,1
166019084,0,0,1,0,1
141740738,0,0,1,0,1
163047410,1,0,0,0,1
127341412,1,0,0,0,1
127267474,1,0,0,0,1
162893787,0,0,1,0,1
144833193,1,0,0,0,1
165908674,1,0,0,0,1
159215356,1,0,0,0,1
139046390,0,0,1,0,1
141720257,1,0,0,0,1
123793147,0,0,1,0,1
159230735,1,0,0,0,1
123634035,1,0,0,0,1
165884816,1,0,0,0,1
144829155,0,0,1,0,1
123805373,1,0,0,0,1
127250455,0,0,1,0,1
127227897,1,0,0,0,1
123849755,1,0,0,0,1
142519287,1,0,0,0,1
127203228,0,0,1,0,1
127201714,0,0,1,0,1
127164761,0,0,1,0,1
159239228,1,0,0,0,1
159312334,0,0,1,0,1
123605746,0,0,1,0,1
144807057,1,0,0,0,1
165853174,1,0,0,0,1
126451493,1,0,0,0,1
162174536,0,0,1,0,1
164519659,0,0,1,0,1
126420866,0,0,1,0,1
125204273,0,0,1,0,1
140129617,0,0,1,0,1
125202325,0,0,1,0,1
163703669,0,0,1,0,1
143603020,1,0,0,0,1
142852663,0,0,1,0,1
140138765,1,0,0,0,1
125177157,1,0,0,0,1
125090618,1,0,0,0,1
140153865,1,0,0,0,1
142904044,0,0,1,0,1
161604395,1,0,0,0,1
143532846,0,0,1,0,1
161648438,1,0,0,0,1
142235171,1,0,0,0,1
125076766,0,0,1,0,1
142483789,1,0,0,0,1
123284293,0,0,1,0,1
143516082,1,0,0,0,1
161659518,0,0,1,0,1
125059640,1,0,0,0,1
125021178,1,0,0,0,1
142240474,1,0,0,0,1
142246533,0,0,1,0,1
140220933,1,0,0,0,1
162293435,1,0,0,0,1
125011763,1,0,0,0,1
143506701,0,0,1,0,1
143402105,0,0,1,0,1
163704446,0,0,1,0,1
163395163,1,0,0,0,1
125231390,1,0,0,0,1
161448479,1,0,0,0,1
123102489,0,0,1,0,1
124409689,1,0,0,0,1
162407370,0,0,1,0,1
143627644,0,0,0,1,1
161432983,1,0,0,0,1
140073773,1,0,0,0,1
163841098,1,0,0,0,1
140090423,1,0,0,0,1
161446130,0,0,1,0,1
161447986,0,0,1,0,1
143610536,1,0,0,0,1
124458490,0,0,0,1,1
125534010,1,0,0,0,1
162394023,1,0,0,0,1
142096180,0,0,0,1,1
123215557,1,0,0,0,1
123248789,0,0,1,0,1
161454135,0,0,1,0,1
162374141,0,0,1,0,1
125511976,1,0,0,0,1
161514941,0,0,1,0,1
163829123,1,0,0,0,1
142078178,1,0,0,0,1
140096210,1,0,0,0,1
125508339,1,0,0,0,1
125444588,0,0,1,0,1
161562842,1,0,0,0,1
125408735,0,0,1,0,1
123320165,1,0,0,0,1
162283008,0,0,1,0,1
161743285,0,0,0,1,1
163435333,1,0,0,0,1
163603458,1,0,0,0,1
124886133,1,0,0,0,1
161997330,1,0,0,0,1
140312311,0,0,1,0,1
142392927,1,0,0,0,1
143144982,1,0,0,0,1
124875592,1,0,0,0,1
141012332,1,0,0,0,1
163554531,0,0,1,0,1
163503264,0,0,1,0,1
163482759,0,0,1,0,1
162251663,0,0,1,0,1
123460654,1,0,0,0,1
124864741,0,0,1,0,1
140305853,1,0,0,0,1
124771208,0,0,1,0,1
142426920,0,0,1,0,1
124554019,0,0,1,0,1
140348326,0,0,1,0,1
162100686,1,0,0,0,1
123506305,0,0,1,0,1
124733512,1,0,0,0,1
123511218,0,0,1,0,1
124580765,1,0,0,0,1
162153544,1,0,0,0,1
143070465,0,0,1,0,1
140323391,0,0,1,0,1
141011662,1,0,0,0,1
124512705,0,0,1,0,1
161983650,0,0,1,0,1
142263776,1,0,0,0,1
123367130,1,0,0,0,1
161768861,1,0,0,0,1
161770518,1,0,0,0,1
124486054,0,0,1,0,1
143236401,0,0,1,0,1
123350031,0,0,1,0,1
124999506,1,0,0,0,1
141025502,1,0,0,0,1
161780175,1,0,0,0,1
123354518,0,0,1,0,1
143217239,1,0,0,0,1
161784847,1,0,0,0,1
123362684,1,0,0,0,1
143006262,1,0,0,0,1
143186772,1,0,0,0,1
143168243,0,0,1,0,1
140253187,0,0,1,0,1
163605956,1,0,0,0,1
161919000,0,0,1,0,1
162261784,0,0,0,1,1
123370360,1,0,0,0,1
124919670,1,0,0,0,1
123453141,0,0,1,0,1
123523177,1,0,0,0,1
143169709,0,0,1,0,1
140286225,0,0,1,0,1
143031280,1,0,0,0,1
140983856,1,0,0,0,1
123458466,0,0,1,0,1
163843832,0,0,1,0,1
123066627,1,0,0,0,1
141031544,0,0,1,0,1
141335210,1,0,0,0,1
144002200,1,0,0,0,1
164292046,1,0,0,0,1
126131797,0,0,1,0,1
123578077,0,0,1,0,1
139638096,0,0,1,0,1
126077082,0,0,1,0,1
160491843,0,0,1,0,1
160495098,1,0,0,0,1
140938997,0,0,1,0,1
122884945,1,0,0,0,1
124106675,1,0,0,0,1
162493061,1,0,0,0,1
160507714,0,0,1,0,1
160561142,1,0,0,0,1
122853875,1,0,0,0,1
122908845,1,0,0,0,1
142030905,1,0,0,0,1
163376694,1,0,0,0,1
126052775,0,0,1,0,1
160592811,0,0,1,0,1
143952234,1,0,0,0,1
139865682,0,0,1,0,1
125875662,1,0,0,0,1
160611440,0,0,1,0,1
164242874,1,0,0,0,1
125833008,0,0,1,0,1
122915576,1,0,0,0,1
139871790,1,0,0,0,1
164297725,1,0,0,0,1
139623237,0,0,1,0,1
125828141,1,0,0,0,1
164345159,0,0,1,0,1
144193172,0,0,1,0,1
160343135,0,0,1,0,1
122786340,0,0,1,0,1
144138036,1,0,0,0,1
163259257,0,0,0,1,1
164453630,0,0,1,0,1
126415353,0,0,1,0,1
163429865,1,0,0,0,1
144124452,0,0,1,0,1
160354574,1,0,0,0,1
160376922,1,0,0,0,1
164391402,0,0,1,0,1
123592933,0,0,1,0,1
126413470,1,0,0,0,1
124082275,0,0,1,0,1
126407919,1,0,0,0,1
144099816,0,0,1,0,1
164338652,1,0,0,0,1
141361303,1,0,0,0,1
141353471,0,0,1,0,1
126346950,1,0,0,0,1
164306429,1,0,0,0,1
163374912,0,0,1,0,1
122849679,0,0,1,0,1
160468444,0,0,1,0,1
142765455,1,0,0,0,1
126288916,0,0,1,0,1
126285830,0,0,1,0,1
160614820,0,0,1,0,1
139872738,1,0,0,0,1
163389619,1,0,0,0,1
125627920,1,0,0,0,1
162432069,1,0,0,0,1
162411010,1,0,0,0,1
141141822,0,0,1,0,1
143817547,1,0,0,0,1
123060492,1,0,0,0,1
124318039,0,0,1,0,1
161157565,0,0,1,0,1
161314694,1,0,0,0,1
161344095,1,0,0,0,1
143806301,0,0,1,0,1
140959303,1,0,0,0,1
143768763,0,0,1,0,1
143767350,0,0,1,0,1
143725871,1,0,0,0,1
124312370,1,0,0,0,1
140981137,1,0,0,0,1
161357125,0,0,1,0,1
163855521,1,0,0,0,1
124382170,1,0,0,0,1
143708082,1,0,0,0,1
161360183,1,0,0,0,1
142833006,0,0,1,0,1
163848078,1,0,0,0,1
161369795,0,0,1,0,1
139960947,1,0,0,0,1
125598078,1,0,0,0,1
125565839,1,0,0,0,1
123063094,0,0,1,0,1
122991035,1,0,0,0,1
160927474,0,0,1,0,1
160707142,0,0,1,0,1
160882703,1,0,0,0,1
163384875,1,0,0,0,1
139876671,0,0,1,0,1
164178160,0,0,1,0,1
125775383,1,0,0,0,1
139884352,0,0,1,0,1
160721088,0,0,1,0,1
142795724,0,0,1,0,1
139896539,1,0,0,0,1
123736313,1,0,0,0,1
160738437,0,0,1,0,1
160847231,1,0,0,0,1
122919892,1,0,0,0,1
164176914,1,0,0,0,1
140447920,0,0,1,0,1
125654433,1,0,0,0,1
125692898,0,0,1,0,1
141218191,1,0,0,0,1
139934186,1,0,0,0,1
124287074,1,0,0,0,1
162457374,0,0,1,0,1
160923266,0,0,1,0,1
163910171,1,0,0,0,1
139936437,0,0,1,0,1
140368531,0,0,1,0,1
125684191,0,0,1,0,1
122922752,0,0,1,0,1
142059543,0,0,1,0,1
125673239,1,0,0,0,1
143938171,1,0,0,0,1
134419840,0,0,1,0,1
127633170,0,0,1,0,1
131621761,0,0,1,0,1
148383782,1,0,0,0,1
148404349,0,0,1,0,1
131782045,0,0,1,0,1
136080466,1,0,0,0,1
152959594,1,0,0,0,1
131808888,1,0,0,0,1
131839253,1,0,0,0,1
131848646,0,0,1,0,1
152895936,0,0,1,0,1
136058103,0,0,1,0,1
152878377,0,0,1,0,1
148508902,1,0,0,0,1
148525638,0,0,1,0,1
152852607,1,0,0,0,1
131950694,0,0,1,0,1
152760575,0,0,1,0,1
148544231,0,0,1,0,1
152747338,1,0,0,0,1
131971883,1,0,0,0,1
136081476,1,0,0,0,1
153015791,0,0,1,0,1
148317706,1,0,0,0,1
153066091,0,0,1,0,1
153166469,1,0,0,0,1
153163740,1,0,0,0,1
153160229,0,0,1,0,1
148242106,0,0,1,0,1
153154549,0,0,1,0,1
136218354,1,0,0,0,1
131638107,1,0,0,0,1
153083048,0,0,1,0,1
136214003,1,0,0,0,1
131767309,0,0,1,0,1
131671508,0,0,1,0,1
136104359,0,0,1,0,1
131694766,1,0,0,0,1
148261815,0,0,1,0,1
148307318,1,0,0,0,1
136098610,1,0,0,0,1
131700723,1,0,0,0,1
153031657,0,0,1,0,1
148546760,1,0,0,0,1
135960773,0,0,1,0,1
148548075,1,0,0,0,1
135845936,0,0,1,0,1
132341923,1,0,0,0,1
135856127,0,0,1,0,1
152636597,0,0,1,0,1
152629314,0,0,1,0,1
132402260,0,0,1,0,1
152622411,0,0,1,0,1
132405291,1,0,0,0,1
152605245,0,0,1,0,1
132464510,0,0,1,0,1
135860446,1,0,0,0,1
135744505,0,0,1,0,1
148812441,1,0,0,0,1
132464629,1,0,0,0,1
132475953,0,0,1,0,1
152595606,1,0,0,0,1
132484183,1,0,0,0,1
135739716,1,0,0,0,1
132485225,0,0,1,0,1
132194726,1,0,0,0,1
148686255,0,0,1,0,1
152721564,1,0,0,0,1
148681567,0,0,1,0,1
135944525,0,0,1,0,1
148579193,0,0,1,0,1
131993336,1,0,0,0,1
132042700,0,0,1,0,1
132080218,0,0,1,0,1
148603348,1,0,0,0,1
148610928,1,0,0,0,1
135940325,1,0,0,0,1
135932425,0,0,1,0,1
132178349,1,0,0,0,1
135910220,0,0,1,0,1
135879317,0,0,1,0,1
132103681,1,0,0,0,1
135877454,1,0,0,0,1
148685521,0,0,1,0,1
132134034,0,0,1,0,1
132158770,1,0,0,0,1
132174119,0,0,1,0,1
153170211,1,0,0,0,1
153292704,0,0,1,0,1
132496661,0,0,1,0,1
131569457,0,0,0,1,1
154215237,1,0,0,0,1
136814532,0,0,1,0,1
130974654,0,0,1,0,1
130981288,1,0,0,0,1
154157018,0,0,1,0,1
131000948,0,0,1,0,1
131080763,1,0,0,0,1
154116030,1,0,0,0,1
154106207,0,0,1,0,1
131083549,1,0,0,0,1
148080076,1,0,0,0,1
154081089,1,0,0,0,1
131085087,1,0,0,0,1
153942159,1,0,0,0,1
153925237,1,0,0,0,1
148088831,1,0,0,0,1
131109595,1,0,0,0,1
153921305,1,0,0,0,1
131115416,1,0,0,0,1
154217970,0,0,1,0,1
136818122,0,0,1,0,1
154339771,0,0,1,0,1
136979577,1,0,0,0,1
137019730,1,0,0,0,1
154617969,1,0,0,0,1
136994181,1,0,0,0,1
130809111,1,0,0,0,1
154611549,1,0,0,0,1
147961078,1,0,0,0,1
154608871,1,0,0,0,1
136982841,0,0,1,0,1
130815919,1,0,0,0,1
154340775,1,0,0,0,1
154466053,1,0,0,0,1
130897041,1,0,0,0,1
130929164,1,0,0,0,1
154408383,1,0,0,0,1
130936251,1,0,0,0,1
136827347,0,0,1,0,1
154373742,1,0,0,0,1
154362702,1,0,0,0,1
153886003,1,0,0,0,1
148100571,1,0,0,0,1
148101743,1,0,0,0,1
148154589,0,0,1,0,1
153521800,1,0,0,0,1
153513107,1,0,0,0,1
153509107,1,0,0,0,1
153432838,0,0,1,0,1
153419495,1,0,0,0,1
153416347,0,0,1,0,1
148148402,1,0,0,0,1
148152874,1,0,0,0,1
131482216,1,0,0,0,1
136285608,0,0,1,0,1
153392552,1,0,0,0,1
136267788,1,0,0,0,1
131522515,1,0,0,0,1
153315099,0,0,1,0,1
131530792,1,0,0,0,1
148217517,0,0,1,0,1
131544841,1,0,0,0,1
148241246,1,0,0,0,1
131478346,0,0,1,0,1
153561136,1,0,0,0,1
153692944,1,0,0,0,1
148123938,1,0,0,0,1
131161460,0,0,1,0,1
136812643,0,0,1,0,1
148120194,0,0,1,0,1
136795744,1,0,0,0,1
131178795,1,0,0,0,1
136508431,1,0,0,0,1
131204454,1,0,0,0,1
131218877,1,0,0,0,1
131305000,0,0,1,0,1
131476188,0,0,1,0,1
153624920,0,0,1,0,1
136431007,0,0,1,0,1
148130073,1,0,0,0,1
131379802,1,0,0,0,1
136406167,0,0,1,0,1
153616576,1,0,0,0,1
131476092,1,0,0,0,1
153562499,1,0,0,0,1
132485563,0,0,1,0,1
152530167,1,0,0,0,1
130785115,1,0,0,0,1
133544264,0,0,1,0,1
149483822,1,0,0,0,1
149608542,0,0,1,0,1
133825714,0,0,0,1,1
134741341,0,0,1,0,1
151243003,0,0,1,0,1
151189049,0,0,1,0,1
133843257,1,0,0,0,1
151150981,1,0,0,0,1
151139950,1,0,0,0,1
133923404,1,0,0,0,1
151139612,1,0,0,0,1
149618690,1,0,0,0,1
151129573,0,0,1,0,1
134718774,1,0,0,0,1
149707913,1,0,0,0,1
149719030,1,0,0,0,1
134677764,0,0,1,0,1
133972014,1,0,0,0,1
134672751,0,0,1,0,1
134768657,1,0,0,0,1
133790239,0,0,1,0,1
133770455,1,0,0,0,1
149435862,1,0,0,0,1
151560823,0,0,1,0,1
151547086,0,0,1,0,1
133586767,0,0,1,0,1
151447436,1,0,0,0,1
135031316,0,0,1,0,1
134961952,1,0,0,0,1
149394434,0,0,1,0,1
134951555,0,0,1,0,1
149455355,1,0,0,0,1
134809070,1,0,0,0,1
134946389,0,0,1,0,1
151293286,1,0,0,0,1
133620428,1,0,0,0,1
133723890,1,0,0,0,1
133736899,1,0,0,0,1
134929241,1,0,0,0,1
133757967,0,0,1,0,1
134887663,1,0,0,0,1
149814698,0,0,1,0,1
133995881,1,0,0,0,1
149849302,1,0,0,0,1
150363476,0,0,1,0,1
150858055,0,0,1,0,1
150846601,1,0,0,0,1
134438985,1,0,0,0,1
150761245,1,0,0,0,1
150329038,1,0,0,0,1
150738275,1,0,0,0,1
150670215,1,0,0,0,1
134218386,1,0,0,0,1
134230136,1,0,0,0,1
150876351,1,0,0,0,1
150439529,1,0,0,0,1
150551412,1,0,0,0,1
150440720,1,0,0,0,1
150532585,1,0,0,0,1
134264127,1,0,0,0,1
134319027,1,0,0,0,1
150532459,0,0,1,0,1
150482926,1,0,0,0,1
150285481,1,0,0,0,1
150159094,1,0,0,0,1
134669838,0,0,1,0,1
151001073,1,0,0,0,1
151076372,0,0,1,0,1
134031945,1,0,0,0,1
151073194,1,0,0,0,1
134104016,0,0,1,0,1
151018315,0,0,1,0,1
134114121,1,0,0,0,1
134599908,1,0,0,0,1
151017370,1,0,0,0,1
150981064,1,0,0,0,1
150142253,1,0,0,0,1
149872054,1,0,0,0,1
134594269,1,0,0,0,1
134122415,1,0,0,0,1
150965627,0,0,1,0,1
150954841,0,0,1,0,1
150022684,0,0,1,0,1
150879430,0,0,1,0,1
134167192,0,0,1,0,1
151574296,1,0,0,0,1
133534397,1,0,0,0,1
132505285,1,0,0,0,1
133465194,1,0,0,0,1
135696084,0,0,1,0,1
132586703,1,0,0,0,1
149014739,0,0,1,0,1
135582685,0,0,1,0,1
135580412,0,0,1,0,1
132599620,0,0,1,0,1
135577694,1,0,0,0,1
152089883,0,0,1,0,1
152047633,0,0,1,0,1
132644162,1,0,0,0,1
152045247,1,0,0,0,1
132663528,1,0,0,0,1
132694041,1,0,0,0,1
132711675,0,0,1,0,1
149073048,0,0,1,0,1
152041579,0,0,1,0,1
135425067,1,0,0,0,1
152032831,0,0,1,0,1
151955474,0,0,1,0,1
135703190,1,0,0,0,1
132576479,1,0,0,0,1
152334637,0,0,1,0,1
132530334,1,0,0,0,1
135732224,0,0,1,0,1
152478794,1,0,0,0,1
132511908,1,0,0,0,1
152457143,0,0,1,0,1
132513543,1,0,0,0,1
148822519,1,0,0,0,1
132524631,1,0,0,0,1
135731332,1,0,0,0,1
135722057,0,0,1,0,1
132559039,0,0,1,0,1
148897644,0,0,1,0,1
132532539,1,0,0,0,1
152442590,0,0,1,0,1
152384999,1,0,0,0,1
152374951,0,0,1,0,1
132536008,1,0,0,0,1
152366935,1,0,0,0,1
132538605,1,0,0,0,1
151939707,1,0,0,0,1
135412962,1,0,0,0,1
151914151,1,0,0,0,1
133244801,1,0,0,0,1
135150441,0,0,1,0,1
135141630,1,0,0,0,1
135095966,1,0,0,0,1
135093573,0,0,1,0,1
151645438,1,0,0,0,1
133146682,0,0,0,1,1
133147190,0,0,1,0,1
135088799,1,0,0,0,1
133269895,0,0,1,0,1
149265574,0,0,1,0,1
149324749,0,0,1,0,1
135051329,1,0,0,0,1
149365996,1,0,0,0,1
135049810,0,0,1,0,1
133319015,1,0,0,0,1
133393751,0,0,1,0,1
133410608,0,0,1,0,1
133453273,1,0,0,0,1
133037177,0,0,0,1,1
135167209,0,0,1,0,1
135373362,1,0,0,0,1
151728547,1,0,0,0,1
135370608,1,0,0,0,1
132826462,0,0,1,0,1
151784237,0,0,1,0,1
132839074,1,0,0,0,1
151777787,0,0,1,0,1
132868974,1,0,0,0,1
132883657,1,0,0,0,1
149139706,1,0,0,0,1
135272642,1,0,0,0,1
149249049,1,0,0,0,1
151714821,1,0,0,0,1
151665010,1,0,0,0,1
135192905,1,0,0,0,1
132962808,0,0,1,0,1
132983866,0,0,1,0,1
149221924,1,0,0,0,1
135182619,1,0,0,0,1
133010064,1,0,0,0,1
154624283,1,0,0,0,1
147941732,0,0,1,0,1
127667513,1,0,0,0,1
157563838,1,0,0,0,1
128600529,1,0,0,0,1
146000368,1,0,0,0,1
128609354,1,0,0,0,1
138203985,1,0,0,0,1
146030957,0,0,1,0,1
138200407,1,0,0,0,1
128610997,0,0,1,0,1
146116263,0,0,1,0,1
138197456,1,0,0,0,1
128629269,0,0,1,0,1
128673450,1,0,0,0,1
157295049,0,0,1,0,1
157284647,1,0,0,0,1
157275347,1,0,0,0,1
157271408,1,0,0,0,1
138150256,1,0,0,0,1
128692351,0,0,1,0,1
128721938,1,0,0,0,1
146130663,1,0,0,0,1
128594804,0,0,1,0,1
138210979,1,0,0,0,1
157302498,1,0,0,0,1
157438943,0,0,1,0,1
128466802,1,0,0,0,1
138373960,1,0,0,0,1
157506473,0,0,1,0,1
138359603,1,0,0,0,1
128531725,0,0,1,0,1
128557920,1,0,0,0,1
128560208,1,0,0,0,1
145858413,0,0,1,0,1
157410883,1,0,0,0,1
145862771,1,0,0,0,1
128579948,1,0,0,0,1
157406894,0,0,1,0,1
157402346,0,0,1,0,1
128580688,1,0,0,0,1
150489232,0,0,1,0,1
138331581,1,0,0,0,1
138266252,1,0,0,0,1
138223994,1,0,0,0,1
138033394,1,0,0,0,1
128771508,1,0,0,0,1
128774557,0,0,1,0,1
146271052,1,0,0,0,1
128919111,1,0,0,0,1
128923049,0,0,1,0,1
137842078,1,0,0,0,1
128986377,0,0,1,0,1
137838298,0,0,1,0,1
156948111,0,0,1,0,1
129047499,0,0,1,0,1
156931070,0,0,1,0,1
129062212,1,0,0,0,1
146232496,1,0,0,0,1
137832740,0,0,1,0,1
156929679,1,0,0,0,1
156843123,0,0,1,0,1
156833182,1,0,0,0,1
137832487,0,0,1,0,1
137829485,0,0,1,0,1
146361760,1,0,0,0,1
156831639,1,0,0,0,1
128906008,1,0,0,0,1
137872939,0,0,1,0,1
138003310,0,0,1,0,1
146205943,1,0,0,0,1
137958489,0,0,1,0,1
146172048,0,0,1,0,1
157209452,0,0,1,0,1
128852127,0,0,1,0,1
137916804,1,0,0,0,1
157194575,1,0,0,0,1
146182000,0,0,1,0,1
157183215,1,0,0,0,1
157075387,1,0,0,0,1
146219213,0,0,1,0,1
137890627,1,0,0,0,1
157067019,0,0,1,0,1
137872960,0,0,1,0,1
157040162,0,0,1,0,1
157039612,1,0,0,0,1
128899955,0,0,1,0,1
157023321,0,0,0,1,1
156983314,1,0,0,0,1
128452734,1,0,0,0,1
138448755,1,0,0,0,1
129168532,0,0,1,0,1
128424841,1,0,0,0,1
145328112,1,0,0,0,1
158456362,0,0,1,0,1
145333094,0,0,1,0,1
145342126,1,0,0,0,1
127998381,1,0,0,0,1
158455776,1,0,0,0,1
128026912,1,0,0,0,1
145392038,0,0,1,0,1
158298807,1,0,0,0,1
128041172,0,0,1,0,1
138784297,0,0,1,0,1
128093565,0,0,1,0,1
158229004,1,0,0,0,1
145399240,0,0,1,0,1
128145774,0,0,1,0,1
158222655,0,0,1,0,1
128156060,0,0,1,0,1
158219768,1,0,0,0,1
128161356,0,0,1,0,1
158552987,0,0,1,0,1
127982853,1,0,0,0,1
127966183,0,0,1,0,1
138823659,1,0,0,0,1
145248567,1,0,0,0,1
158731650,0,0,1,0,1
158725307,0,0,1,0,1
145249464,1,0,0,0,1
158718264,1,0,0,0,1
158650288,1,0,0,0,1
127714840,0,0,1,0,1
145262656,1,0,0,0,1
127761214,1,0,0,0,1
127925141,0,0,1,0,1
127764617,0,0,1,0,1
127836236,1,0,0,0,1
127886968,0,0,1,0,1
158634669,1,0,0,0,1
127891176,0,0,1,0,1
158613193,0,0,1,0,1
145269309,1,0,0,0,1
127910599,1,0,0,0,1
138782186,0,0,1,0,1
145412589,1,0,0,0,1
128162460,0,0,1,0,1
128371146,0,0,1,0,1
157708630,0,0,1,0,1
128305959,0,0,1,0,1
145563103,1,0,0,0,1
157661515,0,0,1,0,1
157649863,1,0,0,0,1
157642917,1,0,0,0,1
138628430,0,0,1,0,1
145578669,1,0,0,0,1
145687876,1,0,0,0,1
157825168,0,0,1,0,1
128411044,0,0,1,0,1
128413939,0,0,1,0,1
157604475,0,0,1,0,1
138514498,1,0,0,0,1
157599851,0,0,1,0,1
128417181,0,0,1,0,1
145743257,0,0,1,0,1
157589285,0,0,1,0,1
157770735,1,0,0,0,1
157832521,1,0,0,0,1
128164616,0,0,1,0,1
128230715,1,0,0,0,1
145436974,1,0,0,0,1
128210772,0,0,1,0,1
138734174,1,0,0,0,1
158174749,0,0,1,0,1
158128505,1,0,0,0,1
128227275,0,0,1,0,1
145552870,1,0,0,0,1
158048189,1,0,0,0,1
128237188,0,0,1,0,1
157842225,1,0,0,0,1
158044747,1,0,0,0,1
157992328,1,0,0,0,1
157926624,1,0,0,0,1
138708257,0,0,1,0,1
145556205,1,0,0,0,1
138706642,0,0,1,0,1
128271193,0,0,1,0,1
145560149,0,0,1,0,1
129160124,1,0,0,0,1
146504288,1,0,0,0,1
137114793,1,0,0,0,1
130185165,0,0,1,0,1
130201799,0,0,1,0,1
137293107,1,0,0,0,1
155027850,1,0,0,0,1
155014420,1,0,0,0,1
154995528,0,0,1,0,1
154984900,0,0,1,0,1
154978446,1,0,0,0,1
130204296,0,0,1,0,1
137292249,1,0,0,0,1
137280131,1,0,0,0,1
130223713,1,0,0,0,1
147397734,1,0,0,0,1
130239329,1,0,0,0,1
147510629,1,0,0,0,1
154960741,0,0,1,0,1
130289593,1,0,0,0,1
130316720,1,0,0,0,1
154894476,1,0,0,0,1
147514887,0,0,1,0,1
155101453,0,0,1,0,1
137293453,0,0,1,0,1
147269347,0,0,1,0,1
155355077,1,0,0,0,1
155702726,1,0,0,0,1
155619942,1,0,0,0,1
130186732,1,0,0,0,1
147092207,1,0,0,0,1
130186976,1,0,0,0,1
155607686,0,0,1,0,1
137512725,0,0,1,0,1
147118920,1,0,0,0,1
155318905,0,0,1,0,1
155137506,1,0,0,0,1
155282535,1,0,0,0,1
155255550,1,0,0,0,1
137405826,0,0,1,0,1
147256218,1,0,0,0,1
137364928,1,0,0,0,1
155171571,1,0,0,0,1
147256857,0,0,1,0,1
155148052,1,0,0,0,1
147536196,1,0,0,0,1
130337107,1,0,0,0,1
147553350,0,0,1,0,1
147710243,1,0,0,0,1
130511786,0,0,1,0,1
130524170,1,0,0,0,1
130528939,1,0,0,0,1
130564186,1,0,0,0,1
130675388,0,0,1,0,1
130753801,1,0,0,0,1
154714898,1,0,0,0,1
147708401,1,0,0,0,1
147803075,0,0,1,0,1
147695010,0,0,1,0,1
130755514,1,0,0,0,1
147807102,1,0,0,0,1
130756194,0,0,1,0,1
147858863,0,0,1,0,1
154700793,1,0,0,0,1
130774685,1,0,0,0,1
154696585,0,0,1,0,1
154678310,0,0,1,0,1
154834539,1,0,0,0,1
154834587,0,0,1,0,1
137255181,0,0,1,0,1
154869920,1,0,0,0,1
130350276,1,0,0,0,1
147621812,0,0,1,0,1
130350884,1,0,0,0,1
130351126,1,0,0,0,1
154872149,0,0,1,0,1
147647020,1,0,0,0,1
147668954,1,0,0,0,1
130400901,1,0,0,0,1
147674459,1,0,0,0,1
137154853,1,0,0,0,1
154848269,0,0,1,0,1
154843406,0,0,1,0,1
154842298,1,0,0,0,1
130452689,1,0,0,0,1
130473272,1,0,0,0,1
137156356,0,0,1,0,1
147689604,1,0,0,0,1
130496399,1,0,0,0,1
147087560,0,0,1,0,1
137562994,0,0,1,0,1
146507610,1,0,0,0,1
130136946,1,0,0,0,1
129443696,1,0,0,0,1
137746976,1,0,0,0,1
129462719,1,0,0,0,1
129483977,0,0,1,0,1
129497806,1,0,0,0,1
156536838,1,0,0,0,1
129525574,1,0,0,0,1
146762240,0,0,1,0,1
129562484,1,0,0,0,1
129585378,0,0,1,0,1
129596284,0,0,1,0,1
129602851,0,0,1,0,1
156535560,1,0,0,0,1
156518698,0,0,1,0,1
137725101,1,0,0,0,1
156490310,1,0,0,0,1
146785675,1,0,0,0,1
129627879,0,0,1,0,1
137690897,0,0,1,0,1
146741271,0,0,1,0,1
156557516,1,0,0,0,1
146677115,1,0,0,0,1
146620661,1,0,0,0,1
156768745,0,0,1,0,1
137772585,1,0,0,0,1
146598678,0,0,1,0,1
146607158,1,0,0,0,1
146614700,0,0,1,0,1
129270031,0,0,1,0,1
156758470,0,0,0,1,1
146615800,1,0,0,0,1
156592177,0,0,1,0,1
156571787,1,0,0,0,1
146623639,1,0,0,0,1
156571850,1,0,0,0,1
129301317,0,0,1,0,1
129305100,1,0,0,0,1
137763012,1,0,0,0,1
146656172,1,0,0,0,1
129317761,0,0,1,0,1
146660704,0,0,1,0,1
129654782,1,0,0,0,1
156481014,1,0,0,0,1
156396144,1,0,0,0,1
130005087,0,0,1,0,1
156064588,0,0,1,0,1
129823499,1,0,0,0,1
155990761,0,0,1,0,1
129864892,1,0,0,0,1
155968930,1,0,0,0,1
129902279,0,0,1,0,1
137649778,1,0,0,0,1
137647792,1,0,0,0,1
130021104,0,0,1,0,1
129812563,0,0,1,0,1
137605130,1,0,0,0,1
155958005,0,0,1,0,1
130035533,1,0,0,0,1
155913928,0,0,1,0,1
155902664,1,0,0,0,1
137586595,1,0,0,0,1
130074377,0,0,1,0,1
130082352,0,0,1,0,1
156187884,1,0,0,0,1
156216145,1,0,0,0,1
129723592,0,0,1,0,1
137672539,0,0,0,1,1
146807013,1,0,0,0,1
137685990,0,0,1,0,1
146812160,1,0,0,0,1
146821560,0,0,1,0,1
137675040,0,0,1,0,1
156381151,0,0,1,0,1
156352453,1,0,0,0,1
156348349,1,0,0,0,1
129768127,0,0,1,0,1
129797713,0,0,1,0,1
129782365,1,0,0,0,1
129794391,1,0,0,0,1
146823994,0,0,1,0,1
137665954,1,0,0,0,1
156255485,1,0,0,0,1
146960913,0,0,1,0,1
137658925,0,0,1,0,1
146963216,1,0,0,0,1
157397904,1,0,0,0,1
97976588,1,0,0,0,1
122045009,0,0,1,0,1
71732672,1,0,0,0,1
72110132,1,0,0,0,1
72086306,0,0,1,0,1
72027119,1,0,0,0,1
72023980,1,0,0,0,1
72019599,1,0,0,0,1
72002747,1,0,0,0,1
72001588,0,0,1,0,1
71983877,1,0,0,0,1
71895768,1,0,0,0,1
71876303,1,0,0,0,1
71864947,1,0,0,0,1
71850281,0,0,1,0,1
71849302,1,0,0,0,1
71841088,1,0,0,0,1
71811779,1,0,0,0,1
71754921,1,0,0,0,1
71746226,0,0,1,0,1
72110232,1,0,0,0,1
72112652,0,0,1,0,1
72117490,1,0,0,0,1
72287701,1,0,0,0,1
72418046,1,0,0,0,1
72415862,1,0,0,0,1
72400000,0,0,1,0,1
72398084,1,0,0,0,1
72339782,1,0,0,0,1
72312989,1,0,0,0,1
72306726,0,0,1,0,1
72218656,1,0,0,0,1
72142281,1,0,0,0,1
72215470,1,0,0,0,1
72205340,0,0,1,0,1
72203373,0,0,1,0,1
72196680,0,0,1,0,1
72175808,0,0,1,0,1
72168153,0,0,1,0,1
72163559,0,0,1,0,1
71742050,0,0,1,0,1
71725161,1,0,0,0,1
72453994,1,0,0,0,1
71723502,1,0,0,0,1
71375159,0,0,1,0,1
71370979,1,0,0,0,1
71370032,0,0,1,0,1
71366283,1,0,0,0,1
71350426,1,0,0,0,1
71325123,0,0,1,0,1
71321195,1,0,0,0,1
71320132,1,0,0,0,1
71312760,1,0,0,0,1
71307655,1,0,0,0,1
71292398,0,0,1,0,1
71289710,0,0,1,0,1
71211231,0,0,1,0,1
71210357,1,0,0,0,1
71203979,0,0,1,0,1
71188253,1,0,0,0,1
71152156,1,0,0,0,1
71375344,1,0,0,0,1
71402091,1,0,0,0,1
71451795,1,0,0,0,1
71561968,1,0,0,0,1
71698853,1,0,0,0,1
71663192,0,0,1,0,1
71635863,0,0,1,0,1
71635685,1,0,0,0,1
71584494,1,0,0,0,1
71578008,1,0,0,0,1
71564201,1,0,0,0,1
71559157,1,0,0,0,1
71478600,1,0,0,0,1
71552588,0,0,0,1,1
71546110,1,0,0,0,1
71515912,1,0,0,0,1
71496163,1,0,0,0,1
71492792,0,0,1,0,1
71490429,1,0,0,0,1
71482332,1,0,0,0,1
72423116,0,0,1,0,1
72466752,0,0,1,0,1
73965928,1,0,0,0,1
73262360,1,0,0,0,1
73610315,0,0,1,0,1
73597409,1,0,0,0,1
73592174,0,0,1,0,1
73583445,1,0,0,0,1
73550323,0,0,1,0,1
73541172,1,0,0,0,1
73510171,1,0,0,0,1
73498715,1,0,0,0,1
73493521,1,0,0,0,1
73450674,1,0,0,0,1
73435830,1,0,0,0,1
73428135,1,0,0,0,1
73365283,1,0,0,0,1
73358102,1,0,0,0,1
73324719,1,0,0,0,1
73293700,0,0,1,0,1
73284283,1,0,0,0,1
73621411,1,0,0,0,1
73630116,0,0,1,0,1
73638523,1,0,0,0,1
73850433,1,0,0,0,1
73957466,1,0,0,0,1
73941654,1,0,0,0,1
73932051,0,0,1,0,1
73924316,1,0,0,0,1
73868437,1,0,0,0,1
73867354,1,0,0,0,1
73864266,0,0,1,0,1
73843068,1,0,0,0,1
73643860,0,0,1,0,1
73839962,1,0,0,0,1
73785055,1,0,0,0,1
73764539,1,0,0,0,1
73732590,1,0,0,0,1
73717067,1,0,0,0,1
73659867,1,0,0,0,1
73645458,0,0,1,0,1
73269245,0,0,1,0,1
73239638,1,0,0,0,1
72493368,1,0,0,0,1
73196438,0,0,1,0,1
72770139,0,0,1,0,1
72760017,1,0,0,0,1
72741565,1,0,0,0,1
72715655,1,0,0,0,1
72710100,0,0,1,0,1
72701423,0,0,1,0,1
72668918,1,0,0,0,1
72607614,1,0,0,0,1
72596124,1,0,0,0,1
72591141,0,0,1,0,1
72574297,1,0,0,0,1
72573245,1,0,0,0,1
72542338,0,0,1,0,1
72539408,1,0,0,0,1
72521406,1,0,0,0,1
72513175,0,0,1,0,1
72507521,1,0,0,0,1
72774071,1,0,0,0,1
72808547,1,0,0,0,1
72881006,0,0,1,0,1
73055826,1,0,0,0,1
73179534,0,0,1,0,1
73175609,1,0,0,0,1
73126926,0,0,1,0,1
73122401,1,0,0,0,1
73069526,1,0,0,0,1
73068058,1,0,0,0,1
73067678,1,0,0,0,1
72972258,0,0,0,1,1
72893612,1,0,0,0,1
72967204,1,0,0,0,1
72944476,1,0,0,0,1
72931015,1,0,0,0,1
72923241,0,0,1,0,1
72918560,1,0,0,0,1
72904238,1,0,0,0,1
72897900,0,0,1,0,1
71147912,0,0,1,0,1
71146310,1,0,0,0,1
71138930,0,0,1,0,1
68544687,1,0,0,0,1
68894577,0,0,1,0,1
68878222,1,0,0,0,1
68869481,1,0,0,0,1
68848703,1,0,0,0,1
68771036,0,0,1,0,1
68760676,0,0,1,0,1
68740200,1,0,0,0,1
68735532,1,0,0,0,1
68733807,1,0,0,0,1
68729548,0,0,1,0,1
68718914,0,0,1,0,1
68672896,1,0,0,0,1
68585649,0,0,1,0,1
68579384,0,0,1,0,1
68578384,0,0,1,0,1
68571592,0,0,1,0,1
68554866,1,0,0,0,1
68909853,0,0,1,0,1
68921154,1,0,0,0,1
68930733,0,0,1,0,1
69075864,1,0,0,0,1
69232570,0,0,1,0,1
69219807,1,0,0,0,1
69210611,0,0,1,0,1
69205600,0,0,1,0,1
69203926,1,0,0,0,1
69124785,0,0,1,0,1
69117812,0,0,0,1,1
69074662,1,0,0,0,1
68934128,1,0,0,0,1
69069158,0,0,1,0,1
69063239,1,0,0,0,1
69054780,0,0,1,0,1
69029231,1,0,0,0,1
68995107,0,0,1,0,1
68959402,1,0,0,0,1
68945584,1,0,0,0,1
68547639,0,0,1,0,1
68432581,1,0,0,0,1
71093679,1,0,0,0,1
68422430,0,0,1,0,1
68107563,1,0,0,0,1
68094755,0,0,1,0,1
68080601,1,0,0,0,1
68079921,1,0,0,0,1
68077644,1,0,0,0,1
68074387,0,0,1,0,1
68070597,1,0,0,0,1
68017798,0,0,1,0,1
68013836,0,0,1,0,1
67992400,0,0,1,0,1
67974923,1,0,0,0,1
67961258,0,0,1,0,1
67947268,1,0,0,0,1
67931689,0,0,1,0,1
67926180,1,0,0,0,1
67902194,0,0,1,0,1
67869496,1,0,0,0,1
68119814,0,0,1,0,1
68128124,1,0,0,0,1
68134012,1,0,0,0,1
68285811,0,0,0,1,1
68417473,1,0,0,0,1
68404305,0,0,1,0,1
68337710,0,0,1,0,1
68324742,1,0,0,0,1
68322243,1,0,0,0,1
68309691,0,0,1,0,1
68296703,1,0,0,0,1
68276808,0,0,1,0,1
68138404,0,0,1,0,1
68259829,1,0,0,0,1
68249711,1,0,0,0,1
68242337,1,0,0,0,1
68234238,0,0,1,0,1
68225611,1,0,0,0,1
68217730,1,0,0,0,1
68139079,0,0,1,0,1
69255438,1,0,0,0,1
69267322,0,0,1,0,1
69278386,1,0,0,0,1
69278701,1,0,0,0,1
70651602,0,0,1,0,1
70646826,0,0,1,0,1
70646170,1,0,0,0,1
70644373,1,0,0,0,1
70638431,1,0,0,0,1
70637655,0,0,1,0,1
70636634,1,0,0,0,1
70552468,1,0,0,0,1
70541327,1,0,0,0,1
70506007,0,0,1,0,1
70431401,1,0,0,0,1
70419222,1,0,0,0,1
70345156,1,0,0,0,1
70338191,0,0,1,0,1
70321716,1,0,0,0,1
70260210,0,0,1,0,1
70260014,1,0,0,0,1
70686576,1,0,0,0,1
70713032,1,0,0,0,1
70724038,0,0,1,0,1
70872290,1,0,0,0,1
71093067,0,0,1,0,1
71082276,0,0,1,0,1
71049605,0,0,1,0,1
71012165,0,0,1,0,1
71007971,1,0,0,0,1
70995022,1,0,0,0,1
70978172,1,0,0,0,1
70859746,1,0,0,0,1
70734487,1,0,0,0,1
70858872,1,0,0,0,1
70828773,1,0,0,0,1
70816385,1,0,0,0,1
70811892,1,0,0,0,1
70779489,0,0,1,0,1
70774951,1,0,0,0,1
70773274,1,0,0,0,1
70198067,0,0,1,0,1
70164336,1,0,0,0,1
70162513,0,0,1,0,1
69435907,0,0,1,0,1
69681531,1,0,0,0,1
69677082,0,0,1,0,1
69652097,1,0,0,0,1
69576050,1,0,0,0,1
69503147,1,0,0,0,1
69476664,1,0,0,0,1
69457013,0,0,1,0,1
69426967,1,0,0,0,1
69705259,0,0,1,0,1
69399723,1,0,0,0,1
69398683,1,0,0,0,1
69391155,1,0,0,0,1
69373508,1,0,0,0,1
69355658,0,0,1,0,1
69286284,1,0,0,0,1
69286042,0,0,1,0,1
69700229,0,0,1,0,1
69718487,1,0,0,0,1
70154608,1,0,0,0,1
70039705,0,0,1,0,1
70142755,0,0,1,0,1
70120241,1,0,0,0,1
70089330,1,0,0,0,1
70082670,1,0,0,0,1
70079814,1,0,0,0,1
70065270,1,0,0,0,1
70051986,1,0,0,0,1
70026602,0,0,1,0,1
69765146,0,0,1,0,1
70010592,1,0,0,0,1
69992824,1,0,0,0,1
69866875,0,0,1,0,1
69825290,1,0,0,0,1
69798076,1,0,0,0,1
69788303,1,0,0,0,1
69776478,0,0,1,0,1
73961308,1,0,0,0,1
74011703,1,0,0,0,1
67836151,1,0,0,0,1
78814486,0,0,1,0,1
79170398,1,0,0,0,1
79167228,1,0,0,0,1
79162651,1,0,0,0,1
79141968,1,0,0,0,1
79134040,0,0,1,0,1
79086338,0,0,1,0,1
79078275,0,0,1,0,1
79020870,0,0,0,1,1
78953413,1,0,0,0,1
78936234,1,0,0,0,1
78933804,1,0,0,0,1
78931932,1,0,0,0,1
78930817,1,0,0,0,1
78895626,0,0,1,0,1
78877183,1,0,0,0,1
78866824,0,0,1,0,1
78832142,1,0,0,0,1
79258584,1,0,0,0,1
79260308,1,0,0,0,1
79289737,0,0,1,0,1
79478180,1,0,0,0,1
79674429,1,0,0,0,1
79663176,1,0,0,0,1
79589716,0,0,1,0,1
79575143,1,0,0,0,1
79534925,0,0,1,0,1
79501580,1,0,0,0,1
79501489,1,0,0,0,1
79459633,0,0,1,0,1
79293779,1,0,0,0,1
79345554,1,0,0,0,1
79344908,1,0,0,0,1
79341807,1,0,0,0,1
79338533,1,0,0,0,1
79326114,0,0,1,0,1
79322329,0,0,1,0,1
79321760,1,0,0,0,1
78817833,0,0,1,0,1
78803386,1,0,0,0,1
79702096,1,0,0,0,1
78801372,1,0,0,0,1
78326799,0,0,1,0,1
78312516,1,0,0,0,1
78299086,0,0,1,0,1
78292517,1,0,0,0,1
78289814,1,0,0,0,1
78286572,0,0,1,0,1
78285648,1,0,0,0,1
78258683,1,0,0,0,1
78254013,0,0,1,0,1
78176513,1,0,0,0,1
78164397,0,0,1,0,1
78154356,1,0,0,0,1
78150907,1,0,0,0,1
78110875,1,0,0,0,1
78107584,1,0,0,0,1
78078053,0,0,1,0,1
77949896,1,0,0,0,1
78343072,0,0,1,0,1
78343124,0,0,1,0,1
78378674,0,0,0,1,1
78619120,1,0,0,0,1
78732090,0,0,1,0,1
78722739,1,0,0,0,1
78712535,1,0,0,0,1
78706106,1,0,0,0,1
78704485,1,0,0,0,1
78672740,0,0,1,0,1
78640950,1,0,0,0,1
78556150,1,0,0,0,1
78414501,0,0,1,0,1
78529013,0,0,1,0,1
78507216,1,0,0,0,1
78499938,1,0,0,0,1
78464432,1,0,0,0,1
78461503,0,0,1,0,1
78430614,1,0,0,0,1
78414842,0,0,1,0,1
79675471,1,0,0,0,1
79704239,0,0,1,0,1
74031395,1,0,0,0,1
80780369,0,0,1,0,1
81146418,1,0,0,0,1
81141009,1,0,0,0,1
81109720,0,0,1,0,1
81109011,1,0,0,0,1
81058572,1,0,0,0,1
81035627,1,0,0,0,1
81013659,0,0,1,0,1
80958853,1,0,0,0,1
80926401,0,0,1,0,1
80917634,0,0,1,0,1
80894027,1,0,0,0,1
80886117,1,0,0,0,1
80837608,1,0,0,0,1
80797299,0,0,0,1,1
80794677,0,0,1,0,1
80793056,0,0,1,0,1
80789850,0,0,1,0,1
81190209,0,0,1,0,1
81295676,0,0,1,0,1
81329124,1,0,0,0,1
81673810,1,0,0,0,1
81859848,1,0,0,0,1
81767764,1,0,0,0,1
81765898,0,0,1,0,1
81763260,1,0,0,0,1
81754218,1,0,0,0,1
81712146,0,0,1,0,1
81706032,1,0,0,0,1
81640632,1,0,0,0,1
81347848,1,0,0,0,1
81555710,1,0,0,0,1
81534600,1,0,0,0,1
81503286,1,0,0,0,1
81460578,0,0,1,0,1
81441564,1,0,0,0,1
81430151,0,0,1,0,1
81365887,0,0,1,0,1
80781527,1,0,0,0,1
80777352,0,0,1,0,1
79736580,1,0,0,0,1
80770467,0,0,1,0,1
80292073,0,0,1,0,1
80283042,1,0,0,0,1
80277391,0,0,1,0,1
80246058,1,0,0,0,1
80207362,1,0,0,0,1
80134273,1,0,0,0,1
80091916,0,0,1,0,1
80080216,0,0,1,0,1
80068221,1,0,0,0,1
79951689,1,0,0,0,1
79912031,1,0,0,0,1
79896285,0,0,1,0,1
79886089,0,0,1,0,1
79840032,1,0,0,0,1
79752355,1,0,0,0,1
79743016,1,0,0,0,1
79738498,0,0,1,0,1
80315972,1,0,0,0,1
80331757,0,0,1,0,1
80333311,1,0,0,0,1
80593607,1,0,0,0,1
80721470,0,0,1,0,1
80710087,0,0,1,0,1
80690001,1,0,0,0,1
80686298,1,0,0,0,1
80603182,0,0,1,0,1
80602638,1,0,0,0,1
80597953,1,0,0,0,1
80573754,0,0,1,0,1
80336543,0,0,1,0,1
80571832,1,0,0,0,1
80534927,1,0,0,0,1
80509710,0,0,1,0,1
80500519,1,0,0,0,1
80461385,1,0,0,0,1
80443454,0,0,1,0,1
80437226,1,0,0,0,1
77938412,0,0,1,0,1
77825548,0,0,1,0,1
77820704,1,0,0,0,1
75059797,0,0,1,0,1
75398380,1,0,0,0,1
75385686,0,0,1,0,1
75310656,1,0,0,0,1
75287595,0,0,1,0,1
75279920,1,0,0,0,1
75266494,1,0,0,0,1
75253309,1,0,0,0,1
75242347,0,0,1,0,1
75229214,1,0,0,0,1
75218527,1,0,0,0,1
75199843,0,0,1,0,1
75177978,0,0,1,0,1
75115101,0,0,1,0,1
75114184,0,0,1,0,1
75088796,1,0,0,0,1
75085688,1,0,0,0,1
75084422,0,0,1,0,1
75400978,1,0,0,0,1
75431126,0,0,1,0,1
75452286,1,0,0,0,1
75664810,1,0,0,0,1
75828613,0,0,1,0,1
75812000,0,0,1,0,1
75810157,0,0,1,0,1
75793151,1,0,0,0,1
75749777,0,0,1,0,1
75748625,0,0,1,0,1
75737941,1,0,0,0,1
75657939,0,0,1,0,1
75461641,1,0,0,0,1
75600172,0,0,1,0,1
75577166,1,0,0,0,1
75574602,1,0,0,0,1
75569180,1,0,0,0,1
75566080,1,0,0,0,1
75547780,1,0,0,0,1
75478154,1,0,0,0,1
75065047,1,0,0,0,1
75032421,0,0,1,0,1
77811516,0,0,1,0,1
75009670,1,0,0,0,1
74310552,1,0,0,0,1
74282739,1,0,0,0,1
74255931,1,0,0,0,1
74250858,0,0,1,0,1
74217001,1,0,0,0,1
74180901,1,0,0,0,1
74179792,1,0,0,0,1
74178500,1,0,0,0,1
74151784,0,0,1,0,1
74119429,1,0,0,0,1
74103802,1,0,0,0,1
74055474,1,0,0,0,1
74054267,0,0,1,0,1
74047176,1,0,0,0,1
74038304,0,0,1,0,1
74033595,0,0,1,0,1
74033494,1,0,0,0,1
74314960,0,0,1,0,1
74328483,0,0,1,0,1
74330820,0,0,1,0,1
74789787,0,0,1,0,1
75003580,0,0,1,0,1
74944205,1,0,0,0,1
74874485,1,0,0,0,1
74873757,0,0,1,0,1
74823629,0,0,1,0,1
74822306,1,0,0,0,1
74805133,0,0,1,0,1
74697676,0,0,1,0,1
74338412,0,0,1,0,1
74653179,1,0,0,0,1
74643411,1,0,0,0,1
74573695,0,0,1,0,1
74558822,0,0,1,0,1
74514078,0,0,1,0,1
74477395,0,0,1,0,1
74397192,0,0,1,0,1
75853911,1,0,0,0,1
75872359,1,0,0,0,1
75915628,1,0,0,0,1
75916476,0,0,1,0,1
77136720,1,0,0,0,1
77134747,0,0,1,0,1
77108752,1,0,0,0,1
77085687,1,0,0,0,1
77050010,1,0,0,0,1
77015007,1,0,0,0,1
76998256,1,0,0,0,1
76998112,1,0,0,0,1
76940812,1,0,0,0,1
76901881,0,0,1,0,1
76894670,1,0,0,0,1
76855132,1,0,0,0,1
76854135,1,0,0,0,1
76849762,0,0,1,0,1
76849055,0,0,1,0,1
76846398,1,0,0,0,1
76840954,1,0,0,0,1
77153524,0,0,1,0,1
77243829,1,0,0,0,1
77290831,1,0,0,0,1
77580973,0,0,1,0,1
77792023,0,0,1,0,1
77780898,1,0,0,0,1
77744317,0,0,1,0,1
77719880,0,0,1,0,1
77698412,0,0,1,0,1
77646735,1,0,0,0,1
77603717,1,0,0,0,1
77534743,0,0,1,0,1
77304429,1,0,0,0,1
77523610,0,0,1,0,1
77409890,1,0,0,0,1
77375497,1,0,0,0,1
77365697,1,0,0,0,1
77355562,0,0,1,0,1
77341393,0,0,1,0,1
77325010,1,0,0,0,1
76840423,1,0,0,0,1
76835453,1,0,0,0,1
76821338,0,0,1,0,1
76232256,0,0,1,0,1
76407060,1,0,0,0,1
76391110,1,0,0,0,1
76362658,1,0,0,0,1
76327788,1,0,0,0,1
76303329,0,0,1,0,1
76272423,0,0,1,0,1
76237449,1,0,0,0,1
76227113,1,0,0,0,1
76415404,0,0,1,0,1
76225580,1,0,0,0,1
76024942,0,0,1,0,1
76021267,0,0,1,0,1
75982141,1,0,0,0,1
75976584,0,0,1,0,1
75973505,0,0,1,0,1
75918061,1,0,0,0,1
76409499,0,0,1,0,1
76422506,0,0,1,0,1
76816045,1,0,0,0,1
76619663,1,0,0,0,1
76809352,1,0,0,0,1
76767234,0,0,0,1,1
76749134,1,0,0,0,1
76728828,1,0,0,0,1
76664098,0,0,0,1,1
76648163,1,0,0,0,1
76628403,0,0,1,0,1
76590834,0,0,1,0,1
76426686,0,0,1,0,1
76582389,1,0,0,0,1
76559023,0,0,1,0,1
76549046,0,0,1,0,1
76536839,1,0,0,0,1
76533663,0,0,1,0,1
76451668,1,0,0,0,1
76443791,1,0,0,0,1
67840135,1,0,0,0,1
67834597,0,0,1,0,1
81921451,0,0,1,0,1
59518759,0,0,1,0,1
59938558,1,0,0,0,1
59929331,1,0,0,0,1
59922151,1,0,0,0,1
59907906,1,0,0,0,1
59880594,0,0,1,0,1
59808986,1,0,0,0,1
59799262,1,0,0,0,1
59787288,1,0,0,0,1
59765638,1,0,0,0,1
59746634,0,0,1,0,1
59712024,0,0,1,0,1
59680557,0,0,1,0,1
59654712,1,0,0,0,1
59628601,1,0,0,0,1
59609062,0,0,1,0,1
59591371,1,0,0,0,1
59552219,1,0,0,0,1
59954257,1,0,0,0,1
59954595,1,0,0,0,1
59959974,1,0,0,0,1
60094602,1,0,0,0,1
60139158,1,0,0,0,1
60134224,1,0,0,0,1
60128641,0,0,1,0,1
60127679,0,0,1,0,1
60126047,0,0,1,0,1
60116071,1,0,0,0,1
60112093,0,0,1,0,1
60093971,1,0,0,0,1
59966705,1,0,0,0,1
60084155,1,0,0,0,1
60077920,1,0,0,0,1
60077790,0,0,1,0,1
59993718,0,0,1,0,1
59985129,1,0,0,0,1
59982224,1,0,0,0,1
59979344,0,0,1,0,1
59521180,1,0,0,0,1
59493714,0,0,1,0,1
60163700,0,0,1,0,1
59489089,1,0,0,0,1
59075666,0,0,1,0,1
59054124,1,0,0,0,1
59040996,1,0,0,0,1
59037926,0,0,1,0,1
59026607,1,0,0,0,1
59021519,0,0,1,0,1
59021341,0,0,1,0,1
59018284,0,0,1,0,1
58964906,0,0,1,0,1
58931360,1,0,0,0,1
58905707,1,0,0,0,1
58903410,0,0,1,0,1
58882459,0,0,1,0,1
58877492,1,0,0,0,1
58783159,1,0,0,0,1
58753715,0,0,1,0,1
58730304,1,0,0,0,1
59095370,1,0,0,0,1
59105771,1,0,0,0,1
59117179,0,0,1,0,1
59384912,0,0,1,0,1
59488330,0,0,1,0,1
59479018,0,0,1,0,1
59473349,1,0,0,0,1
59459809,1,0,0,0,1
59449336,1,0,0,0,1
59411033,0,0,1,0,1
59392167,0,0,1,0,1
59381723,1,0,0,0,1
59163247,1,0,0,0,1
59377513,1,0,0,0,1
59351143,0,0,0,1,1
59317338,1,0,0,0,1
59254242,0,0,1,0,1
59240650,0,0,1,0,1
59204717,0,0,1,0,1
59169595,1,0,0,0,1
60160069,1,0,0,0,1
60198653,1,0,0,0,1
61649970,1,0,0,0,1
60786164,1,0,0,0,1
61148757,1,0,0,0,1
61140228,0,0,1,0,1
61132135,1,0,0,0,1
61090169,1,0,0,0,1
61088024,1,0,0,0,1
61028242,1,0,0,0,1
61024981,1,0,0,0,1
60996330,1,0,0,0,1
60984957,1,0,0,0,1
60975812,0,0,1,0,1
60928518,1,0,0,0,1
60922011,1,0,0,0,1
60904698,0,0,1,0,1
60901751,1,0,0,0,1
60852834,0,0,1,0,1
60836358,0,0,1,0,1
60817772,1,0,0,0,1
61162003,1,0,0,0,1
61172932,1,0,0,0,1
61257899,1,0,0,0,1
61436372,1,0,0,0,1
61587120,1,0,0,0,1
61585315,0,0,1,0,1
61560050,0,0,1,0,1
61555945,1,0,0,0,1
61549491,1,0,0,0,1
61483702,0,0,1,0,1
61462547,1,0,0,0,1
61418949,0,0,1,0,1
61277311,1,0,0,0,1
61398811,0,0,1,0,1
61394859,0,0,1,0,1
61339221,0,0,1,0,1
61334331,0,0,1,0,1
61330869,0,0,1,0,1
61303786,0,0,1,0,1
61298005,1,0,0,0,1
60786250,1,0,0,0,1
60753668,1,0,0,0,1
60207722,1,0,0,0,1
60749556,1,0,0,0,1
60388022,0,0,1,0,1
60387214,1,0,0,0,1
60376755,1,0,0,0,1
60369400,0,0,1,0,1
60365737,0,0,1,0,1
60365315,0,0,1,0,1
60354171,0,0,1,0,1
60351850,1,0,0,0,1
60344033,0,0,1,0,1
60293337,0,0,1,0,1
60278793,1,0,0,0,1
60278094,1,0,0,0,1
60258860,1,0,0,0,1
60255491,1,0,0,0,1
60239797,0,0,1,0,1
60235514,0,0,1,0,1
60212348,1,0,0,0,1
60411344,0,0,1,0,1
60446033,0,0,1,0,1
60500336,1,0,0,0,1
60617592,0,0,1,0,1
60690903,0,0,1,0,1
60687546,1,0,0,0,1
60678479,0,0,1,0,1
60670531,1,0,0,0,1
60665255,1,0,0,0,1
60626720,0,0,1,0,1
60618494,0,0,1,0,1
60615372,1,0,0,0,1
60501531,1,0,0,0,1
60596749,1,0,0,0,1
60542135,1,0,0,0,1
60539147,1,0,0,0,1
60525649,1,0,0,0,1
60523852,1,0,0,0,1
60523001,1,0,0,0,1
60502606,1,0,0,0,1
58633616,1,0,0,0,1
58633574,0,0,1,0,1
58599806,1,0,0,0,1
56775169,1,0,0,0,1
57068333,1,0,0,0,1
57067644,1,0,0,0,1
57058461,1,0,0,0,1
57055185,0,0,1,0,1
57024509,1,0,0,0,1
57015584,1,0,0,0,1
56991870,1,0,0,0,1
56991582,1,0,0,0,1
56985517,1,0,0,0,1
56983088,1,0,0,0,1
56935058,1,0,0,0,1
56887361,0,0,1,0,1
56865116,1,0,0,0,1
56857033,0,0,1,0,1
56847803,1,0,0,0,1
56841950,0,0,1,0,1
56780355,0,0,1,0,1
57069428,0,0,1,0,1
57090879,0,0,1,0,1
57097075,1,0,0,0,1
57238339,1,0,0,0,1
57287101,1,0,0,0,1
57283593,1,0,0,0,1
57275881,1,0,0,0,1
57264441,1,0,0,0,1
57257971,0,0,1,0,1
57256221,1,0,0,0,1
57254931,1,0,0,0,1
57216066,1,0,0,0,1
57122538,0,0,1,0,1
57192926,1,0,0,0,1
57188049,1,0,0,0,1
57160283,1,0,0,0,1
57146691,1,0,0,0,1
57140272,1,0,0,0,1
57135136,1,0,0,0,1
57124037,1,0,0,0,1
56775629,1,0,0,0,1
56764202,1,0,0,0,1
58581532,0,0,1,0,1
56757345,1,0,0,0,1
56412357,0,0,1,0,1
56382110,1,0,0,0,1
56365890,1,0,0,0,1
56354908,0,0,1,0,1
56352735,1,0,0,0,1
56344347,1,0,0,0,1
56342651,1,0,0,0,1
56312532,1,0,0,0,1
56306339,1,0,0,0,1
56276728,0,0,1,0,1
56263644,0,0,1,0,1
56247346,1,0,0,0,1
56242694,0,0,1,0,1
56242046,1,0,0,0,1
56232543,1,0,0,0,1
56227082,0,0,1,0,1
56214524,1,0,0,0,1
56420582,0,0,1,0,1
56470374,1,0,0,0,1
56488464,1,0,0,0,1
56623911,0,0,1,0,1
56730358,1,0,0,0,1
56726411,0,0,1,0,1
56710089,1,0,0,0,1
56704653,1,0,0,0,1
56653749,1,0,0,0,1
56648414,1,0,0,0,1
56636906,0,0,1,0,1
56616801,0,0,1,0,1
56488633,0,0,1,0,1
56616493,0,0,1,0,1
56607815,1,0,0,0,1
56551795,1,0,0,0,1
56546581,0,0,1,0,1
56539065,0,0,1,0,1
56536974,0,0,1,0,1
56517700,1,0,0,0,1
57287881,0,0,1,0,1
57292550,1,0,0,0,1
57296783,0,0,1,0,1
57305837,1,0,0,0,1
58118531,1,0,0,0,1
58110428,1,0,0,0,1
58104904,0,0,1,0,1
58098561,1,0,0,0,1
58091313,1,0,0,0,1
58078690,1,0,0,0,1
58076069,1,0,0,0,1
58070616,0,0,1,0,1
58069023,1,0,0,0,1
57973441,0,0,1,0,1
57964753,1,0,0,0,1
57954654,1,0,0,0,1
57939306,1,0,0,0,1
57935592,1,0,0,0,1
57910970,1,0,0,0,1
57907042,1,0,0,0,1
57896215,0,0,1,0,1
58164974,0,0,1,0,1
58195065,1,0,0,0,1
58225649,1,0,0,0,1
58389104,1,0,0,0,1
58533091,0,0,1,0,1
58528354,1,0,0,0,1
58478676,0,0,1,0,1
58467654,0,0,1,0,1
58437137,1,0,0,0,1
58405281,1,0,0,0,1
58389790,1,0,0,0,1
58388047,0,0,1,0,1
58228630,0,0,1,0,1
58387459,1,0,0,0,1
58344344,0,0,1,0,1
58338593,0,0,1,0,1
58271557,1,0,0,0,1
58254306,1,0,0,0,1
58249123,0,0,1,0,1
58237695,0,0,1,0,1
57890723,0,0,1,0,1
57885166,0,0,1,0,1
57865986,1,0,0,0,1
57401970,1,0,0,0,1
57517386,0,0,1,0,1
57484031,0,0,1,0,1
57470846,1,0,0,0,1
57460097,0,0,1,0,1
57457584,1,0,0,0,1
57435629,1,0,0,0,1
57412032,1,0,0,0,1
57399783,1,0,0,0,1
57549945,0,0,1,0,1
57398859,0,0,1,0,1
57361562,1,0,0,0,1
57339374,0,0,0,1,1
57336940,1,0,0,0,1
57322447,1,0,0,0,1
57309568,0,0,1,0,1
57306556,0,0,1,0,1
57528994,0,0,1,0,1
57550727,1,0,0,0,1
57821225,1,0,0,0,1
57675402,1,0,0,0,1
57793192,0,0,1,0,1
57786447,1,0,0,0,1
57769225,1,0,0,0,1
57768478,0,0,1,0,1
57755346,1,0,0,0,1
57724903,1,0,0,0,1
57699301,1,0,0,0,1
57642882,1,0,0,0,1
57557811,1,0,0,0,1
57630325,0,0,1,0,1
57616117,1,0,0,0,1
57585972,1,0,0,0,1
57573249,1,0,0,0,1
57571805,0,0,1,0,1
57567136,1,0,0,0,1
57566190,1,0,0,0,1
61592660,0,0,1,0,1
61678511,0,0,1,0,1
67826911,1,0,0,0,1
65747874,1,0,0,0,1
66064924,0,0,1,0,1
66051549,0,0,1,0,1
66049051,1,0,0,0,1
65979492,1,0,0,0,1
65977070,1,0,0,0,1
65971028,1,0,0,0,1
65968828,1,0,0,0,1
65925820,1,0,0,0,1
65905028,1,0,0,0,1
65884381,0,0,1,0,1
65819664,1,0,0,0,1
65797727,1,0,0,0,1
65786525,0,0,1,0,1
65785703,0,0,1,0,1
65775049,1,0,0,0,1
65770853,0,0,1,0,1
65763071,1,0,0,0,1
66096509,1,0,0,0,1
66114992,0,0,1,0,1
66120210,1,0,0,0,1
66269338,0,0,1,0,1
66464301,1,0,0,0,1
66451784,1,0,0,0,1
66394132,1,0,0,0,1
66383919,0,0,1,0,1
66371088,1,0,0,0,1
66363020,1,0,0,0,1
66271966,1,0,0,0,1
66266373,1,0,0,0,1
66154865,1,0,0,0,1
66245995,0,0,1,0,1
66240027,1,0,0,0,1
66231678,0,0,1,0,1
66194217,1,0,0,0,1
66191982,0,0,1,0,1
66182162,1,0,0,0,1
66173032,1,0,0,0,1
65760387,1,0,0,0,1
65735083,1,0,0,0,1
66480106,1,0,0,0,1
65727695,1,0,0,0,1
65364483,1,0,0,0,1
65354277,0,0,1,0,1
65319038,1,0,0,0,1
65304194,1,0,0,0,1
65294078,1,0,0,0,1
65283625,1,0,0,0,1
65276063,0,0,1,0,1
65257571,0,0,1,0,1
65250625,0,0,1,0,1
65119217,0,0,1,0,1
65112370,0,0,1,0,1
65093286,0,0,1,0,1
65061161,0,0,1,0,1
65057965,0,0,1,0,1
64967307,0,0,1,0,1
64948443,0,0,1,0,1
64938416,1,0,0,0,1
65375828,1,0,0,0,1
65415391,0,0,1,0,1
65476654,0,0,1,0,1
65625445,1,0,0,0,1
65690091,1,0,0,0,1
65680581,1,0,0,0,1
65679790,0,0,0,1,1
65678148,1,0,0,0,1
65672074,1,0,0,0,1
65670239,1,0,0,0,1
65639106,1,0,0,0,1
65598016,0,0,1,0,1
65482154,0,0,1,0,1
65590212,1,0,0,0,1
65529583,1,0,0,0,1
65527002,0,0,1,0,1
65519019,1,0,0,0,1
65513259,0,0,1,0,1
65511189,0,0,1,0,1
65483041,1,0,0,0,1
66469868,0,0,1,0,1
66501870,1,0,0,0,1
61693856,1,0,0,0,1
67054959,0,0,1,0,1
67280917,1,0,0,0,1
67274316,1,0,0,0,1
67258884,1,0,0,0,1
67226812,1,0,0,0,1
67225718,0,0,1,0,1
67213712,1,0,0,0,1
67186748,0,0,1,0,1
67129472,1,0,0,0,1
67127998,0,0,1,0,1
67126282,0,0,1,0,1
67118749,1,0,0,0,1
67103923,0,0,1,0,1
67097911,1,0,0,0,1
67073604,0,0,1,0,1
67073298,1,0,0,0,1
67067520,1,0,0,0,1
67062142,1,0,0,0,1
67292058,1,0,0,0,1
67336825,1,0,0,0,1
67345821,1,0,0,0,1
67493763,0,0,1,0,1
67781861,0,0,1,0,1
67730849,1,0,0,0,1
67677095,0,0,1,0,1
67674810,1,0,0,0,1
67666629,1,0,0,0,1
67661003,0,0,1,0,1
67640934,0,0,1,0,1
67480949,1,0,0,0,1
67359538,0,0,1,0,1
67452942,1,0,0,0,1
67439911,1,0,0,0,1
67403262,1,0,0,0,1
67376966,0,0,1,0,1
67375976,1,0,0,0,1
67375050,0,0,1,0,1
67373899,1,0,0,0,1
67060020,0,0,1,0,1
66993395,1,0,0,0,1
66506938,1,0,0,0,1
66987805,1,0,0,0,1
66765288,1,0,0,0,1
66757117,1,0,0,0,1
66744930,1,0,0,0,1
66744439,1,0,0,0,1
66734502,0,0,1,0,1
66734347,1,0,0,0,1
66711185,0,0,1,0,1
66649328,1,0,0,0,1
66646332,0,0,1,0,1
66638172,1,0,0,0,1
66614646,0,0,1,0,1
66604973,1,0,0,0,1
66602200,0,0,1,0,1
66596852,1,0,0,0,1
66574216,0,0,1,0,1
66566329,1,0,0,0,1
66508607,1,0,0,0,1
66798529,0,0,1,0,1
66807700,1,0,0,0,1
66810906,1,0,0,0,1
66949758,1,0,0,0,1
66977773,1,0,0,0,1
66961768,0,0,1,0,1
66961568,1,0,0,0,1
66961444,0,0,1,0,1
66960766,0,0,1,0,1
66959637,0,0,1,0,1
66952005,1,0,0,0,1
66943499,1,0,0,0,1
66811488,0,0,1,0,1
66930690,1,0,0,0,1
66919869,1,0,0,0,1
66915031,0,0,1,0,1
66842467,1,0,0,0,1
66829262,0,0,1,0,1
66828186,1,0,0,0,1
66823224,0,0,1,0,1
64934891,0,0,1,0,1
64921358,0,0,1,0,1
64892392,1,0,0,0,1
62401393,1,0,0,0,1
62773733,1,0,0,0,1
62736996,1,0,0,0,1
62701284,1,0,0,0,1
62700049,1,0,0,0,1
62685070,0,0,1,0,1
62680545,1,0,0,0,1
62661922,1,0,0,0,1
62644193,0,0,1,0,1
62639334,0,0,1,0,1
62634333,1,0,0,0,1
62633968,1,0,0,0,1
62627585,1,0,0,0,1
62604251,0,0,1,0,1
62542739,1,0,0,0,1
62542300,0,0,1,0,1
62530335,1,0,0,0,1
62434703,1,0,0,0,1
62776991,0,0,1,0,1
62777136,1,0,0,0,1
62785237,1,0,0,0,1
62961405,1,0,0,0,1
63162150,1,0,0,0,1
63160119,0,0,1,0,1
63119251,1,0,0,0,1
63026371,0,0,0,1,1
63006814,1,0,0,0,1
63002307,0,0,1,0,1
62966059,0,0,1,0,1
62945221,1,0,0,0,1
62792657,1,0,0,0,1
62939516,1,0,0,0,1
62927172,1,0,0,0,1
62915940,0,0,1,0,1
62856399,1,0,0,0,1
62852828,0,0,1,0,1
62850707,1,0,0,0,1
62839932,1,0,0,0,1
62409721,0,0,1,0,1
62359474,1,0,0,0,1
64837680,0,0,1,0,1
62335395,0,0,0,1,1
61999615,1,0,0,0,1
61981690,1,0,0,0,1
61980894,1,0,0,0,1
61978844,1,0,0,0,1
61938683,1,0,0,0,1
61872828,0,0,1,0,1
61871945,0,0,1,0,1
61851697,1,0,0,0,1
61851470,0,0,1,0,1
61846222,1,0,0,0,1
61841390,1,0,0,0,1
61800014,1,0,0,0,1
61740974,0,0,1,0,1
61723596,1,0,0,0,1
61719199,1,0,0,0,1
61714417,1,0,0,0,1
61699814,1,0,0,0,1
62001039,1,0,0,0,1
62014210,0,0,1,0,1
62017774,1,0,0,0,1
62225580,1,0,0,0,1
62328018,0,0,1,0,1
62320186,1,0,0,0,1
62317991,1,0,0,0,1
62298504,0,0,1,0,1
62285182,1,0,0,0,1
62271374,1,0,0,0,1
62258958,0,0,1,0,1
62192916,1,0,0,0,1
62047190,0,0,1,0,1
62165573,1,0,0,0,1
62133767,0,0,1,0,1
62130666,1,0,0,0,1
62126843,1,0,0,0,1
62093920,0,0,1,0,1
62058232,0,0,1,0,1
62048197,1,0,0,0,1
63189467,0,0,1,0,1
63199008,0,0,1,0,1
63250606,1,0,0,0,1
63260432,0,0,1,0,1
64534798,1,0,0,0,1
64528384,0,0,1,0,1
64504098,1,0,0,0,1
64484703,1,0,0,0,1
64484642,0,0,1,0,1
64480098,1,0,0,0,1
64411228,0,0,1,0,1
64334867,0,0,1,0,1
64323488,1,0,0,0,1
64312229,0,0,1,0,1
64309148,1,0,0,0,1
64247710,0,0,1,0,1
64206316,0,0,1,0,1
64182621,1,0,0,0,1
64172780,0,0,1,0,1
64170751,0,0,1,0,1
64127897,0,0,1,0,1
64540550,0,0,1,0,1
64542737,1,0,0,0,1
64565460,1,0,0,0,1
64750544,1,0,0,0,1
64837317,1,0,0,0,1
64831019,0,0,1,0,1
64813922,1,0,0,0,1
64784962,1,0,0,0,1
64777265,1,0,0,0,1
64765550,1,0,0,0,1
64759023,1,0,0,0,1
64748382,0,0,1,0,1
64568425,1,0,0,0,1
64694321,1,0,0,0,1
64678522,1,0,0,0,1
64676041,1,0,0,0,1
64652921,1,0,0,0,1
64652749,0,0,1,0,1
64648495,1,0,0,0,1
64579750,1,0,0,0,1
64111588,1,0,0,0,1
64109887,0,0,1,0,1
64107217,0,0,1,0,1
63419128,0,0,1,0,1
63623329,0,0,1,0,1
63616247,1,0,0,0,1
63544396,1,0,0,0,1
63544192,0,0,1,0,1
63513695,1,0,0,0,1
63510347,1,0,0,0,1
63506844,1,0,0,0,1
63389796,1,0,0,0,1
63729602,0,0,0,1,1
63361875,0,0,1,0,1
63311662,1,0,0,0,1
63294576,1,0,0,0,1
63281532,1,0,0,0,1
63273681,0,0,1,0,1
63269523,1,0,0,0,1
63266842,1,0,0,0,1
63671528,0,0,1,0,1
63731117,1,0,0,0,1
64098159,1,0,0,0,1
63949298,1,0,0,0,1
64091336,1,0,0,0,1
64076428,1,0,0,0,1
64060155,0,0,1,0,1
64008392,1,0,0,0,1
63986235,0,0,1,0,1
63955681,1,0,0,0,1
63953718,0,0,1,0,1
63943922,0,0,1,0,1
63790712,0,0,1,0,1
63935825,1,0,0,0,1
63935474,0,0,1,0,1
63930670,0,0,1,0,1
63928471,0,0,1,0,1
63896964,1,0,0,0,1
63866600,0,0,1,0,1
63800453,0,0,1,0,1
81865543,0,0,1,0,1
81939249,0,0,1,0,1
122044489,0,0,1,0,1
106763705,0,0,1,0,1
107161778,0,0,1,0,1
107158006,0,0,1,0,1
107140603,0,0,1,0,1
107136259,1,0,0,0,1
107090124,1,0,0,0,1
107075450,0,0,1,0,1
107058927,0,0,1,0,1
107034314,1,0,0,0,1
106977720,0,0,1,0,1
106963874,0,0,1,0,1
106955062,1,0,0,0,1
106949780,1,0,0,0,1
106948134,0,0,1,0,1
106940781,0,0,1,0,1
106863782,1,0,0,0,1
106816918,0,0,1,0,1
106783508,0,0,1,0,1
107177664,0,0,1,0,1
107177716,1,0,0,0,1
107179840,1,0,0,0,1
107416436,0,0,1,0,1
107578176,0,0,1,0,1
107548612,1,0,0,0,1
107516522,1,0,0,0,1
107507766,1,0,0,0,1
107459717,1,0,0,0,1
107437866,1,0,0,0,1
107417836,1,0,0,0,1
107398940,1,0,0,0,1
107188703,1,0,0,0,1
107374902,1,0,0,0,1
107366016,0,0,1,0,1
107299996,1,0,0,0,1
107294313,1,0,0,0,1
107234799,0,0,1,0,1
107208678,1,0,0,0,1
107192991,1,0,0,0,1
106766048,0,0,1,0,1
106746084,0,0,1,0,1
107603094,0,0,1,0,1
106742582,1,0,0,0,1
106309624,1,0,0,0,1
106291193,0,0,1,0,1
106282931,1,0,0,0,1
106269510,1,0,0,0,1
106265221,1,0,0,0,1
106241822,0,0,1,0,1
106233552,1,0,0,0,1
106197850,0,0,1,0,1
106193743,1,0,0,0,1
106168229,0,0,1,0,1
106159574,0,0,1,0,1
106155865,0,0,1,0,1
106130636,0,0,1,0,1
106077181,1,0,0,0,1
106068562,0,0,1,0,1
106063627,1,0,0,0,1
106046570,0,0,1,0,1
106317729,1,0,0,0,1
106321136,0,0,1,0,1
106401814,1,0,0,0,1
106550420,1,0,0,0,1
106723044,0,0,1,0,1
106714852,1,0,0,0,1
106692652,0,0,1,0,1
106687475,0,0,1,0,1
106667600,0,0,1,0,1
106633183,1,0,0,0,1
106555852,0,0,1,0,1
106546614,0,0,1,0,1
106405713,0,0,1,0,1
106538072,1,0,0,0,1
106508052,1,0,0,0,1
106451051,0,0,1,0,1
106445337,0,0,1,0,1
106442885,1,0,0,0,1
106434970,1,0,0,0,1
106407359,0,0,1,0,1
107579819,0,0,1,0,1
107649924,1,0,0,0,1
110191144,0,0,1,0,1
108781530,0,0,1,0,1
109527682,0,0,1,0,1
109498113,1,0,0,0,1
109479467,0,0,1,0,1
109448921,1,0,0,0,1
109442039,1,0,0,0,1
109371945,0,0,1,0,1
109306113,1,0,0,0,1
109276977,1,0,0,0,1
109228430,1,0,0,0,1
109196702,0,0,1,0,1
109162710,0,0,1,0,1
109142193,0,0,1,0,1
109074907,1,0,0,0,1
109033183,0,0,1,0,1
108960673,0,0,1,0,1
108922928,0,0,1,0,1
108836422,0,0,1,0,1
109567034,1,0,0,0,1
109594651,0,0,1,0,1
109660521,0,0,1,0,1
110001729,1,0,0,0,1
110168252,0,0,1,0,1
110142237,1,0,0,0,1
110062117,1,0,0,0,1
110058188,0,0,1,0,1
110049608,1,0,0,0,1
110041840,0,0,1,0,1
110031106,0,0,1,0,1
109931171,0,0,1,0,1
109705262,1,0,0,0,1
109909474,1,0,0,0,1
109861244,0,0,1,0,1
109859103,1,0,0,0,1
109853394,1,0,0,0,1
109828555,1,0,0,0,1
109733032,0,0,1,0,1
109716638,0,0,1,0,1
108786369,1,0,0,0,1
108768156,0,0,1,0,1
107670361,0,0,1,0,1
108614805,0,0,1,0,1
108055585,1,0,0,0,1
108030899,1,0,0,0,1
108009985,1,0,0,0,1
107978473,1,0,0,0,1
107963058,1,0,0,0,1
107960898,1,0,0,0,1
107952354,1,0,0,0,1
107939984,1,0,0,0,1
107933494,1,0,0,0,1
107930075,0,0,1,0,1
107883536,1,0,0,0,1
107833451,1,0,0,0,1
107830761,0,0,1,0,1
107778395,0,0,1,0,1
107712560,0,0,1,0,1
107712101,1,0,0,0,1
107704855,0,0,1,0,1
108061424,0,0,1,0,1
108133340,0,0,1,0,1
108150300,0,0,1,0,1
108357210,0,0,1,0,1
108605013,1,0,0,0,1
108578737,0,0,1,0,1
108550734,1,0,0,0,1
108457539,0,0,1,0,1
108448613,0,0,1,0,1
108435759,1,0,0,0,1
108433379,1,0,0,0,1
108351464,1,0,0,0,1
108162636,0,0,1,0,1
108302188,0,0,1,0,1
108272855,1,0,0,0,1
108252768,0,0,1,0,1
108197310,1,0,0,0,1
108188109,0,0,1,0,1
108168953,0,0,1,0,1
108164496,1,0,0,0,1
106043391,0,0,1,0,1
106040031,0,0,1,0,1
106030531,1,0,0,0,1
103035237,1,0,0,0,1
103678761,1,0,0,0,1
103634445,0,0,1,0,1
103611863,0,0,1,0,1
103605111,0,0,1,0,1
103597496,1,0,0,0,1
103555336,1,0,0,0,1
103545877,1,0,0,0,1
103434234,1,0,0,0,1
103411445,0,0,1,0,1
103380674,0,0,1,0,1
103361884,0,0,1,0,1
103349564,1,0,0,0,1
103336088,1,0,0,0,1
103283875,1,0,0,0,1
103265024,0,0,0,1,1
103170539,0,0,1,0,1
103163218,1,0,0,0,1
103683608,0,0,1,0,1
103714371,1,0,0,0,1
103737324,1,0,0,0,1
103995602,1,0,0,0,1
104151293,1,0,0,0,1
104149113,1,0,0,0,1
104117770,1,0,0,0,1
104068811,1,0,0,0,1
104060705,1,0,0,0,1
104035649,0,0,1,0,1
103999478,1,0,0,0,1
103981529,1,0,0,0,1
103738833,1,0,0,0,1
103922915,1,0,0,0,1
103909781,1,0,0,0,1
103896024,1,0,0,0,1
103883083,0,0,1,0,1
103862923,1,0,0,0,1
103818938,1,0,0,0,1
103745233,0,0,1,0,1
103141818,1,0,0,0,1
103025654,1,0,0,0,1
106018910,0,0,1,0,1
103020905,0,0,1,0,1
102478101,1,0,0,0,1
102421207,1,0,0,0,1
102415020,1,0,0,0,1
102413571,0,0,1,0,1
102367813,0,0,1,0,1
102358867,1,0,0,0,1
102336774,0,0,1,0,1
102294498,1,0,0,0,1
102287990,0,0,1,0,1
102274565,1,0,0,0,1
102251846,1,0,0,0,1
102228163,1,0,0,0,1
102218558,0,0,1,0,1
102212764,1,0,0,0,1
102180676,0,0,1,0,1
102103075,0,0,0,1,1
102080453,1,0,0,0,1
102482048,0,0,1,0,1
102495774,0,0,1,0,1
102498043,1,0,0,0,1
102754726,1,0,0,0,1
103019971,1,0,0,0,1
102890266,1,0,0,0,1
102888703,1,0,0,0,1
102886686,1,0,0,0,1
102866746,1,0,0,0,1
102841376,0,0,1,0,1
102833442,1,0,0,0,1
102731382,1,0,0,0,1
102500495,1,0,0,0,1
102685703,0,0,1,0,1
102648941,1,0,0,0,1
102599996,0,0,1,0,1
102542851,0,0,1,0,1
102537337,0,0,1,0,1
102535503,1,0,0,0,1
102526590,1,0,0,0,1
104157084,0,0,0,1,1
104188124,1,0,0,0,1
104222590,0,0,1,0,1
104228825,1,0,0,0,1
105620723,1,0,0,0,1
105596615,1,0,0,0,1
105572926,0,0,1,0,1
105572605,1,0,0,0,1
105513623,1,0,0,0,1
105497516,0,0,1,0,1
105465646,1,0,0,0,1
105462484,1,0,0,0,1
105461266,1,0,0,0,1
105447387,0,0,1,0,1
105394139,1,0,0,0,1
105372357,0,0,1,0,1
105346006,0,0,1,0,1
105324082,1,0,0,0,1
105315535,1,0,0,0,1
105279602,1,0,0,0,1
105270072,1,0,0,0,1
105629983,0,0,1,0,1
105634248,1,0,0,0,1
105640471,1,0,0,0,1
105758291,1,0,0,0,1
105956343,1,0,0,0,1
105935463,0,0,1,0,1
105828057,0,0,1,0,1
105813928,0,0,1,0,1
105763296,1,0,0,0,1
105758693,1,0,0,0,1
105758386,1,0,0,0,1
105737629,0,0,1,0,1
105644109,1,0,0,0,1
105717256,1,0,0,0,1
105707375,1,0,0,0,1
105699183,1,0,0,0,1
105692628,1,0,0,0,1
105687783,1,0,0,0,1
105672251,0,0,1,0,1
105668518,0,0,1,0,1
105239473,0,0,1,0,1
105228678,1,0,0,0,1
105225699,1,0,0,0,1
104558512,1,0,0,0,1
104781467,1,0,0,0,1
104775467,0,0,0,1,1
104698038,0,0,1,0,1
104695696,0,0,1,0,1
104691618,1,0,0,0,1
104684975,1,0,0,0,1
104661811,0,0,1,0,1
104531078,0,0,1,0,1
104821930,1,0,0,0,1
104497453,0,0,1,0,1
104450469,0,0,1,0,1
104423008,0,0,1,0,1
104401765,1,0,0,0,1
104353777,1,0,0,0,1
104351616,0,0,1,0,1
104262874,0,0,0,1,1
104787732,1,0,0,0,1
104911818,0,0,1,0,1
105162882,0,0,1,0,1
105075265,0,0,1,0,1
105154396,1,0,0,0,1
105150325,1,0,0,0,1
105144312,1,0,0,0,1
105139019,0,0,1,0,1
105130665,1,0,0,0,1
105124052,0,0,1,0,1
105120761,0,0,1,0,1
105056232,1,0,0,0,1
104921994,1,0,0,0,1
105048475,1,0,0,0,1
104967836,1,0,0,0,1
104960784,0,0,1,0,1
104947454,1,0,0,0,1
104944916,1,0,0,0,1
104925528,0,0,1,0,1
104924792,0,0,1,0,1
110175454,1,0,0,0,1
110205987,1,0,0,0,1
102016115,1,0,0,0,1
118099404,1,0,0,0,1
118770743,1,0,0,0,1
118697704,1,0,0,0,1
118672543,0,0,1,0,1
118659557,0,0,1,0,1
118554120,1,0,0,0,1
118547015,1,0,0,0,1
118433712,1,0,0,0,1
118430352,0,0,1,0,1
118404940,1,0,0,0,1
118389135,1,0,0,0,1
118367648,0,0,1,0,1
118366948,1,0,0,0,1
118276455,1,0,0,0,1
118270996,0,0,1,0,1
118248883,1,0,0,0,1
118199454,0,0,1,0,1
118114072,1,0,0,0,1
118839768,0,0,0,1,1
118905457,1,0,0,0,1
118913632,1,0,0,0,1
119531605,0,0,1,0,1
119737270,0,0,1,0,1
119680716,0,0,1,0,1
119673533,1,0,0,0,1
119651060,0,0,1,0,1
119645121,1,0,0,0,1
119609345,1,0,0,0,1
119548006,1,0,0,0,1
119530858,1,0,0,0,1
118983907,1,0,0,0,1
119341880,1,0,0,0,1
119313407,1,0,0,0,1
119294198,0,0,1,0,1
119260265,0,0,1,0,1
119188725,0,0,1,0,1
119125703,1,0,0,0,1
119070668,1,0,0,0,1
118110284,1,0,0,0,1
117999420,0,0,1,0,1
119826595,1,0,0,0,1
117995649,1,0,0,0,1
117086989,1,0,0,0,1
117035626,1,0,0,0,1
117027704,1,0,0,0,1
116995217,1,0,0,0,1
116992515,1,0,0,0,1
116976293,1,0,0,0,1
116914541,1,0,0,0,1
116871769,0,0,1,0,1
116854478,1,0,0,0,1
116758734,0,0,1,0,1
116747751,0,0,1,0,1
116703956,0,0,1,0,1
116634792,0,0,1,0,1
116596381,1,0,0,0,1
116589400,1,0,0,0,1
116460196,0,0,1,0,1
116411135,0,0,1,0,1
117148217,1,0,0,0,1
117258312,1,0,0,0,1
117317499,1,0,0,0,1
117563787,1,0,0,0,1
117851567,0,0,1,0,1
117842223,1,0,0,0,1
117792931,1,0,0,0,1
117742969,1,0,0,0,1
117661879,1,0,0,0,1
117645326,0,0,1,0,1
117633494,1,0,0,0,1
117543014,0,0,1,0,1
117341696,1,0,0,0,1
117530860,0,0,1,0,1
117507630,1,0,0,0,1
117498033,0,0,1,0,1
117478572,1,0,0,0,1
117399779,0,0,1,0,1
117385673,0,0,1,0,1
117378121,1,0,0,0,1
119787924,0,0,1,0,1
119828457,1,0,0,0,1
110218367,0,0,1,0,1
120761466,0,0,1,0,1
121355766,0,0,1,0,1
121352443,0,0,1,0,1
121333825,1,0,0,0,1
121205642,1,0,0,0,1
121187937,0,0,1,0,1
121180167,1,0,0,0,1
121141615,0,0,1,0,1
121141431,1,0,0,0,1
121093001,1,0,0,0,1
121083075,0,0,1,0,1
120989542,0,0,1,0,1
120981856,1,0,0,0,1
120957439,1,0,0,0,1
120821933,1,0,0,0,1
120813796,1,0,0,0,1
120813240,1,0,0,0,1
120810666,1,0,0,0,1
121369530,0,0,1,0,1
121370311,1,0,0,0,1
121392618,1,0,0,0,1
121861644,1,0,0,0,1
122028274,0,0,1,0,1
122028248,1,0,0,0,1
121927736,1,0,0,0,1
121926104,0,0,1,0,1
121917551,1,0,0,0,1
121909760,0,0,1,0,1
121869120,1,0,0,0,1
121842697,1,0,0,0,1
121431667,1,0,0,0,1
121802962,0,0,1,0,1
121732047,0,0,1,0,1
121713773,0,0,1,0,1
121705027,0,0,1,0,1
121578156,1,0,0,0,1
121522137,1,0,0,0,1
121434641,1,0,0,0,1
120779133,1,0,0,0,1
120745552,1,0,0,0,1
119829743,1,0,0,0,1
120725189,1,0,0,0,1
120181746,1,0,0,0,1
120169401,0,0,1,0,1
120158738,1,0,0,0,1
120137482,0,0,1,0,1
120115594,1,0,0,0,1
120105664,0,0,1,0,1
120047243,0,0,1,0,1
120010130,0,0,1,0,1
119952908,0,0,1,0,1
119941037,0,0,1,0,1
119939880,0,0,1,0,1
119926735,1,0,0,0,1
119920535,1,0,0,0,1
119908176,1,0,0,0,1
119900854,1,0,0,0,1
119847900,0,0,1,0,1
119846581,1,0,0,0,1
120231560,0,0,1,0,1
120245256,0,0,1,0,1
120247927,0,0,1,0,1
120561772,0,0,1,0,1
120715669,1,0,0,0,1
120680778,1,0,0,0,1
120638903,1,0,0,0,1
120622978,1,0,0,0,1
120574445,0,0,1,0,1
120567225,1,0,0,0,1
120567010,0,0,1,0,1
120551798,1,0,0,0,1
120267512,1,0,0,0,1
120466306,0,0,1,0,1
120456470,1,0,0,0,1
120431726,0,0,1,0,1
120393659,1,0,0,0,1
120343382,1,0,0,0,1
120297125,0,0,1,0,1
120296922,1,0,0,0,1
116396065,1,0,0,0,1
116388678,0,0,1,0,1
116365995,1,0,0,0,1
111663504,1,0,0,0,1
112573606,1,0,0,0,1
112522169,1,0,0,0,1
112439486,1,0,0,0,1
112420628,1,0,0,0,1
112341991,0,0,1,0,1
112318272,0,0,1,0,1
112316568,0,0,1,0,1
112273279,0,0,0,1,1
112176192,1,0,0,0,1
112165371,1,0,0,0,1
112142263,1,0,0,0,1
112127289,0,0,1,0,1
111997177,0,0,1,0,1
111970954,0,0,1,0,1
111816745,1,0,0,0,1
111798802,1,0,0,0,1
111782745,0,0,0,1,1
112771543,1,0,0,0,1
112820798,1,0,0,0,1
112843970,1,0,0,0,1
113146341,0,0,1,0,1
113432737,0,0,1,0,1
113409633,0,0,1,0,1
113399802,0,0,1,0,1
113356258,0,0,1,0,1
113274391,1,0,0,0,1
113260524,1,0,0,0,1
113198009,0,0,1,0,1
113121666,1,0,0,0,1
112871914,0,0,1,0,1
113113202,0,0,1,0,1
113110121,1,0,0,0,1
113058525,0,0,1,0,1
113055692,1,0,0,0,1
112963302,1,0,0,0,1
112955604,0,0,1,0,1
112954746,1,0,0,0,1
111768943,1,0,0,0,1
111626793,1,0,0,0,1
116270251,0,0,1,0,1
111624886,0,0,1,0,1
110786804,1,0,0,0,1
110708643,1,0,0,0,1
110686573,1,0,0,0,1
110674731,0,0,1,0,1
110605462,0,0,1,0,1
110539055,0,0,1,0,1
110520215,0,0,1,0,1
110478816,1,0,0,0,1
110448579,1,0,0,0,1
110372496,1,0,0,0,1
110367811,1,0,0,0,1
110358650,1,0,0,0,1
110348515,0,0,1,0,1
110346058,0,0,1,0,1
110336691,0,0,1,0,1
110321529,1,0,0,0,1
110290187,1,0,0,0,1
110825940,1,0,0,0,1
110872398,0,0,1,0,1
110888907,1,0,0,0,1
111298791,0,0,1,0,1
111599325,1,0,0,0,1
111480022,1,0,0,0,1
111451636,0,0,1,0,1
111433024,0,0,1,0,1
111428431,1,0,0,0,1
111327104,1,0,0,0,1
111314249,1,0,0,0,1
111294103,0,0,1,0,1
110900012,0,0,1,0,1
111262060,0,0,1,0,1
111208718,0,0,1,0,1
111187966,0,0,1,0,1
111020045,0,0,1,0,1
110966607,0,0,1,0,1
110907551,0,0,1,0,1
110902412,1,0,0,0,1
113454728,0,0,1,0,1
113460991,1,0,0,0,1
113471507,1,0,0,0,1
113542014,1,0,0,0,1
115546121,1,0,0,0,1
115424426,0,0,1,0,1
115415316,0,0,1,0,1
115395049,0,0,1,0,1
115355850,1,0,0,0,1
115307231,0,0,1,0,1
115259709,1,0,0,0,1
115227524,0,0,1,0,1
115204320,1,0,0,0,1
115168723,0,0,1,0,1
115167208,1,0,0,0,1
115151548,0,0,1,0,1
115084419,1,0,0,0,1
114914498,0,0,1,0,1
114894062,1,0,0,0,1
114891780,1,0,0,0,1
114890218,1,0,0,0,1
115589496,1,0,0,0,1
115592163,0,0,1,0,1
115638902,0,0,1,0,1
115939440,1,0,0,0,1
116238997,1,0,0,0,1
116238574,0,0,1,0,1
116171108,0,0,1,0,1
116160665,0,0,1,0,1
116052575,0,0,1,0,1
115994238,0,0,1,0,1
115939890,0,0,1,0,1
115929612,0,0,1,0,1
115670216,1,0,0,0,1
115879887,0,0,1,0,1
115854410,1,0,0,0,1
115845698,0,0,1,0,1
115819687,0,0,1,0,1
115819396,0,0,1,0,1
115688056,0,0,1,0,1
115671542,1,0,0,0,1
114883980,1,0,0,0,1
114877351,1,0,0,0,1
114867228,1,0,0,0,1
113905011,1,0,0,0,1
114027049,0,0,0,1,1
114017434,0,0,1,0,1
114008316,1,0,0,0,1
113927793,1,0,0,0,1
113924874,1,0,0,0,1
113911279,1,0,0,0,1
113909496,0,0,1,0,1
113890236,0,0,1,0,1
114071959,0,0,1,0,1
113854049,1,0,0,0,1
113710437,0,0,1,0,1
113682832,0,0,1,0,1
113585636,1,0,0,0,1
113569756,1,0,0,0,1
113565208,0,0,1,0,1
113558977,0,0,1,0,1
114048818,0,0,1,0,1
114075917,0,0,1,0,1
114851446,1,0,0,0,1
114502772,0,0,1,0,1
114811999,1,0,0,0,1
114713624,0,0,1,0,1
114673570,0,0,1,0,1
114596544,1,0,0,0,1
114523254,0,0,1,0,1
114521467,1,0,0,0,1
114515350,1,0,0,0,1
114418657,0,0,1,0,1
114128146,1,0,0,0,1
114416273,1,0,0,0,1
114413305,0,0,1,0,1
114410100,0,0,1,0,1
114351542,0,0,1,0,1
114249746,0,0,1,0,1
114216175,1,0,0,0,1
114178347,0,0,0,1,1
102071949,1,0,0,0,1
102015407,1,0,0,0,1
81952746,1,0,0,0,1
87690038,0,0,1,0,1
88352863,0,0,1,0,1
88351271,0,0,1,0,1
88326021,1,0,0,0,1
88221919,0,0,1,0,1
88219212,1,0,0,0,1
88150433,1,0,0,0,1
88111418,1,0,0,0,1
88059414,1,0,0,0,1
88034180,0,0,1,0,1
88022215,1,0,0,0,1
88011030,1,0,0,0,1
87967262,0,0,1,0,1
87915374,0,0,1,0,1
87859431,1,0,0,0,1
87835557,1,0,0,0,1
87833104,1,0,0,0,1
87830896,0,0,1,0,1
88381792,1,0,0,0,1
88384901,0,0,1,0,1
88387391,0,0,1,0,1
88673989,1,0,0,0,1
88799471,0,0,1,0,1
88787567,0,0,1,0,1
88774551,0,0,1,0,1
88763572,0,0,1,0,1
88744147,1,0,0,0,1
88713943,1,0,0,0,1
88681982,1,0,0,0,1
88657097,1,0,0,0,1
88394152,1,0,0,0,1
88602231,1,0,0,0,1
88585692,0,0,1,0,1
88560244,1,0,0,0,1
88484548,0,0,1,0,1
88470654,1,0,0,0,1
88465311,1,0,0,0,1
88400958,0,0,1,0,1
87794273,0,0,1,0,1
87680800,0,0,1,0,1
88827012,0,0,1,0,1
87628339,0,0,1,0,1
87093714,1,0,0,0,1
87041889,1,0,0,0,1
86982839,1,0,0,0,1
86973566,0,0,1,0,1
86957449,0,0,1,0,1
86924880,1,0,0,0,1
86892036,0,0,1,0,1
86847270,0,0,1,0,1
86837447,1,0,0,0,1
86813128,0,0,1,0,1
86786513,1,0,0,0,1
86769590,1,0,0,0,1
86669699,1,0,0,0,1
86640102,1,0,0,0,1
86592511,1,0,0,0,1
86576234,0,0,1,0,1
86575720,1,0,0,0,1
87120461,1,0,0,0,1
87156911,1,0,0,0,1
87167456,0,0,1,0,1
87505316,0,0,1,0,1
87612379,1,0,0,0,1
87601935,1,0,0,0,1
87588590,0,0,1,0,1
87563454,1,0,0,0,1
87546977,1,0,0,0,1
87541218,0,0,1,0,1
87519942,1,0,0,0,1
87497118,1,0,0,0,1
87236554,0,0,1,0,1
87474067,0,0,1,0,1
87428324,0,0,1,0,1
87399999,0,0,1,0,1
87339569,0,0,1,0,1
87326432,0,0,0,1,1
87312106,0,0,1,0,1
87241639,0,0,1,0,1
88814777,1,0,0,0,1
88861099,0,0,1,0,1
91002349,0,0,0,1,1
90130659,0,0,1,0,1
90513280,0,0,1,0,1
90474603,1,0,0,0,1
90450107,0,0,1,0,1
90417316,0,0,1,0,1
90359139,1,0,0,0,1
90333053,1,0,0,0,1
90285941,1,0,0,0,1
90279905,0,0,1,0,1
90270616,1,0,0,0,1
90255286,1,0,0,0,1
90254843,1,0,0,0,1
90237608,0,0,1,0,1
90230216,1,0,0,0,1
90227099,1,0,0,0,1
90219307,1,0,0,0,1
90215210,0,0,1,0,1
90144524,0,0,1,0,1
90531953,0,0,1,0,1
90632607,1,0,0,0,1
90633806,1,0,0,0,1
90748448,0,0,1,0,1
90893179,0,0,1,0,1
90848714,1,0,0,0,1
90835843,0,0,0,1,1
90797353,1,0,0,0,1
90787064,1,0,0,0,1
90786439,1,0,0,0,1
90771408,0,0,1,0,1
90731801,0,0,1,0,1
90646927,1,0,0,0,1
90713895,0,0,1,0,1
90710149,1,0,0,0,1
90697907,0,0,1,0,1
90689056,0,0,1,0,1
90685499,1,0,0,0,1
90676675,1,0,0,0,1
90655016,1,0,0,0,1
90131587,1,0,0,0,1
90125781,1,0,0,0,1
88884610,1,0,0,0,1
90094546,1,0,0,0,1
89241337,0,0,1,0,1
89236033,1,0,0,0,1
89197711,0,0,1,0,1
89188080,1,0,0,0,1
89106916,1,0,0,0,1
89071431,0,0,1,0,1
89030405,1,0,0,0,1
89022528,1,0,0,0,1
89000911,0,0,1,0,1
88982639,1,0,0,0,1
88976714,1,0,0,0,1
88929878,0,0,1,0,1
88927588,1,0,0,0,1
88922378,1,0,0,0,1
88904682,1,0,0,0,1
88895712,1,0,0,0,1
88891753,0,0,1,0,1
89332421,1,0,0,0,1
89332916,1,0,0,0,1
89351775,1,0,0,0,1
89842859,1,0,0,0,1
90079326,0,0,1,0,1
90058061,0,0,1,0,1
90057034,0,0,1,0,1
90025899,0,0,1,0,1
89873907,0,0,1,0,1
89861903,0,0,1,0,1
89852528,0,0,1,0,1
89691323,1,0,0,0,1
89391604,0,0,1,0,1
89680675,1,0,0,0,1
89594887,1,0,0,0,1
89593001,1,0,0,0,1
89532341,1,0,0,0,1
89526812,0,0,1,0,1
89501678,0,0,1,0,1
89441379,1,0,0,0,1
86568314,1,0,0,0,1
86538929,1,0,0,0,1
86428878,0,0,1,0,1
83076610,1,0,0,0,1
83394328,1,0,0,0,1
83367874,1,0,0,0,1
83351115,0,0,1,0,1
83333226,0,0,1,0,1
83313026,0,0,1,0,1
83278784,1,0,0,0,1
83241139,1,0,0,0,1
83183600,1,0,0,0,1
83182137,1,0,0,0,1
83176398,0,0,1,0,1
83171661,0,0,1,0,1
83170219,0,0,1,0,1
83167380,1,0,0,0,1
83156877,0,0,1,0,1
83142960,0,0,1,0,1
83141510,1,0,0,0,1
83132880,0,0,1,0,1
83476674,0,0,1,0,1
83549989,1,0,0,0,1
83554004,1,0,0,0,1
83903969,0,0,1,0,1
83938323,1,0,0,0,1
83934468,1,0,0,0,1
83933642,1,0,0,0,1
83921231,1,0,0,0,1
83915742,0,0,1,0,1
83909332,1,0,0,0,1
83908657,1,0,0,0,1
83899060,1,0,0,0,1
83604477,1,0,0,0,1
83856521,1,0,0,0,1
83801982,0,0,1,0,1
83652071,0,0,1,0,1
83632643,1,0,0,0,1
83616984,1,0,0,0,1
83615522,0,0,1,0,1
83611052,1,0,0,0,1
83093714,0,0,1,0,1
83061189,1,0,0,0,1
86426042,0,0,1,0,1
83027967,0,0,1,0,1
82412007,0,0,1,0,1
82398975,0,0,1,0,1
82398569,1,0,0,0,1
82331771,1,0,0,0,1
82189528,0,0,1,0,1
82189264,1,0,0,0,1
82187372,0,0,1,0,1
82155561,1,0,0,0,1
82124196,1,0,0,0,1
82096395,0,0,1,0,1
82003805,1,0,0,0,1
81996236,0,0,1,0,1
81987487,1,0,0,0,1
81969334,1,0,0,0,1
81959199,0,0,1,0,1
81954660,1,0,0,0,1
81953225,0,0,1,0,1
82444858,1,0,0,0,1
82487352,0,0,1,0,1
82504767,1,0,0,0,1
82834850,0,0,1,0,1
83004119,1,0,0,0,1
82998484,1,0,0,0,1
82951378,0,0,1,0,1
82921923,1,0,0,0,1
82878914,0,0,1,0,1
82876116,0,0,1,0,1
82866085,1,0,0,0,1
82805482,0,0,1,0,1
82512085,0,0,1,0,1
82740389,1,0,0,0,1
82736848,1,0,0,0,1
82736418,0,0,1,0,1
82736320,1,0,0,0,1
82717014,0,0,1,0,1
82695060,0,0,1,0,1
82562435,0,0,1,0,1
83967077,1,0,0,0,1
83978022,1,0,0,0,1
83996392,0,0,1,0,1
83998998,1,0,0,0,1
85852354,0,0,1,0,1
85846262,1,0,0,0,1
85734571,1,0,0,0,1
85669769,0,0,1,0,1
85656085,1,0,0,0,1
85540746,1,0,0,0,1
85525216,0,0,1,0,1
85518733,1,0,0,0,1
85507826,0,0,1,0,1
85506502,1,0,0,0,1
85462710,1,0,0,0,1
85454114,0,0,1,0,1
85414049,1,0,0,0,1
85400172,0,0,1,0,1
85375602,1,0,0,0,1
85375269,1,0,0,0,1
85316652,0,0,1,0,1
85852882,1,0,0,0,1
85867497,1,0,0,0,1
85898729,0,0,1,0,1
86233928,1,0,0,0,1
86422842,0,0,1,0,1
86415678,1,0,0,0,1
86414330,1,0,0,0,1
86401168,0,0,1,0,1
86400677,1,0,0,0,1
86396141,1,0,0,0,1
86309043,1,0,0,0,1
86213021,0,0,1,0,1
85914840,0,0,1,0,1
86209218,1,0,0,0,1
86182721,1,0,0,0,1
86171061,1,0,0,0,1
86156456,1,0,0,0,1
86098266,1,0,0,0,1
86087378,1,0,0,0,1
85955862,0,0,1,0,1
85294325,0,0,1,0,1
85281944,1,0,0,0,1
85235313,1,0,0,0,1
84413356,1,0,0,0,1
84548731,0,0,1,0,1
84525154,1,0,0,0,1
84510411,1,0,0,0,1
84493226,0,0,1,0,1
84491220,0,0,1,0,1
84464154,1,0,0,0,1
84453766,0,0,1,0,1
84403365,0,0,1,0,1
84732743,1,0,0,0,1
84303682,1,0,0,0,1
84248816,1,0,0,0,1
84239198,1,0,0,0,1
84177359,0,0,1,0,1
84155085,0,0,1,0,1
84147508,1,0,0,0,1
84109314,0,0,1,0,1
84632856,1,0,0,0,1
84754283,1,0,0,0,1
85218001,0,0,1,0,1
85016972,0,0,1,0,1
85202288,0,0,1,0,1
85187660,1,0,0,0,1
85156888,1,0,0,0,1
85140494,1,0,0,0,1
85113502,1,0,0,0,1
85082002,0,0,1,0,1
85062355,0,0,1,0,1
85006178,1,0,0,0,1
84766486,0,0,1,0,1
84995573,1,0,0,0,1
84985477,1,0,0,0,1
84932219,1,0,0,0,1
84929884,1,0,0,0,1
84902242,0,0,1,0,1
84862540,0,0,1,0,1
84779589,1,0,0,0,1
90956690,1,0,0,0,1
91034542,0,0,1,0,1
101982307,1,0,0,0,1
97322448,0,0,1,0,1
97964040,1,0,0,0,1
97907084,1,0,0,0,1
97822063,0,0,1,0,1
97788824,0,0,1,0,1
97682736,1,0,0,0,1
97660847,1,0,0,0,1
97659986,1,0,0,0,1
97657342,1,0,0,0,1
97633452,0,0,1,0,1
97575855,1,0,0,0,1
97571968,0,0,1,0,1
97552962,0,0,1,0,1
97521826,0,0,1,0,1
97510627,1,0,0,0,1
97441717,0,0,1,0,1
97430074,1,0,0,0,1
97366994,0,0,1,0,1
166310030,1,0,0,0,1
97976772,0,0,1,0,1
97980042,0,0,1,0,1
98522037,1,0,0,0,1
98804213,0,0,1,0,1
98777983,1,0,0,0,1
98719211,1,0,0,0,1
98714463,0,0,1,0,1
98696488,1,0,0,0,1
98662265,1,0,0,0,1
98546474,0,0,1,0,1
98454738,1,0,0,0,1
98053423,0,0,1,0,1
98341498,1,0,0,0,1
98308046,1,0,0,0,1
98279802,0,0,1,0,1
98155588,0,0,1,0,1
98095902,1,0,0,0,1
98066882,0,0,1,0,1
98056984,1,0,0,0,1
97336460,0,0,1,0,1
97243274,1,0,0,0,1
98853519,1,0,0,0,1
97179902,1,0,0,0,1
96311058,1,0,0,0,1
96202421,0,0,1,0,1
96166120,1,0,0,0,1
96159925,1,0,0,0,1
96143211,1,0,0,0,1
96101938,1,0,0,0,1
96056572,0,0,1,0,1
96049478,1,0,0,0,1
96013929,1,0,0,0,1
95999344,1,0,0,0,1
95994558,1,0,0,0,1
95939781,1,0,0,0,1
95936966,0,0,1,0,1
95934601,1,0,0,0,1
95921812,1,0,0,0,1
95905001,1,0,0,0,1
95865067,0,0,1,0,1
96317547,0,0,1,0,1
96328834,0,0,1,0,1
96335626,0,0,1,0,1
96971087,1,0,0,0,1
97170205,1,0,0,0,1
97148702,1,0,0,0,1
97086824,1,0,0,0,1
97041394,1,0,0,0,1
97001292,1,0,0,0,1
96996010,0,0,1,0,1
96978953,0,0,1,0,1
96889845,1,0,0,0,1
96347002,1,0,0,0,1
96867847,1,0,0,0,1
96841679,1,0,0,0,1
96742320,1,0,0,0,1
96608840,1,0,0,0,1
96438921,1,0,0,0,1
96377729,0,0,1,0,1
96361528,1,0,0,0,1
98828133,1,0,0,0,1
98868828,0,0,1,0,1
91076684,1,0,0,0,1
100657919,1,0,0,0,1
101144679,1,0,0,0,1
101131690,1,0,0,0,1
101113812,1,0,0,0,1
101113595,0,0,1,0,1
101076625,1,0,0,0,1
101076486,0,0,1,0,1
100982305,1,0,0,0,1
100970377,1,0,0,0,1
100965471,1,0,0,0,1
100939823,0,0,1,0,1
100896520,0,0,1,0,1
100841539,0,0,1,0,1
100812175,0,0,1,0,1
100809424,0,0,1,0,1
100784323,0,0,1,0,1
100709327,0,0,1,0,1
100671934,1,0,0,0,1
101234103,1,0,0,0,1
101264083,1,0,0,0,1
101267763,1,0,0,0,1
101597958,0,0,1,0,1
101971358,1,0,0,0,1
101962566,1,0,0,0,1
101883929,1,0,0,0,1
101772343,1,0,0,0,1
101723478,1,0,0,0,1
101720883,0,0,1,0,1
101609386,0,0,1,0,1
101568108,1,0,0,0,1
101290167,0,0,1,0,1
101560248,0,0,1,0,1
101557399,1,0,0,0,1
101533618,1,0,0,0,1
101529107,1,0,0,0,1
101367917,0,0,1,0,1
101311747,1,0,0,0,1
101309858,0,0,1,0,1
100666941,1,0,0,0,1
100593354,1,0,0,0,1
99100523,1,0,0,0,1
100565897,0,0,1,0,1
99638009,0,0,1,0,1
99634835,1,0,0,0,1
99551805,0,0,1,0,1
99532682,1,0,0,0,1
99434002,1,0,0,0,1
99421256,1,0,0,0,1
99346083,1,0,0,0,1
99270668,1,0,0,0,1
99268393,1,0,0,0,1
99256824,1,0,0,0,1
99245631,0,0,1,0,1
99218703,1,0,0,0,1
99216670,1,0,0,0,1
99205045,0,0,1,0,1
99139601,1,0,0,0,1
99137770,0,0,0,1,1
99108929,0,0,0,1,1
99639187,1,0,0,0,1
99642772,1,0,0,0,1
99652823,0,0,1,0,1
100202479,1,0,0,0,1
100497914,1,0,0,0,1
100426482,1,0,0,0,1
100394501,1,0,0,0,1
100354001,0,0,1,0,1
100286479,1,0,0,0,1
100277101,0,0,1,0,1
100271449,0,0,1,0,1
100107219,1,0,0,0,1
99658452,1,0,0,0,1
100032033,0,0,1,0,1
99991907,0,0,1,0,1
99895215,1,0,0,0,1
99865195,1,0,0,0,1
99804239,0,0,1,0,1
99770640,1,0,0,0,1
99683151,1,0,0,0,1
95782575,0,0,1,0,1
95766078,1,0,0,0,1
95688223,1,0,0,0,1
92030616,1,0,0,0,1
92610445,0,0,0,1,1
92602590,1,0,0,0,1
92562164,1,0,0,0,1
92523302,0,0,1,0,1
92510990,0,0,1,0,1
92509169,1,0,0,0,1
92493393,0,0,1,0,1
92474771,0,0,1,0,1
92325527,0,0,1,0,1
92321381,1,0,0,0,1
92300748,0,0,1,0,1
92294213,1,0,0,0,1
92195100,0,0,1,0,1
92192182,1,0,0,0,1
92183983,1,0,0,0,1
92168817,1,0,0,0,1
92100014,1,0,0,0,1
92612757,1,0,0,0,1
92647951,1,0,0,0,1
92650708,1,0,0,0,1
92856787,1,0,0,0,1
93094135,1,0,0,0,1
93080182,1,0,0,0,1
93029228,1,0,0,0,1
93020402,1,0,0,0,1
92904178,1,0,0,0,1
92892590,1,0,0,0,1
92856848,1,0,0,0,1
92814116,1,0,0,0,1
92673876,1,0,0,0,1
92813058,1,0,0,0,1
92793705,1,0,0,0,1
92769975,1,0,0,0,1
92733485,0,0,1,0,1
92715725,1,0,0,0,1
92703158,1,0,0,0,1
92690603,0,0,1,0,1
92082876,1,0,0,0,1
91997718,0,0,1,0,1
95642648,1,0,0,0,1
91985207,1,0,0,0,1
91510178,1,0,0,0,1
91466201,1,0,0,0,1
91393358,1,0,0,0,1
91380044,1,0,0,0,1
91361325,1,0,0,0,1
91359302,0,0,1,0,1
91355631,0,0,1,0,1
91301448,1,0,0,0,1
91299100,1,0,0,0,1
91292951,0,0,1,0,1
91280958,0,0,1,0,1
91273277,1,0,0,0,1
91194780,0,0,1,0,1
91182756,1,0,0,0,1
91176276,1,0,0,0,1
91173287,0,0,1,0,1
91147323,0,0,1,0,1
91522394,1,0,0,0,1
91547284,1,0,0,0,1
91554940,1,0,0,0,1
91783661,1,0,0,0,1
91902742,0,0,1,0,1
91889284,0,0,1,0,1
91876294,0,0,1,0,1
91845557,0,0,1,0,1
91838449,1,0,0,0,1
91829289,1,0,0,0,1
91804427,0,0,1,0,1
91777502,0,0,1,0,1
91563694,1,0,0,0,1
91744364,1,0,0,0,1
91741735,0,0,1,0,1
91718195,0,0,1,0,1
91678787,1,0,0,0,1
91645690,1,0,0,0,1
91600307,1,0,0,0,1
91565089,1,0,0,0,1
93160113,1,0,0,0,1
93211521,1,0,0,0,1
93224650,1,0,0,0,1
93294060,1,0,0,0,1
95051172,0,0,1,0,1
95038818,0,0,1,0,1
95014144,0,0,1,0,1
94951531,1,0,0,0,1
94898029,1,0,0,0,1
94880542,1,0,0,0,1
94860592,0,0,1,0,1
94843889,0,0,1,0,1
94832914,1,0,0,0,1
94820583,0,0,1,0,1
94717868,0,0,1,0,1
94707512,0,0,1,0,1
94597331,1,0,0,0,1
94543144,1,0,0,0,1
94522062,0,0,1,0,1
94514185,1,0,0,0,1
94493643,1,0,0,0,1
95057884,1,0,0,0,1
95107611,1,0,0,0,1
95117581,1,0,0,0,1
95416322,1,0,0,0,1
95575605,1,0,0,0,1
95552798,1,0,0,0,1
95475481,0,0,1,0,1
95471685,1,0,0,0,1
95452926,1,0,0,0,1
95442839,1,0,0,0,1
95436015,1,0,0,0,1
95344065,0,0,1,0,1
95152904,1,0,0,0,1
95343073,1,0,0,0,1
95306427,0,0,1,0,1
95286194,0,0,1,0,1
95284964,1,0,0,0,1
95280862,0,0,1,0,1
95175364,1,0,0,0,1
95153199,1,0,0,0,1
94492921,1,0,0,0,1
94471400,1,0,0,0,1
94467583,1,0,0,0,1
93470906,0,0,1,0,1
93827372,1,0,0,0,1
93751838,0,0,1,0,1
93743081,0,0,1,0,1
93742479,1,0,0,0,1
93661688,0,0,1,0,1
93532582,1,0,0,0,1
93516714,0,0,1,0,1
93441980,0,0,1,0,1
93918222,1,0,0,0,1
93412728,0,0,1,0,1
93411405,0,0,1,0,1
93376283,1,0,0,0,1
93356179,1,0,0,0,1
93335548,1,0,0,0,1
93316008,0,0,1,0,1
93308233,0,0,1,0,1
93839620,0,0,1,0,1
93947132,1,0,0,0,1
94426860,0,0,1,0,1
94344304,1,0,0,0,1
94408885,1,0,0,0,1
94395484,1,0,0,0,1
94382194,1,0,0,0,1
94375628,1,0,0,0,1
94368269,1,0,0,0,1
94363111,1,0,0,0,1
94348160,1,0,0,0,1
94308476,1,0,0,0,1
94027304,0,0,1,0,1
94263025,0,0,1,0,1
94232838,0,0,1,0,1
94196548,1,0,0,0,1
94118056,1,0,0,0,1
94111558,1,0,0,0,1
94100727,1,0,0,0,1
94088674,0,0,1,0,1
166289951,0,0,1,0,1
1678,1,0,0,0,1
166390893,1,0,0,0,1
404575129,0,0,1,0,1
405428786,1,0,0,0,1
405256726,1,0,0,0,1
405254288,1,0,0,0,1
405159598,1,0,0,0,1
405104809,1,0,0,0,1
405009589,1,0,0,0,1
404801432,0,0,1,0,1
404734114,1,0,0,0,1
404527714,1,0,0,0,1
335801810,1,0,0,0,1
404468987,1,0,0,0,1
404435510,1,0,0,0,1
404412943,1,0,0,0,1
404233577,1,0,0,0,1
404036280,0,0,1,0,1
403986007,0,0,1,0,1
403929901,1,0,0,0,1
403893716,1,0,0,0,1
405452153,1,0,0,0,1
405475955,1,0,0,0,1
405495289,0,0,1,0,1
405504942,1,0,0,0,1
407197368,0,0,1,0,1
407182150,0,0,1,0,1
407157607,1,0,0,0,1
407147563,1,0,0,0,1
407101663,0,0,1,0,1
406984733,1,0,0,0,1
406915877,1,0,0,0,1
406886697,1,0,0,0,1
406760867,1,0,0,0,1
406639403,1,0,0,0,1
406581194,1,0,0,0,1
406446693,0,0,1,0,1
406393070,1,0,0,0,1
406092115,1,0,0,0,1
406031733,1,0,0,0,1
405865572,1,0,0,0,1
405681246,1,0,0,0,1
403843912,1,0,0,0,1
403843505,1,0,0,0,1
403696256,1,0,0,0,1
402052525,1,0,0,0,1
401748469,1,0,0,0,1
401614822,1,0,0,0,1
401597887,1,0,0,0,1
401550069,1,0,0,0,1
401539965,1,0,0,0,1
401436640,1,0,0,0,1
401400056,1,0,0,0,1
401381568,1,0,0,0,1
401334061,0,0,1,0,1
401325437,0,0,1,0,1
401303313,0,0,1,0,1
401278500,1,0,0,0,1
401245166,1,0,0,0,1
401145372,0,0,1,0,1
401113005,1,0,0,0,1
401061543,1,0,0,0,1
400939608,1,0,0,0,1
401898605,1,0,0,0,1
402074599,0,0,1,0,1
403346164,1,0,0,0,1
402109679,0,0,1,0,1
403322325,1,0,0,0,1
403320678,1,0,0,0,1
403218932,1,0,0,0,1
403063206,1,0,0,0,1
403061977,0,0,1,0,1
402899930,1,0,0,0,1
402752945,0,0,1,0,1
402752251,0,0,0,1,1
402747348,1,0,0,0,1
402651015,1,0,0,0,1
402617816,1,0,0,0,1
402608429,1,0,0,0,1
402572772,0,0,0,1,1
402456922,0,0,1,0,1
402435841,1,0,0,0,1
402410298,0,0,1,0,1
402340182,1,0,0,0,1
407221865,1,0,0,0,1
407257557,1,0,0,0,1
407322081,0,0,1,0,1
412459804,1,0,0,0,1
411907451,0,0,1,0,1
411892530,1,0,0,0,1
411760614,1,0,0,0,1
411757598,1,0,0,0,1
411735553,0,0,1,0,1
411676796,1,0,0,0,1
411600910,1,0,0,0,1
411289125,0,0,1,0,1
411240832,1,0,0,0,1
411146302,1,0,0,0,1
411007202,1,0,0,0,1
410561414,1,0,0,0,1
410445057,1,0,0,0,1
410378522,1,0,0,0,1
410346205,1,0,0,0,1
410180930,1,0,0,0,1
410171023,1,0,0,0,1
412138034,1,0,0,0,1
412467812,1,0,0,0,1
410129149,1,0,0,0,1
412487513,0,0,1,0,1
413875067,1,0,0,0,1
413855662,1,0,0,0,1
413772712,1,0,0,0,1
413732109,1,0,0,0,1
413543496,1,0,0,0,1
413542489,0,0,1,0,1
413506029,1,0,0,0,1
413485013,1,0,0,0,1
413355897,0,0,1,0,1
413300516,1,0,0,0,1
413161278,1,0,0,0,1
412935934,0,0,1,0,1
412781708,1,0,0,0,1
412716980,1,0,0,0,1
412547947,1,0,0,0,1
412537511,1,0,0,0,1
412531962,1,0,0,0,1
410131557,0,0,1,0,1
410123680,0,0,1,0,1
407386185,1,0,0,0,1
408542634,1,0,0,0,1
408409567,1,0,0,0,1
408388828,1,0,0,0,1
408346348,1,0,0,0,1
408165393,0,0,1,0,1
407939379,1,0,0,0,1
407913399,0,0,1,0,1
407896135,1,0,0,0,1
407864820,1,0,0,0,1
407806556,1,0,0,0,1
407664870,1,0,0,0,1
407664569,0,0,1,0,1
407661651,1,0,0,0,1
407650153,1,0,0,0,1
407646300,1,0,0,0,1
407566959,1,0,0,0,1
407531685,1,0,0,0,1
407393457,1,0,0,0,1
408433618,1,0,0,0,1
408634137,0,0,1,0,1
410078356,0,0,1,0,1
408782369,1,0,0,0,1
410010254,0,0,1,0,1
409967227,0,0,1,0,1
409939700,0,0,1,0,1
409796268,0,0,1,0,1
409771624,0,0,1,0,1
409756330,1,0,0,0,1
409668384,0,0,1,0,1
409575276,0,0,1,0,1
409567775,1,0,0,0,1
409460972,0,0,1,0,1
409362260,1,0,0,0,1
409139174,1,0,0,0,1
409097659,1,0,0,0,1
409022952,1,0,0,0,1
408991577,0,0,1,0,1
408917399,1,0,0,0,1
408827396,1,0,0,0,1
400891981,1,0,0,0,1
400866258,1,0,0,0,1
400858815,1,0,0,0,1
393265299,1,0,0,0,1
393005227,1,0,0,0,1
392887204,1,0,0,0,1
392740323,1,0,0,0,1
392601866,1,0,0,0,1
392456121,1,0,0,0,1
392437847,1,0,0,0,1
392360860,0,0,1,0,1
392342746,1,0,0,0,1
392191524,1,0,0,0,1
392170456,1,0,0,0,1
392166643,1,0,0,0,1
392144724,0,0,1,0,1
392125496,1,0,0,0,1
392049314,0,0,1,0,1
391877894,1,0,0,0,1
391638914,0,0,1,0,1
391622090,1,0,0,0,1
393073349,0,0,1,0,1
393270710,0,0,1,0,1
391440782,0,0,1,0,1
393282713,0,0,1,0,1
394564578,1,0,0,0,1
394562867,1,0,0,0,1
394499579,0,0,1,0,1
394467691,1,0,0,0,1
394423249,0,0,1,0,1
394409000,1,0,0,0,1
394305005,1,0,0,0,1
394289605,0,0,1,0,1
393992614,1,0,0,0,1
393967857,1,0,0,0,1
393891728,1,0,0,0,1
393692728,1,0,0,0,1
393595369,1,0,0,0,1
393539508,1,0,0,0,1
393536950,1,0,0,0,1
393527994,1,0,0,0,1
393331643,1,0,0,0,1
391596394,1,0,0,0,1
391434532,0,0,1,0,1
394621051,1,0,0,0,1
390444899,1,0,0,0,1
390368320,1,0,0,0,1
390246709,1,0,0,0,1
390243843,0,0,1,0,1
390077597,0,1,0,0,1
390066321,0,0,1,0,1
389993466,0,0,1,0,1
389896641,0,0,1,0,1
389845679,0,0,1,0,1
389589118,1,0,0,0,1
389538239,0,0,1,0,1
389514150,1,0,0,0,1
389500302,1,0,0,0,1
389475718,0,0,1,0,1
389436964,1,0,0,0,1
389166192,0,0,1,0,1
389147430,1,0,0,0,1
388868701,1,0,0,0,1
390384656,1,0,0,0,1
390615926,1,0,0,0,1
391413366,0,0,1,0,1
390647784,1,0,0,0,1
391400443,1,0,0,0,1
391331417,0,0,1,0,1
391308796,1,0,0,0,1
391271295,1,0,0,0,1
391267817,1,0,0,0,1
391183792,0,0,1,0,1
391176643,1,0,0,0,1
391168473,1,0,0,0,1
391149265,1,0,0,0,1
391019420,1,0,0,0,1
391013997,0,0,1,0,1
390876463,0,0,1,0,1
390872332,1,0,0,0,1
390870857,0,0,1,0,1
390836474,1,0,0,0,1
390810530,0,1,0,0,1
390730096,0,0,1,0,1
394599669,0,0,1,0,1
394704718,1,0,0,0,1
400802920,1,0,0,0,1
398970490,0,0,1,0,1
398809789,1,0,0,0,1
398726516,1,0,0,0,1
398678033,0,0,1,0,1
398637169,1,0,0,0,1
398460031,1,0,0,0,1
398395127,0,0,1,0,1
398367132,1,0,0,0,1
398214275,1,0,0,0,1
398164774,0,0,1,0,1
398072416,1,0,0,0,1
398011206,1,0,0,0,1
397984016,1,0,0,0,1
397909940,1,0,0,0,1
397899582,1,0,0,0,1
397758091,0,0,1,0,1
397743459,0,0,1,0,1
397650145,1,0,0,0,1
398849838,1,0,0,0,1
398985476,1,0,0,0,1
397594672,1,0,0,0,1
399032318,1,0,0,0,1
400790971,0,0,0,1,1
400777393,1,0,0,0,1
400364146,1,0,0,0,1
400193201,1,0,0,0,1
400165346,1,0,0,0,1
400158761,1,0,0,0,1
400070515,1,0,0,0,1
399839711,1,0,0,0,1
399569723,1,0,0,0,1
399555458,0,0,1,0,1
399513696,1,0,0,0,1
399396467,1,0,0,0,1
399393231,0,0,0,1,1
399358002,1,0,0,0,1
399189844,1,0,0,0,1
399098718,0,0,1,0,1
399054321,1,0,0,0,1
397595133,1,0,0,0,1
397556888,1,0,0,0,1
394707471,1,0,0,0,1
395964359,1,0,0,0,1
395699445,0,0,1,0,1
395631262,1,0,0,0,1
395520753,0,0,1,0,1
395470384,1,0,0,0,1
395389976,0,0,1,0,1
395383871,0,0,1,0,1
395286433,1,0,0,0,1
395195732,1,0,0,0,1
395153297,0,0,1,0,1
395145358,1,0,0,0,1
395092854,1,0,0,0,1
395053857,1,0,0,0,1
395032236,1,0,0,0,1
394951981,0,0,1,0,1
394746651,0,0,1,0,1
394726912,0,0,1,0,1
394726603,1,0,0,0,1
395765663,0,0,1,0,1
395972423,1,0,0,0,1
397538297,1,0,0,0,1
395972564,1,0,0,0,1
397500496,1,0,0,0,1
397389208,0,0,1,0,1
397296766,0,0,1,0,1
397288055,1,0,0,0,1
397163059,1,0,0,0,1
397121052,0,0,1,0,1
397099903,1,0,0,0,1
397073018,0,0,0,1,1
396969684,1,0,0,0,1
396786434,1,0,0,0,1
396662812,1,0,0,0,1
396556622,1,0,0,0,1
396548417,1,0,0,0,1
396461379,0,0,1,0,1
396419043,1,0,0,0,1
396362260,1,0,0,0,1
396005614,1,0,0,0,1
413981013,0,0,1,0,1
413982944,1,0,0,0,1
413988494,0,0,1,0,1
430626948,0,0,1,0,1
430510722,1,0,0,0,1
430380865,1,0,0,0,1
430279823,0,0,1,0,1
430077990,1,0,0,0,1
430051258,1,0,0,0,1
429970523,1,0,0,0,1
429960952,1,0,0,0,1
429793250,1,0,0,0,1
429792351,1,0,0,0,1
429698197,1,0,0,0,1
429680509,1,0,0,0,1
429636259,1,0,0,0,1
429635356,1,0,0,0,1
429378639,1,0,0,0,1
429293737,1,0,0,0,1
429247380,1,0,0,0,1
429183811,0,0,1,0,1
430605414,1,0,0,0,1
430683325,1,0,0,0,1
429055682,1,0,0,0,1
430685664,1,0,0,0,1
432098605,1,0,0,0,1
432058192,1,0,0,0,1
432036690,1,0,0,0,1
432036636,1,0,0,0,1
432032850,1,0,0,0,1
431971547,1,0,0,0,1
431904792,1,0,0,0,1
431870776,0,0,1,0,1
431776619,1,0,0,0,1
431522149,1,0,0,0,1
431421365,1,0,0,0,1
431264673,1,0,0,0,1
431208540,0,0,1,0,1
430983788,0,0,1,0,1
430972148,1,0,0,0,1
430837138,1,0,0,0,1
430769144,0,0,1,0,1
429140512,0,0,1,0,1
428838691,1,0,0,0,1
432231920,1,0,0,0,1
427654922,0,0,1,0,1
427350306,0,0,1,0,1
427337597,1,0,0,0,1
427288092,1,0,0,0,1
427286327,1,0,0,0,1
427251657,1,0,0,0,1
427245287,1,0,0,0,1
427093425,1,0,0,0,1
427089828,0,0,1,0,1
427086056,1,0,0,0,1
427051831,1,0,0,0,1
426984092,1,0,0,0,1
426958468,1,0,0,0,1
426819235,1,0,0,0,1
426804754,1,0,0,0,1
426682883,0,0,1,0,1
426490985,1,0,0,0,1
426406556,1,0,0,0,1
427357222,1,0,0,0,1
427675615,1,0,0,0,1
428837979,0,0,1,0,1
427781414,0,0,1,0,1
428761064,1,0,0,0,1
428705707,1,0,0,0,1
428517167,0,0,1,0,1
428510020,0,0,1,0,1
428426634,1,0,0,0,1
428423827,0,0,1,0,1
428377058,1,0,0,0,1
428270883,1,0,0,0,1
428183273,0,0,1,0,1
428156760,0,0,1,0,1
428147699,1,0,0,0,1
428138457,1,0,0,0,1
428093769,1,0,0,0,1
428067885,1,0,0,0,1
428055153,1,0,0,0,1
427967589,0,0,1,0,1
427808382,1,0,0,0,1
432158812,1,0,0,0,1
432243229,1,0,0,0,1
426250815,1,0,0,0,1
435088866,1,0,0,0,1
434939029,1,0,0,0,1
434928403,1,0,0,0,1
434923721,0,0,1,0,1
434912305,1,0,0,0,1
434892746,1,0,0,0,1
434840773,0,0,1,0,1
434637424,1,0,0,0,1
434579035,1,0,0,0,1
434571817,1,0,0,0,1
434539417,1,0,0,0,1
434496280,1,0,0,0,1
434473645,1,0,0,0,1
434427702,1,0,0,0,1
434417987,1,0,0,0,1
434407568,1,0,0,0,1
434394473,0,0,1,0,1
434379988,0,0,1,0,1
435076774,1,0,0,0,1
435121441,1,0,0,0,1
434325396,0,0,1,0,1
435273167,0,0,1,0,1
436314626,1,0,0,0,1
436210041,1,0,0,0,1
436205980,1,0,0,0,1
436204978,1,0,0,0,1
436157703,1,0,0,0,1
436143141,0,0,1,0,1
436098811,1,0,0,0,1
436046447,1,0,0,0,1
435847805,1,0,0,0,1
435821587,1,0,0,0,1
435772211,0,0,1,0,1
435658930,1,0,0,0,1
435596498,0,0,1,0,1
435592300,0,0,1,0,1
435511395,0,0,1,0,1
435480629,1,0,0,0,1
435341575,1,0,0,0,1
434367440,1,0,0,0,1
434142299,1,0,0,0,1
432265222,1,0,0,0,1
433172270,1,0,0,0,1
432988568,1,0,0,0,1
432967074,1,0,0,0,1
432939986,1,0,0,0,1
432932425,1,0,0,0,1
432917817,1,0,0,0,1
432873764,0,0,1,0,1
432786519,1,0,0,0,1
432754170,1,0,0,0,1
432634656,0,0,0,1,1
432628336,1,0,0,0,1
432491766,1,0,0,0,1
432488510,0,0,1,0,1
432478348,1,0,0,0,1
432388965,1,0,0,0,1
432356356,1,0,0,0,1
432356078,1,0,0,0,1
432309846,0,0,1,0,1
433012511,0,0,1,0,1
433172943,1,0,0,0,1
434082175,1,0,0,0,1
433207104,0,0,1,0,1
433965914,1,0,0,0,1
433929543,0,0,1,0,1
433720268,1,0,0,0,1
433697486,1,0,0,0,1
433677671,1,0,0,0,1
433655315,0,0,1,0,1
433622516,1,0,0,0,1
433615899,1,0,0,0,1
433564446,1,0,0,0,1
433546248,1,0,0,0,1
433524753,1,0,0,0,1
433494440,0,0,1,0,1
433332162,0,0,1,0,1
433324460,1,0,0,0,1
433321587,1,0,0,0,1
433237033,0,0,1,0,1
433209116,1,0,0,0,1
426394465,1,0,0,0,1
426242060,1,0,0,0,1
414053733,1,0,0,0,1
419339788,1,0,0,0,1
418755715,1,0,0,0,1
418742053,1,0,0,0,1
418642230,0,0,1,0,1
418559327,1,0,0,0,1
418199181,1,0,0,0,1
418151816,1,0,0,0,1
418124294,0,0,1,0,1
418043689,1,0,0,0,1
417722738,1,0,0,0,1
417692654,1,0,0,0,1
417550602,0,0,1,0,1
417522395,0,0,1,0,1
417475830,0,0,1,0,1
417346311,0,0,1,0,1
417330733,0,0,1,0,1
417305132,1,0,0,0,1
417206678,1,0,0,0,1
419307390,1,0,0,0,1
419358491,1,0,0,0,1
417196731,1,0,0,0,1
419395382,1,0,0,0,1
420132354,1,0,0,0,1
420076709,0,0,1,0,1
420064732,1,0,0,0,1
420019170,1,0,0,0,1
420008778,1,0,0,0,1
419923115,1,0,0,0,1
419867541,1,0,0,0,1
419859723,1,0,0,0,1
419852791,0,0,1,0,1
419717387,0,0,1,0,1
419687159,1,0,0,0,1
419642286,0,0,1,0,1
419590304,0,0,1,0,1
419546321,0,0,1,0,1
419542964,1,0,0,0,1
419476200,1,0,0,0,1
419474229,0,0,0,1,1
417201324,1,0,0,0,1
417090315,0,0,1,0,1
420191437,0,0,1,0,1
415255533,1,0,0,0,1
415122602,1,0,0,0,1
415080892,1,0,0,0,1
414960176,0,0,1,0,1
414869990,1,0,0,0,1
414684807,1,0,0,0,1
414646580,1,0,0,0,1
414619902,1,0,0,0,1
414611459,0,0,1,0,1
414576994,0,0,1,0,1
414550936,1,0,0,0,1
414507871,1,0,0,0,1
414406854,0,0,1,0,1
414379463,1,0,0,0,1
414375084,1,0,0,0,1
414343320,0,0,1,0,1
414206354,0,0,1,0,1
414188733,1,0,0,0,1
415142603,1,0,0,0,1
415297628,0,0,1,0,1
417088896,1,0,0,0,1
415460981,1,0,0,0,1
417077805,1,0,0,0,1
416750758,1,0,0,0,1
416654796,0,0,1,0,1
416590559,1,0,0,0,1
416545661,1,0,0,0,1
416292655,1,0,0,0,1
416205031,1,0,0,0,1
416189034,1,0,0,0,1
416179654,1,0,0,0,1
416144471,1,0,0,0,1
416129697,1,0,0,0,1
416021133,0,0,1,0,1
415733609,1,0,0,0,1
415732126,1,0,0,0,1
415705092,0,0,1,0,1
415537080,1,0,0,0,1
415475108,1,0,0,0,1
420148935,1,0,0,0,1
420261624,1,0,0,0,1
426210481,1,0,0,0,1
424796859,0,0,1,0,1
424741639,1,0,0,0,1
424608315,0,0,1,0,1
424602779,1,0,0,0,1
424459512,0,0,1,0,1
424457245,1,0,0,0,1
424446457,1,0,0,0,1
424354855,0,0,1,0,1
424179971,1,0,0,0,1
424173274,1,0,0,0,1
424170184,1,0,0,0,1
424135738,1,0,0,0,1
424060182,1,0,0,0,1
424059660,1,0,0,0,1
424054614,1,0,0,0,1
424033060,1,0,0,0,1
423982333,0,0,1,0,1
423906571,1,0,0,0,1
424757620,1,0,0,0,1
425038091,1,0,0,0,1
423769430,1,0,0,0,1
425058817,1,0,0,0,1
426163934,1,0,0,0,1
426099783,1,0,0,0,1
426053714,1,0,0,0,1
425951302,0,0,1,0,1
425941907,1,0,0,0,1
425897675,0,0,1,0,1
425854650,1,0,0,0,1
425713967,1,0,0,0,1
425708503,0,0,1,0,1
425618526,1,0,0,0,1
425584890,1,0,0,0,1
425438245,1,0,0,0,1
425386178,1,0,0,0,1
425355649,0,0,1,0,1
425339781,1,0,0,0,1
425209831,1,0,0,0,1
425159392,1,0,0,0,1
423838195,1,0,0,0,1
423653399,1,0,0,0,1
420263983,1,0,0,0,1
422291147,0,0,1,0,1
422135819,1,0,0,0,1
422008059,1,0,0,0,1
421934229,1,0,0,0,1
421890661,1,0,0,0,1
421792224,0,0,1,0,1
421715571,1,0,0,0,1
421715467,1,0,0,0,1
421609761,0,0,1,0,1
421605394,1,0,0,0,1
421264574,1,0,0,0,1
421041104,0,0,1,0,1
420995366,1,0,0,0,1
420960795,1,0,0,0,1
420852622,1,0,0,0,1
420598562,1,0,0,0,1
420433352,1,0,0,0,1
420392531,1,0,0,0,1
422238549,1,0,0,0,1
422296685,1,0,0,0,1
423484073,0,0,1,0,1
422309354,0,0,1,0,1
423452852,1,0,0,0,1
423356160,1,0,0,0,1
423326630,1,0,0,0,1
423294451,1,0,0,0,1
423206065,1,0,0,0,1
423201359,1,0,0,0,1
423175770,1,0,0,0,1
423079881,1,0,0,0,1
422990421,1,0,0,0,1
422985413,1,0,0,0,1
422978002,1,0,0,0,1
422907858,1,0,0,0,1
422737259,1,0,0,0,1
422647197,1,0,0,0,1
422581359,1,0,0,0,1
422337306,1,0,0,0,1
422319674,0,0,1,0,1
388818764,0,0,1,0,1
388770258,1,0,0,0,1
388595654,0,0,1,0,1
351325108,0,0,1,0,1
351006187,1,0,0,0,1
350862434,1,0,0,0,1
350804501,0,0,1,0,1
350725081,1,0,0,0,1
350542140,1,0,0,0,1
350408858,1,0,0,0,1
350196855,1,0,0,0,1
350196525,0,0,1,0,1
350031143,1,0,0,0,1
349931116,0,0,0,1,1
349828679,1,0,0,0,1
349820814,1,0,0,0,1
349812592,0,0,1,0,1
349670810,0,0,1,0,1
349662394,1,0,0,0,1
349624917,0,0,1,0,1
349608221,1,0,0,0,1
351006583,1,0,0,0,1
351339834,1,0,0,0,1
349478003,1,0,0,0,1
351371283,0,0,0,1,1
353267257,1,0,0,0,1
353224767,1,0,0,0,1
353115658,1,0,0,0,1
353050284,1,0,0,0,1
352987237,1,0,0,0,1
352857062,1,0,0,0,1
352617669,1,0,0,0,1
352534073,0,0,1,0,1
352501846,0,0,1,0,1
352444781,0,0,1,0,1
352171581,1,0,0,0,1
352057642,0,0,0,1,1
351905581,0,0,1,0,1
351701484,0,0,1,0,1
351556515,1,0,0,0,1
351491173,0,0,1,0,1
351404975,0,0,1,0,1
349508205,1,0,0,0,1
349413488,1,0,0,0,1
353550835,1,0,0,0,1
347821719,1,0,0,0,1
347673646,1,0,0,0,1
347652020,0,0,1,0,1
347604033,1,0,0,0,1
347567413,1,0,0,0,1
347481441,0,0,1,0,1
347474872,0,0,1,0,1
347203608,1,0,0,0,1
347186956,0,0,1,0,1
347139856,0,0,1,0,1
347029971,1,0,0,0,1
346915366,1,0,0,0,1
346906516,0,0,1,0,1
346884245,1,0,0,0,1
346824213,1,0,0,0,1
346772364,0,0,1,0,1
346723005,1,0,0,0,1
346638859,1,0,0,0,1
347713812,0,0,1,0,1
347836749,1,0,0,0,1
349395270,1,0,0,0,1
347884942,0,0,1,0,1
349342033,0,0,1,0,1
349227192,1,0,0,0,1
348978057,1,0,0,0,1
348913133,1,0,0,0,1
348891433,0,0,1,0,1
348847132,0,0,1,0,1
348756875,0,0,1,0,1
348564569,1,0,0,0,1
348502047,1,0,0,0,1
348486067,0,0,1,0,1
348200293,0,0,1,0,1
348141027,1,0,0,0,1
348119186,1,0,0,0,1
348072917,0,0,0,1,1
348054745,1,0,0,0,1
348045909,1,0,0,0,1
348038583,1,0,0,0,1
353307054,1,0,0,0,1
353568119,1,0,0,0,1
346575915,1,0,0,0,1
359537256,1,0,0,0,1
359499038,1,0,0,0,1
359250381,0,0,1,0,1
359218159,0,0,1,0,1
359097710,0,0,1,0,1
359016315,0,0,1,0,1
358836868,1,0,0,0,1
358735760,0,0,1,0,1
358717658,1,0,0,0,1
358650418,0,0,1,0,1
358433214,1,0,0,0,1
358397432,1,0,0,0,1
358288637,1,0,0,0,1
358285408,1,0,0,0,1
358237996,1,0,0,0,1
358060731,0,0,1,0,1
357899706,0,0,1,0,1
357740865,0,0,1,0,1
359515388,1,0,0,0,1
359756644,0,0,1,0,1
357666378,0,0,1,0,1
359773132,1,0,0,0,1
361455854,1,0,0,0,1
361317957,1,0,0,0,1
361182285,1,0,0,0,1
361034257,1,0,0,0,1
360780711,0,0,1,0,1
360662584,0,1,0,0,1
360586882,1,0,0,0,1
360422264,0,0,1,0,1
360402657,0,0,1,0,1
360205326,1,0,0,0,1
360180465,0,0,1,0,1
360106411,1,0,0,0,1
360086075,1,0,0,0,1
359934180,0,0,1,0,1
359913981,1,0,0,0,1
359870362,0,0,1,0,1
359863329,1,0,0,0,1
357734210,1,0,0,0,1
357509976,0,0,1,0,1
353975212,1,0,0,0,1
355804818,1,0,0,0,1
355686828,1,0,0,0,1
355683094,1,0,0,0,1
355600793,0,0,0,1,1
355586252,0,0,1,0,1
355499242,1,0,0,0,1
355238960,0,0,1,0,1
355144328,0,0,1,0,1
355039509,0,0,1,0,1
354909683,1,0,0,0,1
354737559,1,0,0,0,1
354518586,0,0,1,0,1
354500396,0,0,1,0,1
354491017,1,0,0,0,1
354409033,1,0,0,0,1
354181313,0,0,1,0,1
354035081,1,0,0,0,1
353990601,1,0,0,0,1
355773591,1,0,0,0,1
356050857,1,0,0,0,1
357477821,1,0,0,0,1
356120729,1,0,0,0,1
357325811,1,0,0,0,1
357257077,1,0,0,0,1
357114684,1,0,0,0,1
357068895,1,0,0,0,1
357064961,1,0,0,0,1
356981374,1,0,0,0,1
356966392,0,0,1,0,1
356788969,0,0,1,0,1
356788134,1,0,0,0,1
356783946,1,0,0,0,1
356758729,1,0,0,0,1
356663207,1,0,0,0,1
356658410,0,0,1,0,1
356632650,0,0,1,0,1
356470759,0,0,1,0,1
356430849,0,0,1,0,1
356385048,1,0,0,0,1
346579486,1,0,0,0,1
346403664,0,0,1,0,1
361567777,1,0,0,0,1
340298962,0,0,1,0,1
340186155,1,0,0,0,1
340069774,1,0,0,0,1
340032161,0,0,1,0,1
339927331,1,0,0,0,1
339925294,1,0,0,0,1
339808768,1,0,0,0,1
339778197,0,0,1,0,1
339771748,1,0,0,0,1
339715504,1,0,0,0,1
339633862,0,0,1,0,1
339532633,0,0,0,1,1
339277055,0,0,1,0,1
339176757,0,0,1,0,1
339168427,1,0,0,0,1
339137391,1,0,0,0,1
339122855,0,0,1,0,1
339065933,1,0,0,0,1
340198326,1,0,0,0,1
340410992,0,0,0,1,1
338812311,1,0,0,0,1
340427015,1,0,0,0,1
341019038,1,0,0,0,1
340959159,0,0,1,0,1
340910893,0,0,1,0,1
340909563,0,0,1,0,1
340860098,1,0,0,0,1
340845255,0,0,1,0,1
340801756,0,0,1,0,1
340799243,1,0,0,0,1
340719881,0,0,1,0,1
340681289,1,0,0,0,1
340603785,0,0,1,0,1
340586364,0,0,1,0,1
340529580,0,0,1,0,1
340520294,0,0,1,0,1
340516424,0,0,1,0,1
340471505,0,0,1,0,1
340446368,1,0,0,0,1
339041088,1,0,0,0,1
338801033,1,0,0,0,1
341089565,0,0,1,0,1
337471235,1,0,0,0,1
337103567,1,0,0,0,1
337088173,0,0,1,0,1
337081866,1,0,0,0,1
337058327,0,0,1,0,1
337018538,0,0,1,0,1
336953334,1,0,0,0,1
336906719,0,0,1,0,1
336501346,0,0,1,0,1
336438781,1,0,0,0,1
336347705,1,0,0,0,1
336332427,0,0,0,1,1
336247977,1,0,0,0,1
336202829,1,0,0,0,1
336050514,0,0,1,0,1
335973546,0,0,1,0,1
335969218,0,0,1,0,1
335966370,1,0,0,0,1
337459786,0,0,1,0,1
337477879,1,0,0,0,1
338790934,1,0,0,0,1
337483521,1,0,0,0,1
338746167,0,0,1,0,1
338640411,0,0,1,0,1
338529971,1,0,0,0,1
338498911,1,0,0,0,1
338424773,1,0,0,0,1
338416949,1,0,0,0,1
338377256,1,0,0,0,1
338314964,0,0,1,0,1
338228106,1,0,0,0,1
338198692,1,0,0,0,1
338000317,1,0,0,0,1
337853119,1,0,0,0,1
337841230,0,0,1,0,1
337711840,0,0,1,0,1
337615993,0,0,1,0,1
337608527,1,0,0,0,1
337489786,0,0,1,0,1
341081198,0,0,1,0,1
341182053,1,0,0,0,1
346364657,0,0,1,0,1
345196808,1,0,0,0,1
345159362,1,0,0,0,1
345088683,1,0,0,0,1
344977817,0,0,1,0,1
344974718,1,0,0,0,1
344891745,0,0,1,0,1
344805837,1,0,0,0,1
344798817,1,0,0,0,1
344779386,1,0,0,0,1
344657177,1,0,0,0,1
344525630,1,0,0,0,1
344492196,1,0,0,0,1
344445728,1,0,0,0,1
344432929,1,0,0,0,1
344384237,1,0,0,0,1
344294077,1,0,0,0,1
344288730,0,0,1,0,1
344256042,0,0,1,0,1
345162226,1,0,0,0,1
345220874,1,0,0,0,1
343979062,0,0,1,0,1
345230568,1,0,0,0,1
346357287,1,0,0,0,1
346283145,0,0,1,0,1
346273882,0,0,1,0,1
346197555,1,0,0,0,1
346162718,1,0,0,0,1
346149267,1,0,0,0,1
346109549,0,0,1,0,1
346001746,1,0,0,0,1
345999890,1,0,0,0,1
345992143,1,0,0,0,1
345861676,1,0,0,0,1
345738005,0,0,1,0,1
345696291,1,0,0,0,1
345497509,0,0,1,0,1
345475722,1,0,0,0,1
345468539,1,0,0,0,1
345447216,1,0,0,0,1
344136847,1,0,0,0,1
343877962,1,0,0,0,1
341348997,1,0,0,0,1
342297283,1,0,0,0,1
342156685,1,0,0,0,1
342147522,0,0,1,0,1
342145489,1,0,0,0,1
342142296,0,0,1,0,1
342140677,1,0,0,0,1
342131155,1,0,0,0,1
342053968,0,1,0,0,1
341959197,0,0,1,0,1
341928072,0,0,1,0,1
341913604,1,0,0,0,1
341574549,1,0,0,0,1
341515596,0,0,1,0,1
341471321,0,0,1,0,1
341469185,0,0,1,0,1
341468081,1,0,0,0,1
341408541,1,0,0,0,1
341381811,0,0,1,0,1
342224614,0,0,1,0,1
342298445,1,0,0,0,1
343836403,1,0,0,0,1
342312333,1,0,0,0,1
343830444,1,0,0,0,1
343784251,1,0,0,0,1
343760399,1,0,0,0,1
343748989,1,0,0,0,1
343632743,1,0,0,0,1
343623135,1,0,0,0,1
343585922,1,0,0,0,1
343568398,1,0,0,0,1
343538498,0,0,1,0,1
343192493,0,0,1,0,1
343153813,1,0,0,0,1
343024997,1,0,0,0,1
342815607,1,0,0,0,1
342640129,1,0,0,0,1
342548185,0,0,1,0,1
342323079,0,0,1,0,1
342317272,1,0,0,0,1
361456321,0,0,1,0,1
361674968,0,0,1,0,1
388550274,1,0,0,0,1
380144777,1,0,0,0,1
379883703,0,0,1,0,1
379713641,1,0,0,0,1
379446535,1,0,0,0,1
379426733,1,0,0,0,1
379398902,1,0,0,0,1
379247545,1,0,0,0,1
378995497,1,0,0,0,1
378967242,1,0,0,0,1
378956905,1,0,0,0,1
378900197,1,0,0,0,1
378877200,1,0,0,0,1
378877182,0,0,1,0,1
378853274,1,0,0,0,1
378824641,1,0,0,0,1
378802243,1,0,0,0,1
378700758,0,0,1,0,1
378618797,1,0,0,0,1
380013607,1,0,0,0,1
380153350,0,0,1,0,1
378456334,0,0,1,0,1
380274974,1,0,0,0,1
381868676,0,0,1,0,1
381859774,1,0,0,0,1
381849651,1,0,0,0,1
381833215,1,0,0,0,1
381782081,0,0,1,0,1
381610034,1,0,0,0,1
381602499,0,0,1,0,1
381319750,1,0,0,0,1
381242156,0,0,1,0,1
381148614,1,0,0,0,1
381121555,1,0,0,0,1
381060830,1,0,0,0,1
380862126,1,0,0,0,1
380818034,1,0,0,0,1
380727943,1,0,0,0,1
380446280,0,0,1,0,1
380355687,1,0,0,0,1
378517976,0,0,1,0,1
378378800,1,0,0,0,1
381884891,0,0,1,0,1
376691941,1,0,0,0,1
376582322,1,0,0,0,1
376570687,0,0,1,0,1
376526291,1,0,0,0,1
376179374,1,0,0,0,1
376162527,1,0,0,0,1
376143855,1,0,0,0,1
376119631,1,0,0,0,1
376047482,1,0,0,0,1
376042176,1,0,0,0,1
375996839,0,0,1,0,1
375912658,1,0,0,0,1
375909286,0,0,1,0,1
375788400,0,0,1,0,1
375773332,1,0,0,0,1
375692991,1,0,0,0,1
375649922,1,0,0,0,1
375556460,0,0,1,0,1
376601023,1,0,0,0,1
376786364,0,0,1,0,1
378338930,1,0,0,0,1
376861859,1,0,0,0,1
378295793,0,0,1,0,1
378258850,1,0,0,0,1
378228712,1,0,0,0,1
377992297,1,0,0,0,1
377850318,0,0,1,0,1
377823632,1,0,0,0,1
377635800,1,0,0,0,1
377491269,1,0,0,0,1
377484768,1,0,0,0,1
377307556,1,0,0,0,1
377279237,0,0,0,1,1
377269900,1,0,0,0,1
377244856,0,0,1,0,1
377238289,1,0,0,0,1
377006945,1,0,0,0,1
376893850,1,0,0,0,1
376877842,0,1,0,0,1
381875331,1,0,0,0,1
382074973,1,0,0,0,1
375482741,1,0,0,0,1
386999487,1,0,0,0,1
386901621,1,0,0,0,1
386896345,1,0,0,0,1
386813366,1,0,0,0,1
386809212,0,0,1,0,1
386744710,0,0,1,0,1
386334460,1,0,0,0,1
386245057,0,0,1,0,1
386195498,1,0,0,0,1
386152775,1,0,0,0,1
386139674,1,0,0,0,1
386135351,0,0,1,0,1
386068658,1,0,0,0,1
386053525,1,0,0,0,1
386024440,0,0,1,0,1
386023252,0,0,1,0,1
385983554,1,0,0,0,1
385859541,1,0,0,0,1
386935484,1,0,0,0,1
387005139,1,0,0,0,1
385718613,1,0,0,0,1
387055664,0,0,1,0,1
388457296,1,0,0,0,1
388454307,1,0,0,0,1
388452445,1,0,0,0,1
388356556,1,0,0,0,1
388322607,1,0,0,0,1
388145254,1,0,0,0,1
387986500,1,0,0,0,1
387954821,0,0,1,0,1
387935140,1,0,0,0,1
387892852,1,0,0,0,1
387851556,1,0,0,0,1
387806257,1,0,0,0,1
387524354,1,0,0,0,1
387284813,1,0,0,0,1
387166404,0,0,1,0,1
387131883,0,0,1,0,1
387071756,1,0,0,0,1
385772454,1,0,0,0,1
385702301,1,0,0,0,1
382100439,1,0,0,0,1
383370816,1,0,0,0,1
383231871,1,0,0,0,1
383187802,1,0,0,0,1
383117231,1,0,0,0,1
383080007,0,0,1,0,1
383001817,1,0,0,0,1
382915957,1,0,0,0,1
382898134,1,0,0,0,1
382860269,0,0,1,0,1
382749079,1,0,0,0,1
382708371,0,0,1,0,1
382572424,0,0,1,0,1
382498029,1,0,0,0,1
382455281,1,0,0,0,1
382450631,0,0,0,1,1
382218860,1,0,0,0,1
382214233,0,0,1,0,1
382163659,1,0,0,0,1
383234265,1,0,0,0,1
383480316,1,0,0,0,1
385638714,1,0,0,0,1
383525988,0,0,1,0,1
385630107,1,0,0,0,1
385558721,1,0,0,0,1
385425813,1,0,0,0,1
385370887,1,0,0,0,1
385258090,1,0,0,0,1
385248797,1,0,0,0,1
385166054,1,0,0,0,1
384883997,0,0,1,0,1
384638084,1,0,0,0,1
384546695,0,0,1,0,1
384413290,1,0,0,0,1
384235573,0,0,1,0,1
383979841,0,0,1,0,1
383855837,1,0,0,0,1
383793841,1,0,0,0,1
383703901,0,0,1,0,1
383615076,1,0,0,0,1
375501529,0,0,1,0,1
375451243,1,0,0,0,1
361814116,1,0,0,0,1
367328551,1,0,0,0,1
367129649,1,0,0,0,1
367124043,0,0,1,0,1
366922406,1,0,0,0,1
366800813,1,0,0,0,1
366628161,0,0,1,0,1
366546827,1,0,0,0,1
366470668,1,0,0,0,1
366431108,1,0,0,0,1
366377975,1,0,0,0,1
366283494,0,0,1,0,1
366154108,1,0,0,0,1
365989993,1,0,0,0,1
365938535,1,0,0,0,1
365869902,0,0,1,0,1
365845844,0,0,1,0,1
365819135,0,0,0,1,1
365589126,1,0,0,0,1
367231035,0,0,0,1,1
367382526,1,0,0,0,1
365493358,1,0,0,0,1
367390713,1,0,0,0,1
368901342,0,0,1,0,1
368785877,1,0,0,0,1
368700813,0,0,1,0,1
368629649,0,0,1,0,1
368580200,1,0,0,0,1
368570321,0,0,1,0,1
368543083,1,0,0,0,1
368451481,1,0,0,0,1
368414381,1,0,0,0,1
368276707,0,0,1,0,1
368146547,0,0,1,0,1
368042440,0,0,1,0,1
367989777,0,0,1,0,1
367724384,0,0,1,0,1
367705043,1,0,0,0,1
367704372,1,0,0,0,1
367507745,0,0,1,0,1
365526556,1,0,0,0,1
365479070,1,0,0,0,1
369203714,0,0,1,0,1
363305238,0,0,1,0,1
363152304,1,0,0,0,1
363130739,1,0,0,0,1
363015389,0,0,1,0,1
363005435,0,0,1,0,1
362971554,1,0,0,0,1
362955034,0,0,1,0,1
362860202,1,0,0,0,1
362851420,1,0,0,0,1
362781480,0,0,1,0,1
362635506,1,0,0,0,1
362615913,1,0,0,0,1
362591996,1,0,0,0,1
362433699,1,0,0,0,1
362419479,0,0,1,0,1
362281804,0,0,1,0,1
361973567,1,0,0,0,1
361868048,1,0,0,0,1
363171869,0,0,1,0,1
363326797,0,0,1,0,1
365350027,1,0,0,0,1
363344191,0,0,0,1,1
365337143,1,0,0,0,1
365329145,1,0,0,0,1
365295082,1,0,0,0,1
365279318,1,0,0,0,1
365260642,1,0,0,0,1
365166797,0,0,1,0,1
364960386,0,0,1,0,1
364952392,1,0,0,0,1
364690311,1,0,0,0,1
364572188,0,0,0,1,1
364376879,1,0,0,0,1
364269372,1,0,0,0,1
364261771,1,0,0,0,1
364255290,0,0,1,0,1
363672432,1,0,0,0,1
363643848,1,0,0,0,1
363381319,1,0,0,0,1
368998469,1,0,0,0,1
369309284,0,0,1,0,1
375371764,0,0,1,0,1
374607003,1,0,0,0,1
374593637,1,0,0,0,1
374518555,1,0,0,0,1
374516933,0,1,0,0,1
374449219,0,0,1,0,1
374308047,1,0,0,0,1
374188925,1,0,0,0,1
374105886,1,0,0,0,1
374081944,1,0,0,0,1
374032448,1,0,0,0,1
373983477,1,0,0,0,1
373955746,0,0,1,0,1
373916913,0,0,0,1,1
373823609,0,0,1,0,1
373734101,1,0,0,0,1
373604254,0,0,1,0,1
373584750,0,0,1,0,1
373522899,0,1,0,0,1
374604891,0,0,1,0,1
374684744,1,0,0,0,1
373174959,1,0,0,0,1
374735401,1,0,0,0,1
375310869,0,0,1,0,1
375307184,0,0,1,0,1
375297023,1,0,0,0,1
375296427,1,0,0,0,1
375288951,1,0,0,0,1
375217586,1,0,0,0,1
375073900,1,0,0,0,1
375044940,0,1,0,0,1
375040445,0,0,1,0,1
375039363,1,0,0,0,1
375019665,1,0,0,0,1
374993676,1,0,0,0,1
374968989,1,0,0,0,1
374866296,0,0,1,0,1
374822883,0,0,1,0,1
374804480,0,0,1,0,1
374773389,1,0,0,0,1
373324108,0,1,0,0,1
373150096,1,0,0,0,1
369442791,1,0,0,0,1
371329980,0,0,0,1,1
371098672,1,0,0,0,1
371019748,0,0,1,0,1
370975408,1,0,0,0,1
370972093,1,0,0,0,1
370965607,0,0,1,0,1
370835210,0,0,1,0,1
370807118,0,0,1,0,1
370772965,1,0,0,0,1
370560523,0,0,1,0,1
370442577,1,0,0,0,1
370170848,1,0,0,0,1
370019723,0,0,1,0,1
369994560,1,0,0,0,1
369906131,1,0,0,0,1
369850877,1,0,0,0,1
369742736,1,0,0,0,1
369494394,0,0,1,0,1
371194284,0,0,1,0,1
371398232,0,0,1,0,1
373096495,1,0,0,0,1
371449690,0,0,1,0,1
373073512,1,0,0,0,1
373042041,1,0,0,0,1
372977893,0,0,1,0,1
372973706,1,0,0,0,1
372805273,1,0,0,0,1
372788555,1,0,0,0,1
372558343,1,0,0,0,1
372289021,0,0,1,0,1
372246062,1,0,0,0,1
372092255,1,0,0,0,1
372069426,1,0,0,0,1
371789143,0,0,1,0,1
371577746,1,0,0,0,1
371562400,0,0,1,0,1
371559902,1,0,0,0,1
371552119,1,0,0,0,1
371528958,0,0,1,0,1
436541589,1,0,0,0,1
436547566,1,0,0,0,1
436556245,1,0,0,0,1
485185772,0,0,1,0,1
485171377,1,0,0,0,1
485111492,0,0,1,0,1
485084447,1,0,0,0,1
485070807,1,0,0,0,1
485061457,0,0,1,0,1
485014634,0,0,1,0,1
484962232,0,0,1,0,1
484932854,1,0,0,0,1
484913874,1,0,0,0,1
484899399,1,0,0,0,1
484895556,1,0,0,0,1
484859277,0,0,1,0,1
484826444,1,0,0,0,1
484816344,1,0,0,0,1
484803943,1,0,0,0,1
484794931,1,0,0,0,1
484779336,1,0,0,0,1
485173366,1,0,0,0,1
485211326,1,0,0,0,1
484574667,1,0,0,0,1
485229795,0,0,1,0,1
485946841,1,0,0,0,1
485942766,1,0,0,0,1
485855824,1,0,0,0,1
485839643,1,0,0,0,1
485829640,1,0,0,0,1
485805518,1,0,0,0,1
485803252,0,0,1,0,1
485776753,0,0,1,0,1
485728963,1,0,0,0,1
485611808,1,0,0,0,1
485437101,1,0,0,0,1
485373398,0,0,1,0,1
485359574,1,0,0,0,1
485354838,1,0,0,0,1
485343193,0,0,1,0,1
485324628,1,0,0,0,1
485323152,1,0,0,0,1
484699969,0,0,1,0,1
484563208,1,0,0,0,1
485985198,1,0,0,0,1
483868898,0,0,1,0,1
483770088,0,0,1,0,1
483763106,1,0,0,0,1
483751627,0,0,1,0,1
483744092,0,0,1,0,1
483633753,1,0,0,0,1
483629476,1,0,0,0,1
483615094,1,0,0,0,1
483607409,0,0,1,0,1
483486885,0,0,1,0,1
483440846,1,0,0,0,1
483327588,0,0,1,0,1
483309434,1,0,0,0,1
483229880,0,0,1,0,1
483218347,1,0,0,0,1
483217856,1,0,0,0,1
483074683,1,0,0,0,1
483068348,1,0,0,0,1
483771253,1,0,0,0,1
483874061,0,0,1,0,1
484537981,1,0,0,0,1
483881086,1,0,0,0,1
484515382,1,0,0,0,1
484495739,1,0,0,0,1
484408284,0,0,1,0,1
484398197,1,0,0,0,1
484392800,0,0,1,0,1
484324985,1,0,0,0,1
484290309,1,0,0,0,1
484287403,1,0,0,0,1
484286846,0,0,1,0,1
484279403,1,0,0,0,1
484277903,1,0,0,0,1
484247176,1,0,0,0,1
484176167,1,0,0,0,1
484132818,0,0,1,0,1
484098387,1,0,0,0,1
484013577,1,0,0,0,1
483965676,1,0,0,0,1
485973297,1,0,0,0,1
485988649,1,0,0,0,1
483057505,1,0,0,0,1
487896351,0,0,1,0,1
487864032,1,0,0,0,1
487861036,1,0,0,0,1
487846236,1,0,0,0,1
487819923,1,0,0,0,1
487795291,1,0,0,0,1
487744769,1,0,0,0,1
487744763,1,0,0,0,1
487735818,1,0,0,0,1
487732145,1,0,0,0,1
487685421,1,0,0,0,1
487676932,0,0,1,0,1
487625803,1,0,0,0,1
487616169,1,0,0,0,1
487612714,1,0,0,0,1
487473676,1,0,0,0,1
487465936,1,0,0,0,1
487462757,1,0,0,0,1
487873033,1,0,0,0,1
488049608,0,0,1,0,1
487320634,0,0,1,0,1
488065285,1,0,0,0,1
488546512,1,0,0,0,1
488539431,1,0,0,0,1
488522261,1,0,0,0,1
488495961,1,0,0,0,1
488481206,1,0,0,0,1
488476526,1,0,0,0,1
488472966,1,0,0,0,1
488368251,0,0,1,0,1
488323459,0,0,1,0,1
488282340,0,0,1,0,1
488260221,1,0,0,0,1
488255635,0,0,1,0,1
488162997,0,0,1,0,1
488144253,0,0,1,0,1
488130450,1,0,0,0,1
488079018,1,0,0,0,1
488065800,1,0,0,0,1
487351657,1,0,0,0,1
487300451,0,0,1,0,1
486042229,1,0,0,0,1
486793548,1,0,0,0,1
486770819,1,0,0,0,1
486764652,1,0,0,0,1
486734376,1,0,0,0,1
486730231,1,0,0,0,1
486718434,1,0,0,0,1
486649903,1,0,0,0,1
486633028,0,0,1,0,1
486610912,0,0,1,0,1
486493763,0,0,1,0,1
486480555,1,0,0,0,1
486464662,0,0,1,0,1
486339875,1,0,0,0,1
486316837,1,0,0,0,1
486247851,1,0,0,0,1
486203412,1,0,0,0,1
486110460,0,0,1,0,1
486090705,1,0,0,0,1
486789740,1,0,0,0,1
486808291,1,0,0,0,1
487295439,1,0,0,0,1
486817080,1,0,0,0,1
487252842,1,0,0,0,1
487244381,1,0,0,0,1
487219193,1,0,0,0,1
487215434,0,0,1,0,1
487163726,1,0,0,0,1
487162533,1,0,0,0,1
487112126,1,0,0,0,1
487101544,1,0,0,0,1
487101093,1,0,0,0,1
487045208,1,0,0,0,1
487016673,1,0,0,0,1
486933976,1,0,0,0,1
486927614,0,0,1,0,1
486875574,1,0,0,0,1
486830876,1,0,0,0,1
486827448,0,0,1,0,1
486824757,0,0,1,0,1
483059771,1,0,0,0,1
483007321,0,0,1,0,1
488624774,1,0,0,0,1
478793484,0,0,1,0,1
478745760,0,0,1,0,1
478741811,1,0,0,0,1
478704134,1,0,0,0,1
478702177,1,0,0,0,1
478680126,0,0,1,0,1
478624829,0,0,1,0,1
478621955,0,0,1,0,1
478611111,0,0,1,0,1
478586325,1,0,0,0,1
478459336,1,0,0,0,1
478456160,1,0,0,0,1
478448449,1,0,0,0,1
478436679,1,0,0,0,1
478341085,1,0,0,0,1
478319808,1,0,0,0,1
478160947,0,0,1,0,1
478126038,0,0,1,0,1
478751274,0,0,1,0,1
478853010,1,0,0,0,1
478063298,1,0,0,0,1
478858562,0,0,1,0,1
479823248,0,0,1,0,1
479558506,1,0,0,0,1
479531200,1,0,0,0,1
479419660,1,0,0,0,1
479405522,1,0,0,0,1
479353659,0,0,1,0,1
479291997,0,0,1,0,1
479247124,1,0,0,0,1
479235301,1,0,0,0,1
479120264,1,0,0,0,1
479109924,1,0,0,0,1
479109639,1,0,0,0,1
479097030,0,0,1,0,1
479060864,0,0,1,0,1
478958012,1,0,0,0,1
478954712,1,0,0,0,1
478887744,0,0,1,0,1
478094511,0,0,1,0,1
477986362,1,0,0,0,1
479851009,0,0,1,0,1
476797648,0,0,1,0,1
476667079,1,0,0,0,1
476666525,1,0,0,0,1
476632391,0,0,1,0,1
476614247,1,0,0,0,1
476583114,1,0,0,0,1
476553901,0,0,1,0,1
476541588,1,0,0,0,1
476462867,1,0,0,0,1
476420513,1,0,0,0,1
476342614,1,0,0,0,1
476306741,1,0,0,0,1
476302196,1,0,0,0,1
476281829,0,0,1,0,1
476279438,0,0,1,0,1
476248743,1,0,0,0,1
476228262,0,0,1,0,1
476223618,0,0,1,0,1
476708855,1,0,0,0,1
476858753,1,0,0,0,1
477963283,1,0,0,0,1
476873009,0,0,1,0,1
477896633,1,0,0,0,1
477810951,0,0,1,0,1
477752095,1,0,0,0,1
477669980,1,0,0,0,1
477581304,1,0,0,0,1
477578342,1,0,0,0,1
477481580,1,0,0,0,1
477426357,0,0,1,0,1
477278664,1,0,0,0,1
477257195,0,0,1,0,1
477237877,1,0,0,0,1
477199909,0,0,1,0,1
477167118,0,0,1,0,1
477140532,1,0,0,0,1
477131459,1,0,0,0,1
476983386,1,0,0,0,1
476883690,1,0,0,0,1
479833121,1,0,0,0,1
479952821,1,0,0,0,1
482957454,1,0,0,0,1
482101892,1,0,0,0,1
481938286,0,0,1,0,1
481930684,1,0,0,0,1
481893833,1,0,0,0,1
481833651,0,0,1,0,1
481810723,1,0,0,0,1
481780830,1,0,0,0,1
481741155,1,0,0,0,1
481642557,1,0,0,0,1
481639634,1,0,0,0,1
481555716,1,0,0,0,1
481554665,1,0,0,0,1
481502481,0,0,1,0,1
481483120,1,0,0,0,1
481452777,1,0,0,0,1
481451665,1,0,0,0,1
481431731,1,0,0,0,1
481431538,0,0,1,0,1
482047667,1,0,0,0,1
482278094,0,0,1,0,1
481411059,0,0,1,0,1
482318049,1,0,0,0,1
482943758,0,0,1,0,1
482930192,1,0,0,0,1
482929446,1,0,0,0,1
482914016,0,0,1,0,1
482911907,1,0,0,0,1
482903733,1,0,0,0,1
482900720,1,0,0,0,1
482862186,1,0,0,0,1
482814253,1,0,0,0,1
482673736,0,0,1,0,1
482612537,0,0,1,0,1
482538354,1,0,0,0,1
482532704,1,0,0,0,1
482505101,1,0,0,0,1
482353949,0,0,1,0,1
482351835,0,0,1,0,1
482330811,1,0,0,0,1
481426303,0,0,1,0,1
481395079,0,0,1,0,1
480027395,1,0,0,0,1
480475204,0,0,1,0,1
480391007,0,0,1,0,1
480385047,1,0,0,0,1
480373613,1,0,0,0,1
480328832,1,0,0,0,1
480320061,1,0,0,0,1
480306795,0,0,1,0,1
480293174,1,0,0,0,1
480252588,1,0,0,0,1
480237147,0,0,1,0,1
480236688,1,0,0,0,1
480209472,1,0,0,0,1
480175135,1,0,0,0,1
480118202,1,0,0,0,1
480094583,1,0,0,0,1
480084040,1,0,0,0,1
480068366,1,0,0,0,1
480054909,0,0,1,0,1
480471392,0,0,0,1,1
480516328,0,0,1,0,1
481328584,1,0,0,0,1
480577061,1,0,0,0,1
481311244,1,0,0,0,1
481263266,0,0,1,0,1
481248312,1,0,0,0,1
481222916,1,0,0,0,1
481127562,0,0,1,0,1
481048209,1,0,0,0,1
481048164,0,0,1,0,1
481029866,1,0,0,0,1
480980663,1,0,0,0,1
480961292,0,0,1,0,1
480857366,0,0,1,0,1
480770456,1,0,0,0,1
480764728,0,0,1,0,1
480762641,0,0,1,0,1
480702161,1,0,0,0,1
480652547,0,0,1,0,1
480647027,1,0,0,0,1
488599936,1,0,0,0,1
488635972,1,0,0,0,1
476207170,1,0,0,0,1
497908128,1,0,0,0,1
497802176,1,0,0,0,1
497598466,0,0,1,0,1
497594297,0,0,1,0,1
497588950,1,0,0,0,1
497586419,0,0,1,0,1
497494661,1,0,0,0,1
497290653,1,0,0,0,1
497150078,1,0,0,0,1
497128249,1,0,0,0,1
497104003,0,0,1,0,1
497083839,1,0,0,0,1
496995514,1,0,0,0,1
496922858,1,0,0,0,1
496916072,1,0,0,0,1
496858629,0,0,1,0,1
496749638,1,0,0,0,1
496675940,0,0,1,0,1
497858552,1,0,0,0,1
497952874,0,0,1,0,1
496617784,0,0,1,0,1
497983868,0,0,1,0,1
499313046,0,0,1,0,1
499071357,1,0,0,0,1
499068203,0,0,1,0,1
498983290,1,0,0,0,1
498926245,0,0,1,0,1
498897848,1,0,0,0,1
498818487,1,0,0,0,1
498573400,1,0,0,0,1
498430936,1,0,0,0,1
498414968,1,0,0,0,1
498379429,0,0,1,0,1
498216067,1,0,0,0,1
498140931,1,0,0,0,1
498135066,1,0,0,0,1
498076311,1,0,0,0,1
498057029,1,0,0,0,1
497992899,1,0,0,0,1
496656714,1,0,0,0,1
496595115,1,0,0,0,1
499364544,1,0,0,0,1
495208457,1,0,0,0,1
495161470,1,0,0,0,1
495152817,1,0,0,0,1
495152281,0,0,1,0,1
495128593,1,0,0,0,1
495123710,1,0,0,0,1
495031721,1,0,0,0,1
495024042,0,0,1,0,1
495001759,0,0,1,0,1
494968798,0,0,1,0,1
494946040,1,0,0,0,1
494941408,0,0,1,0,1
494894516,1,0,0,0,1
494891626,1,0,0,0,1
494863140,1,0,0,0,1
494853622,1,0,0,0,1
494830696,1,0,0,0,1
494823562,1,0,0,0,1
495202358,0,0,1,0,1
495220547,1,0,0,0,1
496474632,0,0,0,1,1
495367057,1,0,0,0,1
496466111,1,0,0,0,1
496438033,0,0,1,0,1
496210514,0,0,1,0,1
496110788,1,0,0,0,1
496038617,1,0,0,0,1
496038581,0,0,1,0,1
495895786,0,0,1,0,1
495723535,1,0,0,0,1
495685976,1,0,0,0,1
495665151,0,0,1,0,1
495575428,1,0,0,0,1
495572193,1,0,0,0,1
495555539,1,0,0,0,1
495531149,1,0,0,0,1
495455523,0,0,1,0,1
495429272,0,0,1,0,1
495392808,1,0,0,0,1
499363064,0,0,1,0,1
499380885,0,0,1,0,1
494779190,1,0,0,0,1
503067817,0,0,1,0,1
502961936,0,0,1,0,1
502860319,1,0,0,0,1
502827743,1,0,0,0,1
502735846,1,0,0,0,1
502693559,0,0,1,0,1
502665539,1,0,0,0,1
502630726,1,0,0,0,1
502492269,0,0,1,0,1
502204063,1,0,0,0,1
502200353,0,0,1,0,1
502195527,0,0,1,0,1
502134137,1,0,0,0,1
502035912,1,0,0,0,1
502013143,1,0,0,0,1
501989137,1,0,0,0,1
501901357,1,0,0,0,1
501895733,1,0,0,0,1
503067251,0,0,1,0,1
503117175,1,0,0,0,1
501809937,0,0,1,0,1
503172463,0,0,1,0,1
503757175,1,0,0,0,1
503726515,1,0,0,0,1
503718879,1,0,0,0,1
503593397,1,0,0,0,1
503579221,1,0,0,0,1
503563559,1,0,0,0,1
503556906,0,0,1,0,1
503542653,0,0,1,0,1
503540971,0,0,1,0,1
503507946,1,0,0,0,1
503463560,1,0,0,0,1
503445703,0,0,1,0,1
503431002,1,0,0,0,1
503398601,1,0,0,0,1
503378668,1,0,0,0,1
503294089,1,0,0,0,1
503254407,0,0,1,0,1
501810381,0,0,1,0,1
501499086,1,0,0,0,1
499392898,1,0,0,0,1
500466854,0,0,1,0,1
500394455,1,0,0,0,1
500342826,1,0,0,0,1
500322453,0,0,1,0,1
500280579,0,0,1,0,1
500236217,0,0,1,0,1
500150447,1,0,0,0,1
500021882,1,0,0,0,1
500012134,1,0,0,0,1
500002037,1,0,0,0,1
499914915,0,0,1,0,1
499897372,0,0,1,0,1
499780866,1,0,0,0,1
499774224,1,0,0,0,1
499727511,1,0,0,0,1
499723851,1,0,0,0,1
499645233,0,0,1,0,1
499585896,1,0,0,0,1
500407084,1,0,0,0,1
500473166,1,0,0,0,1
501429913,1,0,0,0,1
500489684,1,0,0,0,1
501152044,1,0,0,0,1
501136181,1,0,0,0,1
501108264,0,0,1,0,1
501105581,0,0,1,0,1
501081040,1,0,0,0,1
501006297,1,0,0,0,1
500934819,1,0,0,0,1
500914053,1,0,0,0,1
500900954,1,0,0,0,1
500887745,1,0,0,0,1
500886235,0,0,1,0,1
500811896,1,0,0,0,1
500803340,1,0,0,0,1
500541724,1,0,0,0,1
500535172,1,0,0,0,1
500533959,0,0,1,0,1
500501741,0,0,1,0,1
494809273,1,0,0,0,1
494720997,0,0,1,0,1
488645097,0,0,1,0,1
490325647,0,0,1,0,1
490259984,0,0,1,0,1
490259214,1,0,0,0,1
490255439,1,0,0,0,1
490249930,0,0,1,0,1
490248915,1,0,0,0,1
490244497,0,0,1,0,1
490237372,0,0,1,0,1
490218837,0,0,1,0,1
490208841,1,0,0,0,1
490206795,1,0,0,0,1
490139030,1,0,0,0,1
490134847,1,0,0,0,1
490117218,1,0,0,0,1
490085300,1,0,0,0,1
490006452,1,0,0,0,1
489999916,1,0,0,0,1
489996729,1,0,0,0,1
490267039,1,0,0,0,1
490351203,1,0,0,0,1
489963985,1,0,0,0,1
490402176,0,0,1,0,1
491091990,1,0,0,0,1
491091084,0,0,1,0,1
490960527,1,0,0,0,1
490954959,1,0,0,0,1
490942622,1,0,0,0,1
490940871,1,0,0,0,1
490879586,1,0,0,0,1
490871569,1,0,0,0,1
490856120,1,0,0,0,1
490822596,1,0,0,0,1
490767259,0,0,1,0,1
490742719,0,0,1,0,1
490628688,1,0,0,0,1
490628648,0,0,1,0,1
490566485,1,0,0,0,1
490544246,1,0,0,0,1
490452317,1,0,0,0,1
489989672,1,0,0,0,1
489955848,0,0,1,0,1
491183847,1,0,0,0,1
489515103,1,0,0,0,1
489350364,1,0,0,0,1
489349967,0,0,1,0,1
489230483,1,0,0,0,1
489115483,1,0,0,0,1
489011256,1,0,0,0,1
488974314,1,0,0,0,1
488961311,0,0,1,0,1
488961149,0,0,1,0,1
488930659,1,0,0,0,1
488875309,0,0,1,0,1
488819150,1,0,0,0,1
488798902,0,0,1,0,1
488767748,0,0,1,0,1
488754512,1,0,0,0,1
488754388,1,0,0,0,1
488677595,1,0,0,0,1
488657089,1,0,0,0,1
489462323,1,0,0,0,1
489523092,1,0,0,0,1
489948289,1,0,0,0,1
489532090,1,0,0,0,1
489930689,0,0,1,0,1
489891925,1,0,0,0,1
489865818,1,0,0,0,1
489845768,1,0,0,0,1
489774110,0,0,1,0,1
489767638,1,0,0,0,1
489742150,1,0,0,0,1
489710978,1,0,0,0,1
489665309,1,0,0,0,1
489660544,0,0,1,0,1
489645502,1,0,0,0,1
489634031,0,0,0,1,1
489623638,1,0,0,0,1
489622782,1,0,0,0,1
489622236,1,0,0,0,1
489589484,0,0,1,0,1
489538309,1,0,0,0,1
491094535,1,0,0,0,1
491191446,1,0,0,0,1
494661917,1,0,0,0,1
493730096,1,0,0,0,1
493553636,0,0,1,0,1
493545167,1,0,0,0,1
493533274,1,0,0,0,1
493519247,1,0,0,0,1
493509193,1,0,0,0,1
493473453,1,0,0,0,1
493425260,0,0,1,0,1
493346404,0,0,1,0,1
493257026,1,0,0,0,1
493241158,1,0,0,0,1
493221489,1,0,0,0,1
493205635,1,0,0,0,1
493195190,0,0,1,0,1
493191472,1,0,0,0,1
493143034,1,0,0,0,1
493071199,1,0,0,0,1
493049394,1,0,0,0,1
493556858,1,0,0,0,1
493739633,0,0,1,0,1
493014158,0,0,1,0,1
493870734,0,0,1,0,1
494660107,0,0,1,0,1
494642045,1,0,0,0,1
494636504,1,0,0,0,1
494632237,1,0,0,0,1
494565867,1,0,0,0,1
494562913,1,0,0,0,1
494371299,1,0,0,0,1
494367927,0,0,1,0,1
494325012,0,0,1,0,1
494322472,1,0,0,0,1
494318769,1,0,0,0,1
494158698,1,0,0,0,1
494085113,1,0,0,0,1
493950544,0,0,1,0,1
493949425,0,0,1,0,1
493947159,1,0,0,0,1
493903378,0,0,1,0,1
493039547,0,0,1,0,1
493010735,0,0,1,0,1
491197167,1,0,0,0,1
492044795,1,0,0,0,1
492034586,0,0,1,0,1
491950794,0,0,1,0,1
491949715,0,0,1,0,1
491927132,1,0,0,0,1
491834352,0,0,1,0,1
491797998,0,0,1,0,1
491790606,0,0,1,0,1
491688517,1,0,0,0,1
491612635,1,0,0,0,1
491546827,0,0,1,0,1
491520818,1,0,0,0,1
491513126,1,0,0,0,1
491482383,1,0,0,0,1
491436433,1,0,0,0,1
491354614,1,0,0,0,1
491273013,1,0,0,0,1
491204291,1,0,0,0,1
492041488,1,0,0,0,1
492085056,1,0,0,0,1
492999539,1,0,0,0,1
492123147,1,0,0,0,1
492849680,0,0,1,0,1
492758906,1,0,0,0,1
492712557,1,0,0,0,1
492594506,0,0,1,0,1
492550771,1,0,0,0,1
492533967,1,0,0,0,1
492466391,1,0,0,0,1
492458108,1,0,0,0,1
492448702,0,0,1,0,1
492417898,0,0,1,0,1
492294901,1,0,0,0,1
492274451,1,0,0,0,1
492175196,1,0,0,0,1
492152791,0,0,1,0,1
492145349,1,0,0,0,1
492143955,1,0,0,0,1
492141179,1,0,0,0,1
476222456,1,0,0,0,1
476205843,1,0,0,0,1
436565885,1,0,0,0,1
451776967,1,0,0,0,1
451677867,1,0,0,0,1
451628647,1,0,0,0,1
451557423,1,0,0,0,1
451463218,0,0,1,0,1
451383898,0,0,1,0,1
451261962,1,0,0,0,1
451230943,0,0,1,0,1
450977842,1,0,0,0,1
450923110,0,0,0,1,1
450802789,1,0,0,0,1
450800384,1,0,0,0,1
450794152,0,0,1,0,1
450769596,1,0,0,0,1
450746899,0,0,1,0,1
450631182,1,0,0,0,1
450345002,1,0,0,0,1
450204989,1,0,0,0,1
451720279,1,0,0,0,1
451866547,1,0,0,0,1
450089462,1,0,0,0,1
451983217,1,0,0,0,1
452800382,1,0,0,0,1
452781216,1,0,0,0,1
452776580,1,0,0,0,1
452699674,0,0,1,0,1
452631152,0,0,1,0,1
452546500,1,0,0,0,1
452518213,0,0,1,0,1
452459370,1,0,0,0,1
452443129,0,0,1,0,1
452419611,0,0,1,0,1
452371640,1,0,0,0,1
452323240,1,0,0,0,1
452312087,0,0,1,0,1
452278012,1,0,0,0,1
452163088,0,0,1,0,1
452136788,0,0,1,0,1
452034819,1,0,0,0,1
450095749,1,0,0,0,1
450072305,1,0,0,0,1
452903553,0,0,1,0,1
448910326,1,0,0,0,1
448645046,1,0,0,0,1
448577768,1,0,0,0,1
448456175,1,0,0,0,1
448403084,1,0,0,0,1
448251181,0,0,1,0,1
448183921,1,0,0,0,1
448142693,0,0,1,0,1
448131740,1,0,0,0,1
448129815,1,0,0,0,1
448121491,1,0,0,0,1
448112944,1,0,0,0,1
448038989,1,0,0,0,1
447971713,0,0,1,0,1
447914116,0,0,1,0,1
447844374,1,0,0,0,1
447788073,1,0,0,0,1
447733927,1,0,0,0,1
448739722,1,0,0,0,1
448923871,1,0,0,0,1
450029902,1,0,0,0,1
448978880,1,0,0,0,1
450004845,1,0,0,0,1
449966519,1,0,0,0,1
449903407,1,0,0,0,1
449796815,0,0,1,0,1
449618341,1,0,0,0,1
449600773,1,0,0,0,1
449578174,1,0,0,0,1
449529549,1,0,0,0,1
449449822,1,0,0,0,1
449410335,1,0,0,0,1
449398631,1,0,0,0,1
449343904,1,0,0,0,1
449162380,1,0,0,0,1
449142399,1,0,0,0,1
449129729,0,0,1,0,1
449071316,1,0,0,0,1
449045592,0,0,1,0,1
452868879,1,0,0,0,1
453020340,1,0,0,0,1
447616717,1,0,0,0,1
457346413,0,0,1,0,1
456960881,1,0,0,0,1
456940606,1,0,0,0,1
456935537,1,0,0,0,1
456864421,1,0,0,0,1
456852389,1,0,0,0,1
456830372,1,0,0,0,1
456787681,1,0,0,0,1
456692574,1,0,0,0,1
456654308,1,0,0,0,1
456652626,1,0,0,0,1
456381108,1,0,0,0,1
456331483,1,0,0,0,1
456184344,1,0,0,0,1
456025174,0,0,1,0,1
455935615,0,0,1,0,1
455883834,0,0,1,0,1
455836343,1,0,0,0,1
457200545,1,0,0,0,1
457352598,1,0,0,0,1
455764641,0,0,1,0,1
457438946,1,0,0,0,1
458580001,1,0,0,0,1
458554331,1,0,0,0,1
458489090,1,0,0,0,1
458447508,1,0,0,0,1
458389211,1,0,0,0,1
458349523,0,0,1,0,1
458319841,1,0,0,0,1
458284863,0,0,1,0,1
458231575,1,0,0,0,1
458058844,0,0,1,0,1
457926465,1,0,0,0,1
457805461,1,0,0,0,1
457696365,1,0,0,0,1
457510836,1,0,0,0,1
457491342,1,0,0,0,1
457467711,1,0,0,0,1
457440001,1,0,0,0,1
455808073,1,0,0,0,1
455685325,1,0,0,0,1
453028431,1,0,0,0,1
454168664,1,0,0,0,1
453975705,0,0,1,0,1
453929627,1,0,0,0,1
453806741,1,0,0,0,1
453781302,0,0,1,0,1
453777289,1,0,0,0,1
453698319,1,0,0,0,1
453691658,0,0,0,1,1
453681661,0,0,1,0,1
453667806,0,0,1,0,1
453609666,1,0,0,0,1
453528099,1,0,0,0,1
453478436,1,0,0,0,1
453374858,0,0,1,0,1
453301982,1,0,0,0,1
453271960,1,0,0,0,1
453152053,1,0,0,0,1
453101466,0,0,1,0,1
454096782,1,0,0,0,1
454293452,1,0,0,0,1
455637441,1,0,0,0,1
454299936,1,0,0,0,1
455525453,1,0,0,0,1
455504362,1,0,0,0,1
455475296,1,0,0,0,1
455397819,0,0,1,0,1
455217956,1,0,0,0,1
455175874,0,0,1,0,1
455130272,1,0,0,0,1
455117561,1,0,0,0,1
455032099,1,0,0,0,1
454915673,1,0,0,0,1
454792599,1,0,0,0,1
454744425,1,0,0,0,1
454700211,0,0,1,0,1
454437633,1,0,0,0,1
454408233,1,0,0,0,1
454319729,1,0,0,0,1
454300308,1,0,0,0,1
447621395,0,0,1,0,1
447604359,0,0,1,0,1
458598023,0,0,1,0,1
440957041,0,0,1,0,1
440916771,0,0,1,0,1
440874686,1,0,0,0,1
440585824,1,0,0,0,1
440547444,1,0,0,0,1
440507344,1,0,0,0,1
440482754,1,0,0,0,1
440462361,1,0,0,0,1
440455214,1,0,0,0,1
440447377,1,0,0,0,1
440438563,1,0,0,0,1
440374918,1,0,0,0,1
440355290,0,0,1,0,1
440326642,1,0,0,0,1
440162236,1,0,0,0,1
440143258,1,0,0,0,1
440069848,0,0,0,1,1
439618577,1,0,0,0,1
440923122,1,0,0,0,1
441017280,1,0,0,0,1
439562397,1,0,0,0,1
441036942,1,0,0,0,1
442243452,1,0,0,0,1
442212179,1,0,0,0,1
442156389,1,0,0,0,1
442137835,1,0,0,0,1
442133039,0,0,1,0,1
441951432,1,0,0,0,1
441796951,1,0,0,0,1
441785236,1,0,0,0,1
441644824,0,0,1,0,1
441603048,1,0,0,0,1
441561115,1,0,0,0,1
441527146,0,0,1,0,1
441499832,0,0,1,0,1
441470396,1,0,0,0,1
441464233,0,0,1,0,1
441206328,1,0,0,0,1
441084094,1,0,0,0,1
439600694,0,0,1,0,1
439545697,1,0,0,0,1
442311487,1,0,0,0,1
438305064,0,0,1,0,1
438095884,1,0,0,0,1
438045606,0,0,1,0,1
437920123,1,0,0,0,1
437884992,1,0,0,0,1
437752238,1,0,0,0,1
437735069,0,0,1,0,1
437696570,0,0,1,0,1
437529818,1,0,0,0,1
437416126,1,0,0,0,1
437305554,1,0,0,0,1
437285154,0,0,1,0,1
437153923,1,0,0,0,1
436766081,0,0,1,0,1
436705188,1,0,0,0,1
436672443,0,0,1,0,1
436619088,1,0,0,0,1
436580929,1,0,0,0,1
438220335,1,0,0,0,1
438341134,0,0,1,0,1
439505802,0,0,1,0,1
438342469,1,0,0,0,1
439455229,0,0,1,0,1
439436915,1,0,0,0,1
439429870,1,0,0,0,1
439391608,0,0,1,0,1
439289821,0,0,1,0,1
439271111,1,0,0,0,1
439221511,1,0,0,0,1
439181612,1,0,0,0,1
439066367,1,0,0,0,1
438883913,1,0,0,0,1
438862630,1,0,0,0,1
438793405,1,0,0,0,1
438613649,0,0,1,0,1
438577001,1,0,0,0,1
438497106,0,0,1,0,1
438474320,1,0,0,0,1
438367600,0,0,1,0,1
442253364,0,0,1,0,1
442326310,1,0,0,0,1
447548618,1,0,0,0,1
446049347,1,0,0,0,1
445892124,1,0,0,0,1
445862738,1,0,0,0,1
445858732,1,0,0,0,1
445817673,1,0,0,0,1
445742312,0,0,1,0,1
445739897,1,0,0,0,1
445714114,1,0,0,0,1
445694721,1,0,0,0,1
445581518,0,0,1,0,1
445563777,1,0,0,0,1
445515482,0,0,1,0,1
445486546,1,0,0,0,1
445420988,0,0,1,0,1
445356945,1,0,0,0,1
445351287,0,0,1,0,1
445332821,1,0,0,0,1
445219407,0,0,1,0,1
446026882,0,0,1,0,1
446157229,1,0,0,0,1
445024498,1,0,0,0,1
446220451,1,0,0,0,1
447394100,1,0,0,0,1
447327628,1,0,0,0,1
447287481,1,0,0,0,1
447283837,1,0,0,0,1
447277698,0,0,1,0,1
447250856,0,0,1,0,1
447189172,1,0,0,0,1
447085439,0,0,1,0,1
447001912,1,0,0,0,1
446963829,0,0,1,0,1
446854139,1,0,0,0,1
446617811,0,0,1,0,1
446568807,0,0,1,0,1
446435330,1,0,0,0,1
446415785,1,0,0,0,1
446383801,1,0,0,0,1
446278592,1,0,0,0,1
445063647,1,0,0,0,1
444733308,0,0,1,0,1
442449520,1,0,0,0,1
443464580,1,0,0,0,1
443414797,0,0,1,0,1
443405103,0,0,1,0,1
443310211,1,0,0,0,1
443273439,1,0,0,0,1
443249212,0,0,1,0,1
443206975,1,0,0,0,1
443128236,1,0,0,0,1
443115422,1,0,0,0,1
443102829,1,0,0,0,1
442884668,0,0,1,0,1
442877665,0,0,1,0,1
442706042,1,0,0,0,1
442705792,1,0,0,0,1
442679011,0,0,1,0,1
442651716,0,0,0,1,1
442630998,1,0,0,0,1
442539135,1,0,0,0,1
443450883,0,0,1,0,1
443485515,1,0,0,0,1
444686670,0,0,1,0,1
443515330,1,0,0,0,1
444665862,0,0,1,0,1
444659093,1,0,0,0,1
444637487,0,0,1,0,1
444607348,1,0,0,0,1
444548081,1,0,0,0,1
444510266,1,0,0,0,1
444457278,0,0,1,0,1
444425761,1,0,0,0,1
444413982,1,0,0,0,1
444363046,1,0,0,0,1
444248960,0,0,1,0,1
444139089,1,0,0,0,1
444099707,0,0,1,0,1
444084702,0,0,1,0,1
443959268,0,0,1,0,1
443906271,0,0,1,0,1
443862589,1,0,0,0,1
458582247,1,0,0,0,1
458662896,1,0,0,0,1
476172520,0,0,1,0,1
470086709,1,0,0,0,1
470061687,1,0,0,0,1
470044067,1,0,0,0,1
470020762,1,0,0,0,1
470005375,1,0,0,0,1
469988267,1,0,0,0,1
469970638,1,0,0,0,1
469938705,1,0,0,0,1
469892488,1,0,0,0,1
469847031,1,0,0,0,1
469822760,1,0,0,0,1
469822428,1,0,0,0,1
469802403,0,0,1,0,1
469680566,1,0,0,0,1
469539619,1,0,0,0,1
469518763,1,0,0,0,1
469499561,1,0,0,0,1
469437545,1,0,0,0,1
470064540,1,0,0,0,1
470171461,1,0,0,0,1
469317996,0,0,1,0,1
470283396,1,0,0,0,1
471301818,1,0,0,0,1
471293222,1,0,0,0,1
471243431,1,0,0,0,1
471204759,1,0,0,0,1
471188783,0,0,1,0,1
471182640,1,0,0,0,1
471180844,1,0,0,0,1
471177409,1,0,0,0,1
471172585,1,0,0,0,1
471130592,1,0,0,0,1
471023828,1,0,0,0,1
470975288,1,0,0,0,1
470963698,1,0,0,0,1
470939748,1,0,0,0,1
470667341,1,0,0,0,1
470587727,0,0,1,0,1
470358442,1,0,0,0,1
469332856,0,0,1,0,1
469272984,1,0,0,0,1
471369265,0,0,1,0,1
468346332,1,0,0,0,1
468181485,1,0,0,0,1
468146584,1,0,0,0,1
468078621,1,0,0,0,1
468011490,1,0,0,0,1
467975030,1,0,0,0,1
467903463,1,0,0,0,1
467887955,0,0,1,0,1
467872558,1,0,0,0,1
467766688,1,0,0,0,1
467676796,1,0,0,0,1
467596753,1,0,0,0,1
467502816,1,0,0,0,1
467452423,0,0,1,0,1
467416900,0,0,1,0,1
467249780,1,0,0,0,1
467228184,0,0,1,0,1
467169085,1,0,0,0,1
468197743,1,0,0,0,1
468394768,0,0,1,0,1
469266451,1,0,0,0,1
468511305,1,0,0,0,1
469264044,1,0,0,0,1
469262035,0,0,1,0,1
469261629,1,0,0,0,1
469258676,1,0,0,0,1
469158046,1,0,0,0,1
469145934,1,0,0,0,1
469110412,1,0,0,0,1
469097275,1,0,0,0,1
469054694,1,0,0,0,1
468978479,1,0,0,0,1
468902614,1,0,0,0,1
468769212,0,0,1,0,1
468749236,0,0,1,0,1
468736006,1,0,0,0,1
468618141,0,0,1,0,1
468574952,0,0,1,0,1
468542989,1,0,0,0,1
471350570,1,0,0,0,1
471449147,1,0,0,0,1
467087651,1,0,0,0,1
474812824,1,0,0,0,1
474495074,0,0,1,0,1
474492243,1,0,0,0,1
474365064,1,0,0,0,1
474358101,0,0,1,0,1
474352505,1,0,0,0,1
474348453,1,0,0,0,1
474238830,1,0,0,0,1
474179864,0,0,1,0,1
474157365,1,0,0,0,1
474140078,0,0,1,0,1
474013173,1,0,0,0,1
473861306,1,0,0,0,1
473847345,1,0,0,0,1
473838452,1,0,0,0,1
473696790,0,0,1,0,1
473676042,1,0,0,0,1
473659181,1,0,0,0,1
474812165,1,0,0,0,1
474829712,0,0,1,0,1
473457595,1,0,0,0,1
474861044,0,0,1,0,1
476125058,1,0,0,0,1
476093844,1,0,0,0,1
475822306,0,0,1,0,1
475789318,0,0,1,0,1
475695083,0,0,1,0,1
475625876,0,0,1,0,1
475533024,1,0,0,0,1
475418348,1,0,0,0,1
475395086,1,0,0,0,1
475322393,0,0,1,0,1
475318457,1,0,0,0,1
475215998,0,0,1,0,1
475205333,0,0,1,0,1
475045062,0,0,1,0,1
474983433,1,0,0,0,1
474955473,1,0,0,0,1
474954733,1,0,0,0,1
473555416,0,0,1,0,1
473450334,1,0,0,0,1
471460452,1,0,0,0,1
472114792,1,0,0,0,1
472045434,0,0,1,0,1
472043490,1,0,0,0,1
472027255,1,0,0,0,1
472013824,1,0,0,0,1
471970176,1,0,0,0,1
471944683,0,0,1,0,1
471939490,0,0,1,0,1
471936383,1,0,0,0,1
471726877,0,0,1,0,1
471710575,1,0,0,0,1
471648933,1,0,0,0,1
471569289,0,0,1,0,1
471552056,0,0,1,0,1
471543501,1,0,0,0,1
471508880,1,0,0,0,1
471483581,1,0,0,0,1
471461245,0,0,1,0,1
472103163,1,0,0,0,1
472125262,1,0,0,0,1
473396832,1,0,0,0,1
472195874,1,0,0,0,1
473341105,0,0,1,0,1
473309072,1,0,0,0,1
473203096,1,0,0,0,1
473188688,1,0,0,0,1
473128114,1,0,0,0,1
472962200,1,0,0,0,1
472836641,1,0,0,0,1
472794721,1,0,0,0,1
472739248,1,0,0,0,1
472494699,1,0,0,0,1
472493438,1,0,0,0,1
472437221,1,0,0,0,1
472436951,1,0,0,0,1
472422648,1,0,0,0,1
472372377,0,0,1,0,1
472293284,1,0,0,0,1
472197726,1,0,0,0,1
467155839,1,0,0,0,1
467008899,1,0,0,0,1
458726032,1,0,0,0,1
461686330,1,0,0,0,1
461629715,1,0,0,0,1
461612241,1,0,0,0,1
461591006,1,0,0,0,1
461517030,1,0,0,0,1
461399954,1,0,0,0,1
461378304,0,0,1,0,1
461285892,0,0,1,0,1
461263600,1,0,0,0,1
461252637,1,0,0,0,1
461236294,1,0,0,0,1
461132126,1,0,0,0,1
461114549,0,0,1,0,1
461053338,1,0,0,0,1
461008044,1,0,0,0,1
460804125,0,0,1,0,1
460750980,1,0,0,0,1
460737968,1,0,0,0,1
461685356,0,0,1,0,1
461710687,1,0,0,0,1
460459520,1,0,0,0,1
461777806,1,0,0,0,1
462595553,1,0,0,0,1
462582919,0,0,1,0,1
462558289,0,0,1,0,1
462518756,1,0,0,0,1
462389696,0,0,1,0,1
462364312,1,0,0,0,1
462303111,0,0,1,0,1
462225990,1,0,0,0,1
462104983,1,0,0,0,1
462068289,1,0,0,0,1
462025910,0,0,1,0,1
461959453,1,0,0,0,1
461933717,1,0,0,0,1
461928267,1,0,0,0,1
461905319,1,0,0,0,1
461852348,0,0,1,0,1
461850710,1,0,0,0,1
460624166,1,0,0,0,1
460458073,1,0,0,0,1
462775492,0,0,1,0,1
459609591,0,0,1,0,1
459593534,1,0,0,0,1
459578759,1,0,0,0,1
459450273,1,0,0,0,1
459440012,0,0,1,0,1
459432476,0,0,1,0,1
459396015,1,0,0,0,1
459355799,1,0,0,0,1
459316327,1,0,0,0,1
459192204,1,0,0,0,1
459087314,0,0,1,0,1
459079249,0,0,1,0,1
459073067,1,0,0,0,1
459046645,1,0,0,0,1
458988168,0,0,1,0,1
458839652,0,0,1,0,1
458802471,1,0,0,0,1
458728491,1,0,0,0,1
459605511,1,0,0,0,1
459611794,1,0,0,0,1
460452724,1,0,0,0,1
459638238,0,0,1,0,1
460417033,1,0,0,0,1
460348862,1,0,0,0,1
460207014,0,0,1,0,1
460147305,1,0,0,0,1
460132111,1,0,0,0,1
459968296,1,0,0,0,1
459954763,1,0,0,0,1
459821572,0,0,1,0,1
459806934,1,0,0,0,1
459806474,1,0,0,0,1
459799300,1,0,0,0,1
459796507,0,0,1,0,1
459783558,1,0,0,0,1
459768134,0,0,1,0,1
459757317,1,0,0,0,1
459733546,1,0,0,0,1
459645051,1,0,0,0,1
462640737,1,0,0,0,1
462786490,0,0,1,0,1
466974925,1,0,0,0,1
465924008,1,0,0,0,1
465718292,1,0,0,0,1
465621581,1,0,0,0,1
465605016,0,0,1,0,1
465597368,1,0,0,0,1
465555503,1,0,0,0,1
465532852,1,0,0,0,1
465459400,0,0,1,0,1
465450585,0,0,1,0,1
465391305,0,0,1,0,1
465374352,1,0,0,0,1
465330263,0,0,1,0,1
465298176,0,0,1,0,1
465221351,0,0,1,0,1
465132998,0,0,1,0,1
465092276,1,0,0,0,1
465072967,1,0,0,0,1
465037862,1,0,0,0,1
465764425,0,0,1,0,1
465997520,1,0,0,0,1
464834459,0,0,1,0,1
466035025,0,0,1,0,1
466927026,0,0,1,0,1
466838304,1,0,0,0,1
466821690,1,0,0,0,1
466783694,1,0,0,0,1
466778613,1,0,0,0,1
466762506,1,0,0,0,1
466726792,1,0,0,0,1
466709964,0,0,1,0,1
466635999,0,0,1,0,1
466626021,1,0,0,0,1
466572177,1,0,0,0,1
466561806,0,0,1,0,1
466450403,0,0,1,0,1
466434714,1,0,0,0,1
466365624,1,0,0,0,1
466092668,1,0,0,0,1
466087223,1,0,0,0,1
464911964,1,0,0,0,1
464780709,1,0,0,0,1
462896752,1,0,0,0,1
464102537,1,0,0,0,1
464040425,0,0,1,0,1
464037043,1,0,0,0,1
463990799,0,0,1,0,1
463941003,1,0,0,0,1
463917614,0,0,1,0,1
463860904,1,0,0,0,1
463852482,1,0,0,0,1
463851144,1,0,0,0,1
463792653,1,0,0,0,1
463759573,1,0,0,0,1
463672381,1,0,0,0,1
463599756,0,0,1,0,1
463267338,1,0,0,0,1
463052370,0,0,1,0,1
463020910,0,0,1,0,1
462947000,1,0,0,0,1
462939017,1,0,0,0,1
464079439,1,0,0,0,1
464111297,1,0,0,0,1
464779742,1,0,0,0,1
464125343,1,0,0,0,1
464738071,0,0,1,0,1
464669038,0,0,1,0,1
464637798,1,0,0,0,1
464624783,1,0,0,0,1
464617163,0,0,1,0,1
464578626,1,0,0,0,1
464549543,0,0,1,0,1
464534746,1,0,0,0,1
464479595,1,0,0,0,1
464453278,1,0,0,0,1
464411617,1,0,0,0,1
464397781,1,0,0,0,1
464278055,0,0,1,0,1
464258563,1,0,0,0,1
464234569,1,0,0,0,1
464214747,0,0,1,0,1
464206217,1,0,0,0,1
335931554,1,0,0,0,1
335600487,1,0,0,0,1
166398662,0,0,1,0,1
216091157,1,0,0,0,1
216419980,1,0,0,0,1
216411482,0,0,1,0,1
216392786,0,0,1,0,1
216339550,0,0,1,0,1
216310452,1,0,0,0,1
216277741,1,0,0,0,1
216274333,0,0,1,0,1
216263564,0,0,1,0,1
216061803,1,0,0,0,1
335482537,1,0,0,0,1
215922529,1,0,0,0,1
215897007,0,0,1,0,1
215786346,0,0,1,0,1
215575720,1,0,0,0,1
215530555,0,0,1,0,1
215440793,0,0,1,0,1
215277711,1,0,0,0,1
215257373,0,0,1,0,1
216453855,1,0,0,0,1
216519008,0,0,1,0,1
216586341,1,0,0,0,1
216611306,0,0,1,0,1
217379510,1,0,0,0,1
217189801,1,0,0,0,1
217159080,0,0,1,0,1
217054194,0,0,1,0,1
217053085,1,0,0,0,1
217018796,1,0,0,0,1
216994736,0,0,1,0,1
216984109,1,0,0,0,1
216944902,0,0,1,0,1
216943992,0,0,1,0,1
216918562,1,0,0,0,1
216903925,1,0,0,0,1
216891728,1,0,0,0,1
216793414,1,0,0,0,1
216734225,1,0,0,0,1
216664991,0,0,1,0,1
216634331,1,0,0,0,1
215246822,1,0,0,0,1
215239210,1,0,0,0,1
215183568,0,0,1,0,1
214265552,1,0,0,0,1
214173940,1,0,0,0,1
214164524,0,0,1,0,1
214148143,0,0,1,0,1
214141672,0,0,1,0,1
214119114,0,0,1,0,1
214020928,1,0,0,0,1
213907821,1,0,0,0,1
213803787,1,0,0,0,1
213652721,0,0,1,0,1
213650814,1,0,0,0,1
213630008,1,0,0,0,1
213615269,1,0,0,0,1
213251818,1,0,0,0,1
213183791,0,0,1,0,1
213172811,0,0,1,0,1
213149621,0,0,1,0,1
213035338,1,0,0,0,1
214184351,0,0,1,0,1
214270886,1,0,0,0,1
215161436,1,0,0,0,1
214320776,0,0,1,0,1
215127571,0,0,1,0,1
215075242,0,0,1,0,1
215041024,1,0,0,0,1
214922940,0,0,1,0,1
214888995,0,0,1,0,1
214859918,0,0,1,0,1
214646687,0,0,1,0,1
214623686,1,0,0,0,1
214604378,1,0,0,0,1
214597633,0,0,1,0,1
214596396,1,0,0,0,1
214523189,1,0,0,0,1
214480354,0,0,1,0,1
214464499,1,0,0,0,1
214428653,1,0,0,0,1
214424497,1,0,0,0,1
214332639,1,0,0,0,1
217432173,1,0,0,0,1
217507116,0,0,1,0,1
217521776,1,0,0,0,1
221343982,0,0,1,0,1
221259466,1,0,0,0,1
221250223,0,0,1,0,1
221238571,1,0,0,0,1
221177870,1,0,0,0,1
221022609,0,0,1,0,1
221012726,0,0,1,0,1
220934687,0,0,1,0,1
220865756,0,0,1,0,1
220763958,1,0,0,0,1
220734035,0,0,1,0,1
220479551,0,0,1,0,1
220422636,0,0,1,0,1
220400948,1,0,0,0,1
220161560,0,0,1,0,1
220159422,0,0,1,0,1
220129825,0,0,1,0,1
220121415,1,0,0,0,1
221273596,0,0,1,0,1
221366300,1,0,0,0,1
219945845,1,0,0,0,1
221371129,1,0,0,0,1
222302950,0,0,1,0,1
222249366,1,0,0,0,1
222232146,1,0,0,0,1
222192521,0,0,1,0,1
222179066,1,0,0,0,1
222098649,1,0,0,0,1
222081034,1,0,0,0,1
222064628,0,0,1,0,1
221929447,0,0,1,0,1
221920436,1,0,0,0,1
221915349,1,0,0,0,1
221871654,1,0,0,0,1
221853540,1,0,0,0,1
221635816,1,0,0,0,1
221623897,1,0,0,0,1
221595048,1,0,0,0,1
221442773,1,0,0,0,1
220055820,0,0,1,0,1
219931262,0,0,1,0,1
217568399,1,0,0,0,1
218627196,1,0,0,0,1
218612882,1,0,0,0,1
218505786,0,0,1,0,1
218474205,1,0,0,0,1
218458746,0,0,1,0,1
218448466,1,0,0,0,1
218428676,0,0,1,0,1
218336964,0,0,1,0,1
218319766,1,0,0,0,1
218301609,0,0,1,0,1
218286691,1,0,0,0,1
218272490,0,0,1,0,1
218134921,0,0,1,0,1
217836856,0,0,1,0,1
217834192,1,0,0,0,1
217821911,1,0,0,0,1
217793924,1,0,0,0,1
217677486,1,0,0,0,1
218613116,0,0,0,1,1
218680572,1,0,0,0,1
219879114,1,0,0,0,1
218689235,1,0,0,0,1
219785279,0,0,1,0,1
219784095,0,0,1,0,1
219712367,1,0,0,0,1
219700887,1,0,0,0,1
219678120,1,0,0,0,1
219573002,1,0,0,0,1
219558480,1,0,0,0,1
219505617,0,0,1,0,1
219502160,1,0,0,0,1
219478686,1,0,0,0,1
219449657,1,0,0,0,1
219296484,1,0,0,0,1
219137805,0,0,1,0,1
219113745,1,0,0,0,1
218959287,1,0,0,0,1
218940337,1,0,0,0,1
218843230,0,0,1,0,1
213012532,1,0,0,0,1
212898110,1,0,0,0,1
212881346,0,0,1,0,1
207213839,1,0,0,0,1
207204450,0,0,1,0,1
207173529,0,0,1,0,1
207141784,1,0,0,0,1
207000645,0,0,1,0,1
206972453,1,0,0,0,1
206960083,0,0,1,0,1
206954368,1,0,0,0,1
206926840,1,0,0,0,1
206919043,1,0,0,0,1
206889476,1,0,0,0,1
206774126,1,0,0,0,1
206748180,0,0,1,0,1
206531358,1,0,0,0,1
206529596,1,0,0,0,1
206459807,1,0,0,0,1
206305295,0,0,1,0,1
206264331,1,0,0,0,1
207208480,1,0,0,0,1
207367268,0,0,1,0,1
206217143,0,0,1,0,1
207381668,1,0,0,0,1
208477013,1,0,0,0,1
208384577,0,0,1,0,1
208106618,0,0,1,0,1
208079253,1,0,0,0,1
207891531,1,0,0,0,1
207808113,1,0,0,0,1
207773633,1,0,0,0,1
207772400,0,0,1,0,1
207762040,1,0,0,0,1
207700509,1,0,0,0,1
207599465,1,0,0,0,1
207573589,1,0,0,0,1
207562173,0,0,0,1,1
207523208,1,0,0,0,1
207431103,0,0,1,0,1
207418547,0,0,1,0,1
207397350,1,0,0,0,1
206229239,1,0,0,0,1
206195782,1,0,0,0,1
208576158,0,0,1,0,1
205115932,0,0,1,0,1
205069056,1,0,0,0,1
204863778,1,0,0,0,1
204816374,1,0,0,0,1
204810113,0,0,1,0,1
204769168,1,0,0,0,1
204527519,1,0,0,0,1
204495302,1,0,0,0,1
204346423,1,0,0,0,1
204138652,1,0,0,0,1
204092320,1,0,0,0,1
204036615,1,0,0,0,1
204018218,1,0,0,0,1
203981093,1,0,0,0,1
203866020,0,0,1,0,1
203862132,0,0,1,0,1
203806534,1,0,0,0,1
203793342,0,0,1,0,1
205099645,1,0,0,0,1
205118496,1,0,0,0,1
206188423,0,0,1,0,1
205134817,1,0,0,0,1
206054823,0,0,1,0,1
206031174,1,0,0,0,1
206025860,0,0,1,0,1
206009618,0,0,1,0,1
205999048,1,0,0,0,1
205952507,1,0,0,0,1
205952285,0,0,1,0,1
205903495,1,0,0,0,1
205867697,0,0,1,0,1
205669138,1,0,0,0,1
205594437,1,0,0,0,1
205564408,0,0,1,0,1
205491627,1,0,0,0,1
205386178,1,0,0,0,1
205188960,1,0,0,0,1
205144781,1,0,0,0,1
205140335,0,0,1,0,1
208537842,1,0,0,0,1
208702730,0,0,1,0,1
212878765,1,0,0,0,1
211483713,0,0,1,0,1
211433602,1,0,0,0,1
211393353,1,0,0,0,1
211392722,1,0,0,0,1
211390577,1,0,0,0,1
211385563,1,0,0,0,1
211359901,0,0,1,0,1
211350069,1,0,0,0,1
211231503,1,0,0,0,1
211212649,0,0,1,0,1
211106440,1,0,0,0,1
211069875,0,0,1,0,1
211036592,1,0,0,0,1
211034625,1,0,0,0,1
211024051,1,0,0,0,1
211022699,1,0,0,0,1
210934238,0,0,1,0,1
210843289,0,0,1,0,1
211454272,0,0,1,0,1
211502642,0,0,0,1,1
210800523,0,0,1,0,1
211666263,1,0,0,0,1
212871974,0,0,1,0,1
212741420,1,0,0,0,1
212697613,1,0,0,0,1
212661987,0,0,1,0,1
212629546,0,0,1,0,1
212526336,1,0,0,0,1
212479990,1,0,0,0,1
212473045,0,0,1,0,1
212433512,1,0,0,0,1
212338108,0,0,1,0,1
212332349,1,0,0,0,1
212262327,0,0,1,0,1
212252517,1,0,0,0,1
212160752,0,0,1,0,1
211893857,1,0,0,0,1
211821054,0,0,1,0,1
211682646,0,0,1,0,1
210811197,1,0,0,0,1
210642957,1,0,0,0,1
208707377,1,0,0,0,1
209587921,1,0,0,0,1
209527549,1,0,0,0,1
209491015,0,0,1,0,1
209406241,1,0,0,0,1
209395806,1,0,0,0,1
209374833,1,0,0,0,1
209291827,0,0,1,0,1
209202426,1,0,0,0,1
209026981,0,0,1,0,1
208975280,0,0,1,0,1
208955740,1,0,0,0,1
208946050,1,0,0,0,1
208938947,0,0,1,0,1
208930169,0,0,1,0,1
208901618,1,0,0,0,1
208856601,1,0,0,0,1
208796706,0,0,1,0,1
208752230,1,0,0,0,1
209584006,0,0,1,0,1
209619982,1,0,0,0,1
210578372,1,0,0,0,1
209719718,0,0,1,0,1
210577527,1,0,0,0,1
210518607,0,0,1,0,1
210408018,1,0,0,0,1
210287939,1,0,0,0,1
210257450,1,0,0,0,1
210242250,0,0,1,0,1
210220380,0,0,1,0,1
210218941,1,0,0,0,1
210172714,1,0,0,0,1
210147522,0,0,1,0,1
210133054,1,0,0,0,1
210109752,1,0,0,0,1
210036614,1,0,0,0,1
209979150,1,0,0,0,1
209792176,0,0,1,0,1
209768607,1,0,0,0,1
209758777,0,0,1,0,1
222388555,1,0,0,0,1
222425618,0,0,1,0,1
222600382,1,0,0,0,1
233417287,1,0,0,0,1
233375830,1,0,0,0,1
233354151,0,0,1,0,1
233315839,0,0,1,0,1
233227636,0,0,1,0,1
233066892,0,0,1,0,1
233025597,1,0,0,0,1
232985707,0,0,1,0,1
232959891,0,0,1,0,1
232806788,1,0,0,0,1
232806142,1,0,0,0,1
232778333,0,0,1,0,1
232747773,1,0,0,0,1
232653095,0,0,1,0,1
232578558,1,0,0,0,1
232463854,1,0,0,0,1
232454114,0,0,1,0,1
232380879,0,0,1,0,1
233383147,1,0,0,0,1
233434420,1,0,0,0,1
232152341,1,0,0,0,1
233436789,0,0,1,0,1
234211879,1,0,0,0,1
234194182,1,0,0,0,1
234191916,1,0,0,0,1
234174616,1,0,0,0,1
234147066,1,0,0,0,1
234145891,1,0,0,0,1
234115186,1,0,0,0,1
233986637,0,0,1,0,1
233755743,0,0,1,0,1
233731904,0,0,1,0,1
233682356,1,0,0,0,1
233665357,1,0,0,0,1
233534153,1,0,0,0,1
233528692,1,0,0,0,1
233522961,0,0,1,0,1
233521077,0,0,1,0,1
233436938,1,0,0,0,1
232374986,0,0,1,0,1
232112395,0,0,1,0,1
234297980,1,0,0,0,1
231123296,1,0,0,0,1
231048960,1,0,0,0,1
231022382,0,0,1,0,1
231015527,1,0,0,0,1
231007291,1,0,0,0,1
230961710,1,0,0,0,1
230930866,1,0,0,0,1
230777664,1,0,0,0,1
230679834,1,0,0,0,1
230670970,1,0,0,0,1
230670639,1,0,0,0,1
230645834,1,0,0,0,1
230531574,0,0,1,0,1
230531384,0,0,0,1,1
230517521,1,0,0,0,1
230503468,1,0,0,0,1
230490856,1,0,0,0,1
230449841,1,0,0,0,1
231054333,1,0,0,0,1
231161473,0,0,1,0,1
232078815,1,0,0,0,1
231186389,0,0,1,0,1
232017729,1,0,0,0,1
231971512,0,0,1,0,1
231929970,0,0,1,0,1
231875594,0,0,1,0,1
231831493,1,0,0,0,1
231684594,1,0,0,0,1
231633841,0,0,1,0,1
231515893,1,0,0,0,1
231510804,1,0,0,0,1
231503052,1,0,0,0,1
231474021,0,0,1,0,1
231468237,1,0,0,0,1
231459188,0,0,1,0,1
231456842,1,0,0,0,1
231370569,0,0,1,0,1
231352024,1,0,0,0,1
231192888,0,0,1,0,1
234274506,0,0,1,0,1
234331642,0,0,1,0,1
230378560,1,0,0,0,1
238135369,0,0,1,0,1
238111285,0,0,1,0,1
238021379,1,0,0,0,1
237880163,0,0,1,0,1
237863320,0,0,1,0,1
237817180,1,0,0,0,1
237716085,0,0,1,0,1
237668552,0,0,1,0,1
237627269,0,0,1,0,1
237598325,1,0,0,0,1
237569289,1,0,0,0,1
237340817,1,0,0,0,1
237330464,1,0,0,0,1
237283862,1,0,0,0,1
237275466,0,0,1,0,1
237240617,1,0,0,0,1
237139220,1,0,0,0,1
237118012,0,0,1,0,1
238118741,1,0,0,0,1
238380801,1,0,0,0,1
237075599,0,0,1,0,1
238531391,1,0,0,0,1
239978864,1,0,0,0,1
239906704,0,0,1,0,1
239689464,0,0,1,0,1
239638986,0,0,1,0,1
239548019,0,0,1,0,1
239431510,1,0,0,0,1
239388167,1,0,0,0,1
239180752,0,0,1,0,1
239142480,0,0,1,0,1
239116505,0,0,1,0,1
239103551,1,0,0,0,1
238975559,1,0,0,0,1
238953933,1,0,0,0,1
238945127,0,0,1,0,1
238908845,0,0,1,0,1
238894847,1,0,0,0,1
238735207,1,0,0,0,1
237113187,1,0,0,0,1
237049868,1,0,0,0,1
234351695,1,0,0,0,1
235310848,0,0,1,0,1
235218603,1,0,0,0,1
235208764,1,0,0,0,1
235062143,1,0,0,0,1
235008186,1,0,0,0,1
234956201,0,0,1,0,1
234866917,0,0,1,0,1
234641474,1,0,0,0,1
234596452,0,0,1,0,1
234592314,1,0,0,0,1
234572569,1,0,0,0,1
234569330,1,0,0,0,1
234440538,1,0,0,0,1
234423593,1,0,0,0,1
234417391,0,0,1,0,1
234383886,1,0,0,0,1
234383668,1,0,0,0,1
234357462,1,0,0,0,1
235252386,1,0,0,0,1
235311151,0,0,1,0,1
237012544,0,0,1,0,1
235317126,0,0,1,0,1
236914360,0,0,1,0,1
236852677,1,0,0,0,1
236631469,0,0,1,0,1
236607981,0,0,1,0,1
236567207,1,0,0,0,1
236563461,0,0,1,0,1
236432765,1,0,0,0,1
236422290,1,0,0,0,1
236369220,1,0,0,0,1
236148005,1,0,0,0,1
235990293,0,0,1,0,1
235763046,0,0,1,0,1
235762288,1,0,0,0,1
235676280,1,0,0,0,1
235655558,1,0,0,0,1
235344330,1,0,0,0,1
235329443,1,0,0,0,1
230396622,0,0,1,0,1
230252627,1,0,0,0,1
222626145,1,0,0,0,1
225706084,1,0,0,0,1
225616368,1,0,0,0,1
225612108,1,0,0,0,1
225489491,0,0,1,0,1
225429345,1,0,0,0,1
225367154,1,0,0,0,1
225313172,0,0,1,0,1
225291555,1,0,0,0,1
225252724,1,0,0,0,1
225246934,1,0,0,0,1
225122879,1,0,0,0,1
225105519,1,0,0,0,1
225075332,0,0,1,0,1
225033890,1,0,0,0,1
225025900,1,0,0,0,1
225004337,1,0,0,0,1
224979517,1,0,0,0,1
224976669,0,0,1,0,1
225647706,0,0,1,0,1
225809053,1,0,0,0,1
224892300,0,0,1,0,1
225813251,1,0,0,0,1
226520484,0,0,1,0,1
226503876,0,0,1,0,1
226426835,0,0,1,0,1
226399742,1,0,0,0,1
226124574,0,0,1,0,1
226088610,1,0,0,0,1
226048286,1,0,0,0,1
226007552,0,0,1,0,1
225986166,0,0,1,0,1
225971717,1,0,0,0,1
225963659,0,0,1,0,1
225926055,1,0,0,0,1
225913497,0,0,1,0,1
225913271,1,0,0,0,1
225912165,1,0,0,0,1
225891200,0,0,1,0,1
225853788,0,0,1,0,1
224954032,1,0,0,0,1
224889039,0,0,1,0,1
226684665,0,0,1,0,1
223807986,1,0,0,0,1
223667060,1,0,0,0,1
223620306,0,0,0,1,1
223511106,1,0,0,0,1
223504937,1,0,0,0,1
223470070,0,0,1,0,1
223428808,0,0,1,0,1
223422291,1,0,0,0,1
56205792,1,0,0,0,1
223366584,1,0,0,0,1
223238601,0,0,1,0,1
223198021,0,0,1,0,1
223180509,1,0,0,0,1
223032408,1,0,0,0,1
223027077,1,0,0,0,1
222987131,0,0,1,0,1
222805048,0,0,1,0,1
222645551,1,0,0,0,1
223715716,0,0,1,0,1
223913025,0,0,1,0,1
224885898,1,0,0,0,1
224029433,1,0,0,0,1
224874182,0,0,0,1,1
224812047,1,0,0,0,1
224806557,1,0,0,0,1
224803937,0,0,1,0,1
224715959,1,0,0,0,1
224711473,1,0,0,0,1
224699779,0,0,1,0,1
224498087,1,0,0,0,1
224461227,1,0,0,0,1
224413673,1,0,0,0,1
224384517,0,0,1,0,1
224362055,0,0,1,0,1
224350246,1,0,0,0,1
224214774,1,0,0,0,1
224206042,1,0,0,0,1
224190427,0,0,1,0,1
224126362,1,0,0,0,1
226557968,1,0,0,0,1
226714861,1,0,0,0,1
230192818,1,0,0,0,1
229288524,1,0,0,0,1
229284767,1,0,0,0,1
229229020,1,0,0,0,1
229124258,1,0,0,0,1
229072295,1,0,0,0,1
228957948,0,0,1,0,1
228945290,0,0,1,0,1
228915442,1,0,0,0,1
228898361,1,0,0,0,1
228885679,1,0,0,0,1
228865184,1,0,0,0,1
228808159,0,0,1,0,1
228778848,1,0,0,0,1
228750325,1,0,0,0,1
228715959,1,0,0,0,1
228691487,1,0,0,0,1
228595721,0,0,1,0,1
228571016,0,0,1,0,1
229288218,1,0,0,0,1
229296368,0,0,1,0,1
228562055,0,0,1,0,1
229309933,0,0,1,0,1
230173141,1,0,0,0,1
230172508,1,0,0,0,1
230085076,0,0,1,0,1
230062403,1,0,0,0,1
230049837,1,0,0,0,1
230022745,1,0,0,0,1
229950463,1,0,0,0,1
229912004,0,0,1,0,1
229872308,0,0,0,1,1
229853761,0,0,1,0,1
229836139,1,0,0,0,1
229697915,1,0,0,0,1
229604812,1,0,0,0,1
229588502,0,0,1,0,1
229487253,1,0,0,0,1
229470652,1,0,0,0,1
229325672,1,0,0,0,1
228567385,1,0,0,0,1
228536894,0,0,1,0,1
226721808,1,0,0,0,1
227596527,1,0,0,0,1
227413647,0,0,1,0,1
227385012,0,0,1,0,1
227328676,1,0,0,0,1
227309215,1,0,0,0,1
227303384,0,0,1,0,1
227183458,1,0,0,0,1
227165163,0,0,1,0,1
227147313,1,0,0,0,1
227056489,1,0,0,0,1
227021565,0,0,1,0,1
226931496,1,0,0,0,1
226906712,0,0,1,0,1
226838925,0,0,1,0,1
226833844,1,0,0,0,1
226810639,1,0,0,0,1
226772729,0,0,1,0,1
226769067,1,0,0,0,1
227482082,1,0,0,0,1
227629764,1,0,0,0,1
228524640,0,0,1,0,1
227682707,0,0,1,0,1
228473476,0,0,1,0,1
228437214,0,0,1,0,1
228414932,1,0,0,0,1
228257645,1,0,0,0,1
228250502,0,0,0,1,1
228223819,0,0,1,0,1
228213504,0,0,1,0,1
228212001,1,0,0,0,1
228146367,1,0,0,0,1
228132014,0,0,1,0,1
228107908,1,0,0,0,1
228104837,1,0,0,0,1
228080471,1,0,0,0,1
228017415,1,0,0,0,1
227856882,0,0,1,0,1
227801173,1,0,0,0,1
227736941,1,0,0,0,1
203684061,1,0,0,0,1
203610908,0,0,1,0,1
203569485,0,0,1,0,1
178676648,0,0,1,0,1
178654047,1,0,0,0,1
178631153,1,0,0,0,1
178445566,1,0,0,0,1
178327761,1,0,0,0,1
178300668,1,0,0,0,1
178265603,0,0,1,0,1
178237936,1,0,0,0,1
178229322,0,0,1,0,1
178176640,0,0,1,0,1
177915409,1,0,0,0,1
177761074,0,0,1,0,1
177759835,1,0,0,0,1
177742211,1,0,0,0,1
177727829,1,0,0,0,1
177721509,1,0,0,0,1
177714844,0,0,1,0,1
177599555,1,0,0,0,1
178675800,0,0,1,0,1
179014177,1,0,0,0,1
177562935,0,0,1,0,1
179135911,0,0,1,0,1
179805100,1,0,0,0,1
179746154,1,0,0,0,1
179738450,1,0,0,0,1
179668570,1,0,0,0,1
179643204,0,0,1,0,1
179634496,1,0,0,0,1
179622857,1,0,0,0,1
179596678,1,0,0,0,1
179483216,1,0,0,0,1
179469761,1,0,0,0,1
179442361,0,0,1,0,1
179413160,0,0,1,0,1
179387847,1,0,0,0,1
179376942,0,0,1,0,1
179364522,0,0,1,0,1
179355129,1,0,0,0,1
179256587,1,0,0,0,1
177562964,1,0,0,0,1
177560095,0,0,1,0,1
179875767,1,0,0,0,1
176293805,1,0,0,0,1
176279414,1,0,0,0,1
176185168,0,0,1,0,1
176062518,1,0,0,0,1
176043852,0,0,0,1,1
176001804,1,0,0,0,1
175943567,0,0,1,0,1
175924907,0,0,1,0,1
175923004,0,0,1,0,1
175778475,1,0,0,0,1
175684720,1,0,0,0,1
175529225,1,0,0,0,1
175519061,0,0,1,0,1
175368122,0,0,1,0,1
175289458,1,0,0,0,1
175271914,1,0,0,0,1
175152790,0,0,1,0,1
175088896,1,0,0,0,1
176286140,0,0,1,0,1
176342497,0,0,1,0,1
177554775,0,0,1,0,1
176406553,0,0,1,0,1
177412704,1,0,0,0,1
177404414,0,0,1,0,1
177360125,0,0,1,0,1
177353847,1,0,0,0,1
177231047,1,0,0,0,1
177199785,1,0,0,0,1
177156643,0,0,1,0,1
177143668,0,0,1,0,1
177067211,1,0,0,0,1
177036542,1,0,0,0,1
176983812,0,0,1,0,1
176971425,0,0,1,0,1
176850650,1,0,0,0,1
176780491,1,0,0,0,1
176763105,0,0,1,0,1
176683620,1,0,0,0,1
176415826,0,0,0,1,1
179875332,0,0,1,0,1
180045980,1,0,0,0,1
174917364,0,0,1,0,1
183375401,0,0,1,0,1
183288789,0,0,1,0,1
183272436,0,0,1,0,1
183241198,1,0,0,0,1
183198639,1,0,0,0,1
183187600,1,0,0,0,1
183038816,0,0,1,0,1
183024421,1,0,0,0,1
182990602,1,0,0,0,1
182965966,0,0,1,0,1
182940016,0,0,1,0,1
182827988,0,0,1,0,1
182710998,1,0,0,0,1
182490482,0,0,1,0,1
182475381,1,0,0,0,1
182448644,1,0,0,0,1
182425645,1,0,0,0,1
182337369,1,0,0,0,1
183309536,1,0,0,0,1
183393413,0,0,1,0,1
182326028,0,0,1,0,1
183400278,1,0,0,0,1
184501175,1,0,0,0,1
184496160,0,0,1,0,1
184472924,1,0,0,0,1
184462388,1,0,0,0,1
184259332,1,0,0,0,1
184233409,1,0,0,0,1
184147615,0,0,1,0,1
184146557,0,0,1,0,1
184122908,0,0,1,0,1
183967887,0,0,1,0,1
183886601,1,0,0,0,1
183810787,1,0,0,0,1
183735993,0,0,1,0,1
183707967,1,0,0,0,1
183617557,1,0,0,0,1
183589836,1,0,0,0,1
183507429,1,0,0,0,1
182329273,0,0,1,0,1
182306283,1,0,0,0,1
180173329,0,0,1,0,1
181154504,1,0,0,0,1
181108039,1,0,0,0,1
180928667,0,0,1,0,1
180919458,1,0,0,0,1
180914900,0,0,1,0,1
180746404,1,0,0,0,1
180744564,1,0,0,0,1
180740272,1,0,0,0,1
180712863,0,0,1,0,1
180608314,1,0,0,0,1
180380802,1,0,0,0,1
180378787,0,0,1,0,1
180354201,0,0,1,0,1
180347935,0,0,0,1,1
180329864,1,0,0,0,1
180267038,1,0,0,0,1
180219381,0,0,1,0,1
180186230,0,0,1,0,1
181108819,1,0,0,0,1
181160424,0,0,1,0,1
182290525,1,0,0,0,1
181161462,1,0,0,0,1
182260692,0,0,1,0,1
182094526,1,0,0,0,1
182092241,1,0,0,0,1
182084079,1,0,0,0,1
182039779,1,0,0,0,1
182032773,0,0,1,0,1
181875962,1,0,0,0,1
181858292,1,0,0,0,1
181844338,1,0,0,0,1
181711840,1,0,0,0,1
181679481,1,0,0,0,1
181517263,1,0,0,0,1
181499542,1,0,0,0,1
181344112,1,0,0,0,1
181233778,0,0,1,0,1
181205324,1,0,0,0,1
181195072,1,0,0,0,1
174976495,0,0,1,0,1
174838527,0,0,0,1,1
184600679,1,0,0,0,1
169505313,1,0,0,0,1
169472089,0,0,1,0,1
169467786,1,0,0,0,1
169419092,0,0,1,0,1
169357704,0,0,1,0,1
169340719,1,0,0,0,1
169278872,1,0,0,0,1
169150553,0,0,1,0,1
169131031,1,0,0,0,1
169130719,0,0,1,0,1
169012324,1,0,0,0,1
168988812,1,0,0,0,1
168946125,1,0,0,0,1
168927293,0,0,1,0,1
168815258,0,0,1,0,1
168814318,1,0,0,0,1
168710834,1,0,0,0,1
168660624,0,0,1,0,1
169494045,0,0,1,0,1
169524962,1,0,0,0,1
168532479,1,0,0,0,1
169541552,1,0,0,0,1
170387293,0,0,1,0,1
170251158,1,0,0,0,1
170234326,0,0,1,0,1
170095613,0,0,1,0,1
170092307,1,0,0,0,1
170071460,1,0,0,0,1
169967529,1,0,0,0,1
169944714,1,0,0,0,1
169940010,0,0,1,0,1
169882061,1,0,0,0,1
169808541,0,0,1,0,1
169794566,0,0,1,0,1
169704873,0,0,1,0,1
169686676,0,0,1,0,1
169589888,0,0,1,0,1
169587048,0,0,1,0,1
169567256,0,0,1,0,1
168576240,1,0,0,0,1
168501789,1,0,0,0,1
170445076,1,0,0,0,1
167250189,0,0,1,0,1
167188752,0,0,1,0,1
167098774,0,0,1,0,1
167019780,1,0,0,0,1
167007852,0,0,1,0,1
166984137,0,0,1,0,1
166974172,1,0,0,0,1
166937699,0,0,1,0,1
166873118,0,0,1,0,1
166872386,0,0,1,0,1
166820127,1,0,0,0,1
166819817,0,0,1,0,1
166794407,0,0,1,0,1
166779940,1,0,0,0,1
166485120,0,0,1,0,1
166438169,0,0,1,0,1
166432964,0,0,1,0,1
166414791,1,0,0,0,1
167245035,1,0,0,0,1
167364935,1,0,0,0,1
168416827,0,0,1,0,1
167377761,0,0,1,0,1
168308087,1,0,0,0,1
168180986,0,0,1,0,1
168054716,0,0,1,0,1
167986279,1,0,0,0,1
167831565,0,0,1,0,1
167828586,1,0,0,0,1
167818421,0,0,1,0,1
167784680,1,0,0,0,1
167776541,1,0,0,0,1
167769340,1,0,0,0,1
167695588,1,0,0,0,1
167677659,1,0,0,0,1
167577042,1,0,0,0,1
167570251,1,0,0,0,1
167568754,1,0,0,0,1
167510916,1,0,0,0,1
167422704,0,0,1,0,1
170392882,1,0,0,0,1
170457264,1,0,0,0,1
174838471,0,0,1,0,1
173660196,1,0,0,0,1
173483667,1,0,0,0,1
173369078,1,0,0,0,1
173369017,1,0,0,0,1
173290675,0,0,0,1,1
173274299,1,0,0,0,1
173125581,0,0,1,0,1
173123452,1,0,0,0,1
173083297,0,0,1,0,1
172981804,0,0,1,0,1
172941310,1,0,0,0,1
172922617,0,0,1,0,1
172894027,1,0,0,0,1
172885803,1,0,0,0,1
172650321,1,0,0,0,1
172592986,1,0,0,0,1
172579417,0,0,1,0,1
172461497,1,0,0,0,1
173554156,0,0,1,0,1
173669313,1,0,0,0,1
172391931,1,0,0,0,1
173823383,1,0,0,0,1
174816758,1,0,0,0,1
174804937,1,0,0,0,1
174797199,1,0,0,0,1
174786681,0,0,1,0,1
174785774,1,0,0,0,1
174780742,1,0,0,0,1
174724220,1,0,0,0,1
174667063,1,0,0,0,1
174504698,0,0,1,0,1
174494091,1,0,0,0,1
174458184,1,0,0,0,1
174255459,1,0,0,0,1
174215541,0,0,1,0,1
174197082,1,0,0,0,1
174180669,1,0,0,0,1
173999598,1,0,0,0,1
173858338,0,0,1,0,1
172442429,0,0,1,0,1
172311922,0,0,1,0,1
170477315,0,0,1,0,1
171187695,1,0,0,0,1
171171143,1,0,0,0,1
171168334,1,0,0,0,1
171154086,0,0,1,0,1
171107511,0,0,1,0,1
170817628,0,0,1,0,1
170803458,1,0,0,0,1
170771014,0,0,1,0,1
170724808,1,0,0,0,1
170678160,1,0,0,0,1
170660006,1,0,0,0,1
170654081,1,0,0,0,1
170638981,1,0,0,0,1
170624318,0,0,1,0,1
170574337,1,0,0,0,1
170566147,1,0,0,0,1
170498900,1,0,0,0,1
170482956,1,0,0,0,1
171180680,1,0,0,0,1
171212377,1,0,0,0,1
172145021,1,0,0,0,1
171316704,0,0,1,0,1
172067924,1,0,0,0,1
171888683,1,0,0,0,1
171879907,1,0,0,0,1
171854639,1,0,0,0,1
171830071,0,0,1,0,1
171716081,1,0,0,0,1
171678641,1,0,0,0,1
171675703,1,0,0,0,1
171673961,0,0,1,0,1
171660157,0,0,1,0,1
171636572,0,0,1,0,1
171629811,0,0,1,0,1
171590575,0,0,1,0,1
171522181,0,0,1,0,1
171521049,1,0,0,0,1
171446547,0,0,1,0,1
171433016,1,0,0,0,1
184515092,0,0,1,0,1
184694715,1,0,0,0,1
203564743,0,0,1,0,1
197334240,1,0,0,0,1
197169969,1,0,0,0,1
197119374,0,0,1,0,1
197082458,1,0,0,0,1
197059898,0,0,1,0,1
197053492,0,1,0,0,1
196872053,0,0,1,0,1
196838948,1,0,0,0,1
196705969,1,0,0,0,1
196702707,1,0,0,0,1
196701166,0,0,1,0,1
196660011,1,0,0,0,1
196650659,1,0,0,0,1
196580929,0,0,1,0,1
196405027,1,0,0,0,1
196373534,0,0,1,0,1
196273418,1,0,0,0,1
196262113,1,0,0,0,1
197294267,1,0,0,0,1
197344796,0,0,1,0,1
196211856,1,0,0,0,1
197351392,0,0,1,0,1
198716390,1,0,0,0,1
198674748,1,0,0,0,1
198666761,1,0,0,0,1
198526963,1,0,0,0,1
198521670,1,0,0,0,1
198482796,0,0,0,1,1
198340695,1,0,0,0,1
198206886,1,0,0,0,1
197975388,1,0,0,0,1
197753492,1,0,0,0,1
197737782,1,0,0,0,1
197736479,1,0,0,0,1
197675041,1,0,0,0,1
197600390,0,0,1,0,1
197592915,0,0,1,0,1
197487133,1,0,0,0,1
197393504,0,0,1,0,1
196229541,0,0,1,0,1
196064709,1,0,0,0,1
198835140,0,0,1,0,1
195059863,0,0,0,1,1
195049060,1,0,0,0,1
195047045,0,0,1,0,1
195039053,1,0,0,0,1
195024580,1,0,0,0,1
195021790,1,0,0,0,1
195005674,0,0,1,0,1
194927513,1,0,0,0,1
194765199,1,0,0,0,1
194716858,1,0,0,0,1
194696447,1,0,0,0,1
194684765,1,0,0,0,1
194680216,0,0,1,0,1
194673800,1,0,0,0,1
194554070,0,0,1,0,1
194475559,0,0,1,0,1
194416373,0,0,1,0,1
194391932,0,0,1,0,1
195050680,0,0,1,0,1
195086252,0,0,1,0,1
196017028,1,0,0,0,1
195219725,1,0,0,0,1
195835199,1,0,0,0,1
195802909,0,0,1,0,1
195737789,0,0,1,0,1
195712950,1,0,0,0,1
195693063,0,0,1,0,1
195691349,1,0,0,0,1
195687583,1,0,0,0,1
195654382,0,0,1,0,1
195520304,1,0,0,0,1
195516359,1,0,0,0,1
195497710,1,0,0,0,1
195479167,0,0,1,0,1
195452338,0,0,1,0,1
195419830,0,0,1,0,1
195403895,1,0,0,0,1
195280100,0,0,1,0,1
195279731,1,0,0,0,1
198730633,1,0,0,0,1
198890291,1,0,0,0,1
194184883,1,0,0,0,1
202144863,0,0,1,0,1
201940587,1,0,0,0,1
201909387,0,0,1,0,1
201900745,0,0,1,0,1
201893473,0,0,1,0,1
201877539,1,0,0,0,1
201868461,1,0,0,0,1
201859106,1,0,0,0,1
201797577,0,0,1,0,1
201718939,1,0,0,0,1
201654234,1,0,0,0,1
201538971,1,0,0,0,1
201411141,0,0,1,0,1
201399118,1,0,0,0,1
201370147,1,0,0,0,1
201369441,1,0,0,0,1
201315040,0,0,1,0,1
201246457,1,0,0,0,1
202098409,1,0,0,0,1
202287550,0,0,1,0,1
201203968,0,0,1,0,1
202318295,0,0,1,0,1
203531377,1,0,0,0,1
203397896,1,0,0,0,1
203379811,1,0,0,0,1
203294661,0,0,1,0,1
203271555,1,0,0,0,1
203238784,1,0,0,0,1
203231204,0,0,1,0,1
203176937,1,0,0,0,1
203123161,1,0,0,0,1
202942110,1,0,0,0,1
202710081,0,0,1,0,1
202702370,0,0,1,0,1
202697970,0,0,1,0,1
202684451,1,0,0,0,1
202604552,1,0,0,0,1
202478509,1,0,0,0,1
202350344,0,0,1,0,1
201213227,0,0,1,0,1
201174295,0,0,1,0,1
198928314,1,0,0,0,1
199808815,1,0,0,0,1
199745521,0,0,1,0,1
199720771,1,0,0,0,1
199584723,0,0,1,0,1
199535935,1,0,0,0,1
199468878,0,0,1,0,1
199466348,1,0,0,0,1
199457450,0,0,1,0,1
199349788,0,1,0,0,1
199341999,0,0,0,1,1
199294415,1,0,0,0,1
199245226,0,0,1,0,1
199204383,1,0,0,0,1
199203455,0,0,1,0,1
199118646,0,0,1,0,1
199075581,1,0,0,0,1
199014573,0,0,1,0,1
199011457,1,0,0,0,1
199806359,1,0,0,0,1
199956234,1,0,0,0,1
201153591,1,0,0,0,1
200183045,0,0,1,0,1
201142263,0,0,0,1,1
201139702,1,0,0,0,1
201116493,1,0,0,0,1
201112506,1,0,0,0,1
201083646,1,0,0,0,1
200949587,1,0,0,0,1
200933726,0,0,1,0,1
200852582,1,0,0,0,1
200697707,0,0,1,0,1
200611691,1,0,0,0,1
200587972,1,0,0,0,1
200546815,0,0,1,0,1
200483536,0,0,1,0,1
200439496,1,0,0,0,1
200401254,0,0,0,1,1
200308208,0,0,1,0,1
200266510,0,0,1,0,1
194349000,1,0,0,0,1
194108889,1,0,0,0,1
184859394,1,0,0,0,1
188339637,1,0,0,0,1
188225740,1,0,0,0,1
188207570,1,0,0,0,1
188169807,1,0,0,0,1
188107890,1,0,0,0,1
188050970,0,0,1,0,1
187960424,1,0,0,0,1
187914509,0,0,1,0,1
187889772,1,0,0,0,1
187887120,1,0,0,0,1
187861161,0,0,1,0,1
187849608,0,0,1,0,1
187715849,1,0,0,0,1
187648135,0,0,1,0,1
187536544,1,0,0,0,1
187487947,1,0,0,0,1
187466087,1,0,0,0,1
187430955,1,0,0,0,1
188328775,1,0,0,0,1
188453457,0,0,1,0,1
187326900,0,0,1,0,1
188477517,0,0,1,0,1
189028939,1,0,0,0,1
189022543,0,0,1,0,1
188974456,1,0,0,0,1
188956585,1,0,0,0,1
188949327,1,0,0,0,1
188947623,1,0,0,0,1
188909919,1,0,0,0,1
188901948,1,0,0,0,1
188839178,1,0,0,0,1
188830760,0,0,1,0,1
188783370,0,0,1,0,1
188752288,0,0,1,0,1
188737645,1,0,0,0,1
188680034,0,0,1,0,1
188576539,0,0,1,0,1
188494770,0,0,1,0,1
188486925,0,0,1,0,1
187388261,1,0,0,0,1
187311340,1,0,0,0,1
189055563,0,0,1,0,1
186325478,1,0,0,0,1
186320943,0,0,1,0,1
186178785,0,0,1,0,1
186153119,1,0,0,0,1
186148178,1,0,0,0,1
186120177,1,0,0,0,1
186110692,0,0,1,0,1
186100463,0,0,1,0,1
186029613,1,0,0,0,1
185751071,0,0,1,0,1
185693241,1,0,0,0,1
185503694,1,0,0,0,1
185224678,1,0,0,0,1
185189643,0,0,1,0,1
185008425,1,0,0,0,1
184966663,1,0,0,0,1
184928600,0,0,1,0,1
184902640,0,0,1,0,1
186322383,0,0,1,0,1
186349150,0,0,1,0,1
187190679,1,0,0,0,1
186362905,0,0,1,0,1
187182730,0,0,1,0,1
187176491,1,0,0,0,1
187148732,1,0,0,0,1
187103481,1,0,0,0,1
187008191,0,0,1,0,1
186960276,0,0,1,0,1
186815657,1,0,0,0,1
186810935,1,0,0,0,1
186798498,1,0,0,0,1
186795756,1,0,0,0,1
186680487,0,0,1,0,1
186679495,1,0,0,0,1
186679094,0,0,1,0,1
186539588,0,0,1,0,1
186501476,1,0,0,0,1
186476960,0,0,1,0,1
186365946,1,0,0,0,1
189036764,1,0,0,0,1
189065202,0,0,1,0,1
194031970,0,0,0,1,1
192754619,0,0,1,0,1
192649658,1,0,0,0,1
192584956,1,0,0,0,1
192583202,0,0,1,0,1
192476124,1,0,0,0,1
192464234,0,0,1,0,1
192425097,1,0,0,0,1
192380484,0,0,1,0,1
192365902,0,0,1,0,1
192353876,0,0,1,0,1
192335868,0,0,1,0,1
192331889,1,0,0,0,1
192276715,1,0,0,0,1
192085313,0,0,1,0,1
192056824,1,0,0,0,1
191988723,1,0,0,0,1
191913119,1,0,0,0,1
191892665,0,0,1,0,1
192723267,1,0,0,0,1
192793716,1,0,0,0,1
191618352,1,0,0,0,1
192828467,1,0,0,0,1
193983914,1,0,0,0,1
193963715,1,0,0,0,1
193961455,1,0,0,0,1
193910244,1,0,0,0,1
193904277,0,0,1,0,1
193758145,1,0,0,0,1
193716904,0,0,1,0,1
193558362,1,0,0,0,1
193497177,1,0,0,0,1
193490396,1,0,0,0,1
193321999,1,0,0,0,1
193308443,1,0,0,0,1
193216321,1,0,0,0,1
192997396,1,0,0,0,1
192959601,0,0,1,0,1
192890383,0,0,1,0,1
192874460,1,0,0,0,1
191735386,1,0,0,0,1
191577969,0,0,1,0,1
189100218,1,0,0,0,1
190124793,0,0,1,0,1
189982367,0,0,1,0,1
189981848,1,0,0,0,1
189962349,1,0,0,0,1
189876110,0,0,1,0,1
189834234,1,0,0,0,1
189829767,1,0,0,0,1
189808492,0,0,1,0,1
189792874,1,0,0,0,1
189763980,1,0,0,0,1
189604966,1,0,0,0,1
189576498,0,0,1,0,1
189552325,1,0,0,0,1
189548107,1,0,0,0,1
189432700,0,0,1,0,1
189356812,1,0,0,0,1
189249070,1,0,0,0,1
189105696,0,0,1,0,1
189994854,1,0,0,0,1
190340531,0,0,1,0,1
191528717,1,0,0,0,1
190501156,1,0,0,0,1
191469946,1,0,0,0,1
191272085,0,0,1,0,1
191233550,0,0,1,0,1
191106696,0,0,1,0,1
191085997,1,0,0,0,1
191084919,0,0,1,0,1
191063355,1,0,0,0,1
191021802,1,0,0,0,1
191011879,0,0,1,0,1
191009021,1,0,0,0,1
190962476,1,0,0,0,1
190891268,1,0,0,0,1
190787940,1,0,0,0,1
190764593,0,0,1,0,1
190667643,1,0,0,0,1
190643075,1,0,0,0,1
190629348,0,0,1,0,1
240037432,1,0,0,0,1
240065384,0,0,1,0,1
240065426,1,0,0,0,1
300815353,1,0,0,0,1
300626523,1,0,0,0,1
300577516,0,0,1,0,1
300552796,0,0,1,0,1
300546461,0,0,1,0,1
300536279,0,0,1,0,1
300529887,0,0,1,0,1
300450208,1,0,0,0,1
300447118,0,0,1,0,1
300441683,1,0,0,0,1
300348697,1,0,0,0,1
300293489,1,0,0,0,1
300235960,1,0,0,0,1
300216473,0,0,1,0,1
300200933,1,0,0,0,1
300100179,1,0,0,0,1
300095703,1,0,0,0,1
300013181,0,0,1,0,1
300787611,1,0,0,0,1
300884067,1,0,0,0,1
299874106,0,0,1,0,1
300913755,1,0,0,0,1
301792915,1,0,0,0,1
301780791,0,0,1,0,1
301736408,1,0,0,0,1
301725880,0,0,1,0,1
301713537,1,0,0,0,1
301662283,1,0,0,0,1
301573494,0,0,1,0,1
301512484,0,0,1,0,1
301509317,0,0,1,0,1
301502753,0,0,1,0,1
301357987,0,0,1,0,1
301344344,1,0,0,0,1
301334288,1,0,0,0,1
301277352,1,0,0,0,1
301129067,0,0,1,0,1
301123804,0,0,1,0,1
301101607,1,0,0,0,1
299908455,0,0,1,0,1
299762353,0,0,1,0,1
302174376,0,0,1,0,1
298543785,1,0,0,0,1
298333005,0,0,1,0,1
298304737,1,0,0,0,1
298280633,1,0,0,0,1
298168189,1,0,0,0,1
298086688,1,0,0,0,1
298069608,1,0,0,0,1
297961512,1,0,0,0,1
297907675,0,0,1,0,1
297904807,1,0,0,0,1
297851337,0,0,1,0,1
297732471,1,0,0,0,1
297728480,1,0,0,0,1
297679759,0,0,1,0,1
297656889,1,0,0,0,1
297633318,1,0,0,0,1
297621781,1,0,0,0,1
297523086,1,0,0,0,1
298533088,0,0,1,0,1
298560290,0,0,1,0,1
299585706,0,0,1,0,1
298594689,1,0,0,0,1
299565154,1,0,0,0,1
299545644,1,0,0,0,1
299536270,1,0,0,0,1
299430284,1,0,0,0,1
299404927,0,0,1,0,1
299394723,0,0,1,0,1
299371992,1,0,0,0,1
299362103,1,0,0,0,1
299354435,1,0,0,0,1
299140599,1,0,0,0,1
299132013,1,0,0,0,1
299097519,1,0,0,0,1
299080216,1,0,0,0,1
298921063,1,0,0,0,1
298817288,1,0,0,0,1
298691341,0,0,1,0,1
298632130,1,0,0,0,1
301884869,1,0,0,0,1
302225631,0,0,1,0,1
297458185,1,0,0,0,1
305569545,1,0,0,0,1
305382701,1,0,0,0,1
305351979,1,0,0,0,1
305341862,0,0,1,0,1
305328434,1,0,0,0,1
305323614,1,0,0,0,1
305308677,1,0,0,0,1
305256600,1,0,0,0,1
305171363,1,0,0,0,1
305170893,0,0,1,0,1
305152466,1,0,0,0,1
305144235,1,0,0,0,1
305092694,1,0,0,0,1
305082237,0,0,1,0,1
304866105,1,0,0,0,1
304726994,1,0,0,0,1
304541267,0,0,1,0,1
304481466,0,0,1,0,1
305503356,0,0,0,1,1
305598092,0,0,1,0,1
304459512,1,0,0,0,1
305613304,0,0,1,0,1
307056262,1,0,0,0,1
307037923,1,0,0,0,1
306912176,1,0,0,0,1
306862995,1,0,0,0,1
306712634,0,0,1,0,1
306615620,1,0,0,0,1
306361395,1,0,0,0,1
306351832,1,0,0,0,1
306341427,0,0,1,0,1
306335409,0,0,1,0,1
306324544,1,0,0,0,1
306044400,1,0,0,0,1
306036072,1,0,0,0,1
305884143,1,0,0,0,1
305760033,1,0,0,0,1
305725246,0,0,1,0,1
305613328,1,0,0,0,1
304460696,1,0,0,0,1
304437303,0,0,1,0,1
302253393,0,0,0,1,1
303481918,1,0,0,0,1
303344746,1,0,0,0,1
303321105,1,0,0,0,1
303319010,0,0,1,0,1
303258981,1,0,0,0,1
303185676,0,0,1,0,1
303176278,1,0,0,0,1
303026719,1,0,0,0,1
303011364,0,0,1,0,1
303007898,0,0,1,0,1
302843131,0,0,1,0,1
302801473,1,0,0,0,1
302786557,1,0,0,0,1
302706009,1,0,0,0,1
302503899,1,0,0,0,1
302494062,0,0,1,0,1
302488974,0,0,1,0,1
302353701,1,0,0,0,1
303380387,0,0,1,0,1
303509327,1,0,0,0,1
304386444,0,0,1,0,1
303512557,1,0,0,0,1
304385565,1,0,0,0,1
304317395,1,0,0,0,1
304270755,0,0,1,0,1
304182642,0,0,1,0,1
304172695,1,0,0,0,1
304168787,0,0,1,0,1
304149311,1,0,0,0,1
303995322,1,0,0,0,1
303947699,1,0,0,0,1
303941435,0,0,1,0,1
303929008,1,0,0,0,1
303784261,0,0,1,0,1
303749984,1,0,0,0,1
303744808,1,0,0,0,1
303726828,1,0,0,0,1
303643917,1,0,0,0,1
303537032,1,0,0,0,1
297498338,0,0,1,0,1
297430185,1,0,0,0,1
307205588,0,0,1,0,1
287461820,1,0,0,0,1
287392790,1,0,0,0,1
287332625,0,0,1,0,1
287262465,1,0,0,0,1
287258329,0,0,1,0,1
287254825,0,0,1,0,1
287238606,1,0,0,0,1
287193099,1,0,0,0,1
287178820,1,0,0,0,1
287165101,1,0,0,0,1
287131923,1,0,0,0,1
287131759,1,0,0,0,1
286949805,1,0,0,0,1
286908240,0,0,1,0,1
286897393,1,0,0,0,1
286844487,0,0,1,0,1
286742341,1,0,0,0,1
286725076,0,0,1,0,1
287433743,0,0,1,0,1
287646338,0,0,1,0,1
286502016,0,0,1,0,1
287828338,1,0,0,0,1
289366474,1,0,0,0,1
289358257,1,0,0,0,1
289266935,0,0,1,0,1
289221894,1,0,0,0,1
289020147,0,0,1,0,1
289003559,1,0,0,0,1
288981899,0,0,1,0,1
288951547,1,0,0,0,1
288707187,0,0,1,0,1
288688431,0,0,1,0,1
288485926,0,0,1,0,1
288480550,0,0,1,0,1
288440058,1,0,0,0,1
288388758,0,0,1,0,1
288251265,1,0,0,0,1
288193483,1,0,0,0,1
287940420,1,0,0,0,1
286632901,1,0,0,0,1
286250036,1,0,0,0,1
289996492,1,0,0,0,1
284919848,0,0,1,0,1
284862936,0,0,1,0,1
284818503,1,0,0,0,1
284801973,1,0,0,0,1
284790520,1,0,0,0,1
284776109,1,0,0,0,1
284764930,1,0,0,0,1
284718664,1,0,0,0,1
284534515,0,0,0,1,1
284533505,1,0,0,0,1
284502659,0,0,1,0,1
284411372,0,0,1,0,1
284354626,0,0,1,0,1
284298771,1,0,0,0,1
284231888,1,0,0,0,1
284206728,0,0,1,0,1
284188857,1,0,0,0,1
284090766,1,0,0,0,1
284894773,0,0,1,0,1
285042037,1,0,0,0,1
286224937,1,0,0,0,1
285076147,0,0,1,0,1
286136716,1,0,0,0,1
286120648,0,0,1,0,1
286081099,1,0,0,0,1
286080229,0,0,1,0,1
286046737,1,0,0,0,1
286039659,0,0,1,0,1
285946182,1,0,0,0,1
285941960,1,0,0,0,1
285845449,1,0,0,0,1
285731927,0,0,1,0,1
285597727,1,0,0,0,1
285546331,0,0,1,0,1
285300808,0,0,1,0,1
285299217,0,0,1,0,1
285227358,1,0,0,0,1
285149789,1,0,0,0,1
285102905,1,0,0,0,1
289948587,1,0,0,0,1
290156375,1,0,0,0,1
297386459,1,0,0,0,1
295556329,0,0,1,0,1
295229934,0,0,1,0,1
295015902,1,0,0,0,1
295015804,0,0,1,0,1
294997432,1,0,0,0,1
294986115,0,0,1,0,1
294941910,0,0,1,0,1
294862299,1,0,0,0,1
294695910,1,0,0,0,1
294320226,0,0,0,1,1
294300442,1,0,0,0,1
294015297,0,0,1,0,1
293871619,0,0,1,0,1
293848610,1,0,0,0,1
293827185,1,0,0,0,1
293791261,1,0,0,0,1
293765336,1,0,0,0,1
293727209,0,0,1,0,1
295330450,1,0,0,0,1
295596237,1,0,0,0,1
293569524,0,0,1,0,1
295620585,1,0,0,0,1
297358362,1,0,0,0,1
297249042,1,0,0,0,1
297236388,0,0,1,0,1
297043828,1,0,0,0,1
296980707,0,0,1,0,1
296937888,1,0,0,0,1
296801664,0,0,1,0,1
296787187,1,0,0,0,1
296760087,0,0,1,0,1
296745728,0,0,1,0,1
296720161,1,0,0,0,1
296716302,0,0,1,0,1
296641878,1,0,0,0,1
296362224,0,0,1,0,1
296130757,0,0,1,0,1
296080182,1,0,0,0,1
296079529,1,0,0,0,1
293686703,1,0,0,0,1
293474639,0,0,1,0,1
290200406,1,0,0,0,1
291682595,1,0,0,0,1
291562857,0,0,1,0,1
291479768,0,0,1,0,1
291420067,0,0,1,0,1
291273509,1,0,0,0,1
291190299,0,0,1,0,1
291091342,0,0,1,0,1
291026994,1,0,0,0,1
291007533,1,0,0,0,1
290753427,0,0,1,0,1
290574529,0,0,1,0,1
290574460,1,0,0,0,1
290520510,0,0,1,0,1
290498726,0,0,1,0,1
290480767,0,0,1,0,1
290467718,0,0,1,0,1
290408184,0,0,1,0,1
290208548,0,0,1,0,1
291667745,1,0,0,0,1
291811347,1,0,0,0,1
293393162,1,0,0,0,1
291827066,1,0,0,0,1
293262599,0,0,1,0,1
293259373,1,0,0,0,1
293228396,1,0,0,0,1
293172460,0,0,1,0,1
293157326,1,0,0,0,1
293045470,1,0,0,0,1
292644471,0,0,1,0,1
292461827,1,0,0,0,1
292409387,1,0,0,0,1
292334342,0,0,1,0,1
292256329,1,0,0,0,1
292232026,1,0,0,0,1
292219806,0,0,1,0,1
291891514,1,0,0,0,1
291879604,0,0,1,0,1
291873184,0,0,1,0,1
291863483,1,0,0,0,1
307198193,0,0,1,0,1
307205852,1,0,0,0,1
283816623,1,0,0,0,1
325573918,0,0,1,0,1
325320796,1,0,0,0,1
325297928,0,0,1,0,1
325162665,1,0,0,0,1
325084969,0,0,1,0,1
324990686,1,0,0,0,1
324955773,0,1,0,0,1
324907635,1,0,0,0,1
324861600,1,0,0,0,1
324844778,1,0,0,0,1
324684959,0,0,1,0,1
324663268,1,0,0,0,1
324590113,1,0,0,0,1
324456902,0,0,1,0,1
324311285,1,0,0,0,1
324304322,0,0,1,0,1
324301875,1,0,0,0,1
324275419,0,0,1,0,1
325570729,0,0,1,0,1
325614009,1,0,0,0,1
324092165,1,0,0,0,1
325629958,1,0,0,0,1
328102609,0,0,1,0,1
328093301,0,0,1,0,1
327930312,1,0,0,0,1
327789681,1,0,0,0,1
327541101,1,0,0,0,1
327501398,1,0,0,0,1
327215025,1,0,0,0,1
327161461,0,0,1,0,1
327105042,0,0,1,0,1
326709817,1,0,0,0,1
326399571,1,0,0,0,1
326346369,1,0,0,0,1
326089128,0,0,1,0,1
326064814,1,0,0,0,1
326036796,1,0,0,0,1
325949990,1,0,0,0,1
325646128,0,0,1,0,1
324189902,1,0,0,0,1
324032905,1,0,0,0,1
328312067,0,0,1,0,1
321182575,1,0,0,0,1
320932432,1,0,0,0,1
320796742,0,0,1,0,1
320632879,0,0,1,0,1
320413124,1,0,0,0,1
320262763,0,0,1,0,1
320104067,1,0,0,0,1
319891468,0,0,1,0,1
319889338,0,0,0,1,1
319743936,1,0,0,0,1
319642149,0,0,1,0,1
319616744,1,0,0,0,1
319453843,1,0,0,0,1
319140756,0,0,1,0,1
319053984,1,0,0,0,1
319039899,1,0,0,0,1
319005512,1,0,0,0,1
319004394,1,0,0,0,1
321010018,0,0,1,0,1
321208922,1,0,0,0,1
323986499,1,0,0,0,1
321224726,1,0,0,0,1
323774893,0,0,1,0,1
323658450,1,0,0,0,1
323626042,1,0,0,0,1
323452993,1,0,0,0,1
323442877,1,0,0,0,1
323298456,1,0,0,0,1
322739195,1,0,0,0,1
322484729,0,0,1,0,1
322460407,0,0,1,0,1
322248050,1,0,0,0,1
322060693,0,0,1,0,1
321952505,0,0,1,0,1
321874163,1,0,0,0,1
321823933,0,0,1,0,1
321571873,0,0,1,0,1
321402570,0,0,1,0,1
321364483,1,0,0,0,1
328114678,1,0,0,0,1
328405822,1,0,0,0,1
318811385,0,0,1,0,1
333916875,1,0,0,0,1
333872090,0,0,1,0,1
333870992,0,0,0,1,1
333828322,1,0,0,0,1
333740096,1,0,0,0,1
333713350,0,0,1,0,1
333463089,1,0,0,0,1
333405407,0,0,1,0,1
333263893,0,0,1,0,1
333122477,0,0,1,0,1
333026020,1,0,0,0,1
333012251,1,0,0,0,1
332891617,1,0,0,0,1
332637994,0,0,1,0,1
332584554,1,0,0,0,1
332290375,0,0,1,0,1
332269295,1,0,0,0,1
332259898,1,0,0,0,1
333913247,1,0,0,0,1
334001488,1,0,0,0,1
332001395,1,0,0,0,1
334009535,0,0,1,0,1
335389657,0,1,0,0,1
335076875,1,0,0,0,1
335072254,0,1,0,0,1
335040889,1,0,0,0,1
334767186,1,0,0,0,1
334740780,1,0,0,0,1
334605876,1,0,0,0,1
334594111,0,0,1,0,1
334567920,1,0,0,0,1
334500807,1,0,0,0,1
334334264,0,1,0,0,1
334300819,0,0,1,0,1
334206598,0,0,1,0,1
334188225,1,0,0,0,1
334157581,1,0,0,0,1
334095266,1,0,0,0,1
334094481,1,0,0,0,1
332058136,1,0,0,0,1
331846889,0,0,1,0,1
328439832,0,0,1,0,1
329966232,1,0,0,0,1
329841044,1,0,0,0,1
329664811,0,0,1,0,1
329582733,1,0,0,0,1
329544129,1,0,0,0,1
329426487,1,0,0,0,1
329342616,0,0,1,0,1
329320254,1,0,0,0,1
329110308,1,0,0,0,1
329090139,1,0,0,0,1
329063652,1,0,0,0,1
329062278,1,0,0,0,1
328977827,1,0,0,0,1
328865524,1,0,0,0,1
328812672,0,0,1,0,1
328778819,1,0,0,0,1
328697622,0,0,1,0,1
328575368,1,0,0,0,1
329928110,1,0,0,0,1
329967443,1,0,0,0,1
331845020,1,0,0,0,1
330097470,1,0,0,0,1
331402258,1,0,0,0,1
331373674,1,0,0,0,1
331360444,1,0,0,0,1
331296136,0,0,1,0,1
331278345,1,0,0,0,1
331277805,1,0,0,0,1
331107830,1,0,0,0,1
331034050,0,0,1,0,1
330894543,0,0,1,0,1
330886039,0,0,1,0,1
330729840,1,0,0,0,1
330311549,1,0,0,0,1
330259130,0,0,1,0,1
330257584,1,0,0,0,1
330209479,0,0,1,0,1
330198617,1,0,0,0,1
330157466,1,0,0,0,1
319003483,0,0,1,0,1
318788301,0,1,0,0,1
307330962,0,0,1,0,1
310429455,0,1,0,0,1
310317282,0,0,1,0,1
310282123,1,0,0,0,1
310274555,1,0,0,0,1
310264523,1,0,0,0,1
310230118,0,0,1,0,1
310229269,0,0,1,0,1
310169988,0,0,1,0,1
310133765,0,0,1,0,1
310019068,1,0,0,0,1
309951650,0,0,1,0,1
309945329,1,0,0,0,1
309936083,0,0,1,0,1
309828516,1,0,0,0,1
309784885,0,0,1,0,1
309772430,0,1,0,0,1
309742096,1,0,0,0,1
309713775,1,0,0,0,1
310360766,1,0,0,0,1
310486079,1,0,0,0,1
309636649,0,0,0,1,1
310588738,0,0,1,0,1
312027704,1,0,0,0,1
311857989,0,0,1,0,1
311799214,0,0,1,0,1
311794741,1,0,0,0,1
311438508,1,0,0,0,1
311400964,1,0,0,0,1
311400753,1,0,0,0,1
311340454,1,0,0,0,1
311182339,1,0,0,0,1
311115491,0,0,1,0,1
311055083,0,0,1,0,1
310916292,0,0,1,0,1
310907037,1,0,0,0,1
310899081,1,0,0,0,1
310870051,1,0,0,0,1
310756552,1,0,0,0,1
310648323,1,0,0,0,1
309662254,0,0,1,0,1
309602458,0,0,1,0,1
312059159,0,0,1,0,1
308529418,1,0,0,0,1
308478481,0,0,1,0,1
308410527,0,0,1,0,1
308334258,0,0,1,0,1
308316618,0,0,1,0,1
308295726,1,0,0,0,1
308295004,1,0,0,0,1
308198882,1,0,0,0,1
308173820,1,0,0,0,1
308124606,1,0,0,0,1
308020665,1,0,0,0,1
307948944,0,0,1,0,1
307734183,1,0,0,0,1
307723217,1,0,0,0,1
307627544,1,0,0,0,1
307596523,1,0,0,0,1
307580016,1,0,0,0,1
307362200,1,0,0,0,1
308493786,1,0,0,0,1
308567156,1,0,0,0,1
309588677,0,0,1,0,1
308574324,0,0,1,0,1
309568446,0,0,1,0,1
309534581,1,0,0,0,1
309395681,1,0,0,0,1
309358315,0,0,1,0,1
309271477,1,0,0,0,1
309246567,1,0,0,0,1
309240711,0,0,1,0,1
309220263,0,0,1,0,1
308942350,1,0,0,0,1
308917048,1,0,0,0,1
308809387,0,0,1,0,1
308798791,0,0,1,0,1
308789394,0,0,1,0,1
308723993,0,0,1,0,1
308721299,0,1,0,0,1
308692530,1,0,0,0,1
308578179,0,0,1,0,1
312035052,1,0,0,0,1
312104470,0,0,1,0,1
318755919,1,0,0,0,1
316623077,0,0,1,0,1
316536388,0,0,1,0,1
316493772,0,0,1,0,1
316463197,1,0,0,0,1
316441195,1,0,0,0,1
316440833,1,0,0,0,1
316423586,1,0,0,0,1
316295999,1,0,0,0,1
316222128,1,0,0,0,1
316179573,1,0,0,0,1
316004032,0,0,1,0,1
315952485,1,0,0,0,1
315928351,0,0,1,0,1
315905744,1,0,0,0,1
315874064,1,0,0,0,1
315758129,1,0,0,0,1
315721256,1,0,0,0,1
315642866,1,0,0,0,1
316589948,1,0,0,0,1
316803872,0,0,1,0,1
315497803,1,0,0,0,1
316886271,1,0,0,0,1
318743673,1,0,0,0,1
318589021,1,0,0,0,1
318559292,0,1,0,0,1
318515549,1,0,0,0,1
318453838,1,0,0,0,1
318425752,1,0,0,0,1
318397654,1,0,0,0,1
318213165,0,0,1,0,1
318199288,0,0,1,0,1
318194430,1,0,0,0,1
318184283,0,0,1,0,1
318182596,0,0,1,0,1
318094946,1,0,0,0,1
318046812,0,0,1,0,1
317770098,0,0,1,0,1
317369930,1,0,0,0,1
316908165,1,0,0,0,1
315563761,1,0,0,0,1
315428292,0,0,1,0,1
312410720,0,0,1,0,1
313827191,0,0,1,0,1
313659194,1,0,0,0,1
313653397,0,0,1,0,1
313591268,1,0,0,0,1
313557904,0,0,1,0,1
313387251,0,0,1,0,1
313368776,1,0,0,0,1
313345834,1,0,0,0,1
313345726,0,0,1,0,1
313120181,0,0,1,0,1
312983560,1,0,0,0,1
312977896,1,0,0,0,1
312923422,1,0,0,0,1
312841318,0,0,1,0,1
312738076,0,0,1,0,1
312699480,0,0,1,0,1
312486695,1,0,0,0,1
312472616,1,0,0,0,1
313802017,1,0,0,0,1
314036011,1,0,0,0,1
315313267,1,0,0,0,1
314096824,0,0,1,0,1
315299719,0,0,1,0,1
315171069,0,0,0,1,1
315129847,1,0,0,0,1
315123926,1,0,0,0,1
314971159,1,0,0,0,1
314868050,1,0,0,0,1
314766638,1,0,0,0,1
314730370,0,0,1,0,1
314722997,0,0,1,0,1
314682730,0,0,1,0,1
314597383,0,0,1,0,1
314494058,1,0,0,0,1
314457702,1,0,0,0,1
314368230,1,0,0,0,1
314360921,1,0,0,0,1
314302433,1,0,0,0,1
314197504,0,1,0,0,1
284018026,1,0,0,0,1
283812343,1,0,0,0,1
240094957,0,0,1,0,1
256634850,1,0,0,0,1
256504089,0,0,1,0,1
256403429,0,0,1,0,1
256326446,0,0,1,0,1
256296169,1,0,0,0,1
256287735,1,0,0,0,1
256245254,1,0,0,0,1
256227216,1,0,0,0,1
256115397,0,0,1,0,1
256104672,1,0,0,0,1
256071378,1,0,0,0,1
256065299,0,0,1,0,1
256064193,1,0,0,0,1
256052614,0,0,1,0,1
256031371,1,0,0,0,1
256012654,0,0,1,0,1
255990804,1,0,0,0,1
255980743,1,0,0,0,1
256556853,0,0,1,0,1
256664689,1,0,0,0,1
255827154,1,0,0,0,1
256679812,1,0,0,0,1
257634019,0,0,1,0,1
257629980,1,0,0,0,1
257622821,1,0,0,0,1
257585150,0,0,1,0,1
257434395,0,0,1,0,1
257390100,0,0,1,0,1
257348210,1,0,0,0,1
257245441,0,0,1,0,1
257171785,1,0,0,0,1
257053267,0,0,1,0,1
257035928,1,0,0,0,1
256899020,0,0,1,0,1
256894207,0,0,1,0,1
256878517,1,0,0,0,1
256748856,0,0,1,0,1
256726587,1,0,0,0,1
256680416,1,0,0,0,1
255882354,1,0,0,0,1
255811821,0,0,1,0,1
257677852,0,0,1,0,1
253681134,0,0,1,0,1
253519674,0,0,1,0,1
253513520,1,0,0,0,1
253353272,0,0,0,1,1
253242801,1,0,0,0,1
253238139,1,0,0,0,1
253125120,0,0,1,0,1
253110236,1,0,0,0,1
253095994,1,0,0,0,1
253091388,0,0,1,0,1
252855885,0,0,1,0,1
252824941,1,0,0,0,1
252796752,1,0,0,0,1
252786491,1,0,0,0,1
252782565,1,0,0,0,1
252764836,1,0,0,0,1
252643530,1,0,0,0,1
252642141,1,0,0,0,1
253549192,1,0,0,0,1
253845422,1,0,0,0,1
255787885,1,0,0,0,1
253937249,1,0,0,0,1
255655558,0,0,1,0,1
255636248,0,0,1,0,1
255627740,1,0,0,0,1
255618027,0,0,1,0,1
255577756,0,0,1,0,1
255409206,0,0,1,0,1
255347418,1,0,0,0,1
255257985,1,0,0,0,1
255178006,1,0,0,0,1
254771644,1,0,0,0,1
254423425,1,0,0,0,1
254386690,0,0,1,0,1
254359674,0,0,1,0,1
254335433,1,0,0,0,1
254169903,0,0,1,0,1
254150644,0,0,1,0,1
253977488,1,0,0,0,1
257653910,1,0,0,0,1
257766613,1,0,0,0,1
252641467,0,0,1,0,1
261594932,1,0,0,0,1
261563626,0,0,1,0,1
261560877,1,0,0,0,1
261467487,1,0,0,0,1
261424448,1,0,0,0,1
261412334,1,0,0,0,1
261036755,1,0,0,0,1
261008318,1,0,0,0,1
260846055,1,0,0,0,1
260842282,0,0,1,0,1
260808690,1,0,0,0,1
260604130,1,0,0,0,1
260589412,1,0,0,0,1
260475429,1,0,0,0,1
260452146,0,0,1,0,1
260263099,1,0,0,0,1
260029999,0,0,1,0,1
259996834,0,0,1,0,1
261584195,1,0,0,0,1
261604560,0,0,1,0,1
259917183,1,0,0,0,1
261647593,0,0,1,0,1
262571164,1,0,0,0,1
262527838,0,0,1,0,1
262458398,0,1,0,0,1
262436389,0,0,1,0,1
262320337,1,0,0,0,1
262270210,0,0,1,0,1
262091506,0,0,1,0,1
262035496,1,0,0,0,1
262026369,1,0,0,0,1
261952299,0,0,1,0,1
261898854,1,0,0,0,1
261891944,0,0,1,0,1
261879033,1,0,0,0,1
261854722,0,0,1,0,1
261674694,0,0,1,0,1
261663533,0,0,1,0,1
261649111,1,0,0,0,1
259968021,1,0,0,0,1
259888497,1,0,0,0,1
257837216,1,0,0,0,1
258804592,1,0,0,0,1
258468184,1,0,0,0,1
258461766,0,0,1,0,1
258441018,0,0,1,0,1
258375884,0,0,1,0,1
258374626,1,0,0,0,1
258280495,0,0,1,0,1
258251034,1,0,0,0,1
258221896,1,0,0,0,1
258057196,1,0,0,0,1
258003068,1,0,0,0,1
257993786,0,0,1,0,1
257965263,1,0,0,0,1
257908724,1,0,0,0,1
257897630,1,0,0,0,1
257897148,1,0,0,0,1
257889696,1,0,0,0,1
257839699,0,0,1,0,1
258629443,1,0,0,0,1
258818973,0,0,1,0,1
259838485,1,0,0,0,1
258856587,1,0,0,0,1
259736624,0,0,1,0,1
259616851,1,0,0,0,1
259502983,1,0,0,0,1
259474660,1,0,0,0,1
259459612,1,0,0,0,1
259422076,0,0,1,0,1
259393574,1,0,0,0,1
259365836,0,0,1,0,1
259282634,0,0,1,0,1
259271575,0,0,0,1,1
259268901,1,0,0,0,1
259262728,1,0,0,0,1
259229423,1,0,0,0,1
259199112,1,0,0,0,1
259076960,0,0,1,0,1
259005126,1,0,0,0,1
258880426,1,0,0,0,1
252641757,0,0,1,0,1
252628456,1,0,0,0,1
263007016,0,0,1,0,1
244819285,0,0,1,0,1
244733416,1,0,0,0,1
244624345,1,0,0,0,1
244602318,1,0,0,0,1
244596528,1,0,0,0,1
244581878,1,0,0,0,1
244217480,1,0,0,0,1
244135864,1,0,0,0,1
243944082,1,0,0,0,1
243909277,0,0,1,0,1
243741999,0,0,1,0,1
243716532,1,0,0,0,1
243627109,0,0,1,0,1
243556325,1,0,0,0,1
243540233,1,0,0,0,1
243524487,1,0,0,0,1
243466968,0,0,1,0,1
243378593,1,0,0,0,1
244734699,0,0,1,0,1
244831991,0,0,1,0,1
243204798,1,0,0,0,1
244906527,1,0,0,0,1
246197981,1,0,0,0,1
245960335,0,0,1,0,1
245842387,1,0,0,0,1
245781067,1,0,0,0,1
245686814,1,0,0,0,1
245684727,1,0,0,0,1
245464213,0,0,1,0,1
245447340,0,0,1,0,1
245356064,0,0,1,0,1
245243296,0,0,1,0,1
245238363,1,0,0,0,1
245164958,1,0,0,0,1
245160359,0,0,1,0,1
245159568,0,0,1,0,1
245014802,0,0,1,0,1
244964029,1,0,0,0,1
244920495,1,0,0,0,1
243333842,1,0,0,0,1
243115572,0,0,1,0,1
246255718,0,0,1,0,1
241718348,0,0,1,0,1
241674997,0,0,1,0,1
241513556,1,0,0,0,1
241390361,0,0,1,0,1
241366983,1,0,0,0,1
241366980,0,0,1,0,1
241361740,1,0,0,0,1
241359293,1,0,0,0,1
241318961,0,0,1,0,1
241158243,0,0,1,0,1
240858689,0,0,1,0,1
240746806,0,0,1,0,1
240706448,1,0,0,0,1
240480084,1,0,0,0,1
240239465,1,0,0,0,1
240203470,0,0,1,0,1
240200216,1,0,0,0,1
240099532,1,0,0,0,1
241697765,1,0,0,0,1
241729008,1,0,0,0,1
243039099,1,0,0,0,1
241737264,1,0,0,0,1
242995935,0,0,1,0,1
242967001,1,0,0,0,1
242841681,1,0,0,0,1
242805263,0,0,1,0,1
242802865,1,0,0,0,1
242737046,0,0,1,0,1
242622786,1,0,0,0,1
242603381,0,0,1,0,1
242571852,1,0,0,0,1
242438900,1,0,0,0,1
242393668,0,0,1,0,1
242348374,1,0,0,0,1
242330603,1,0,0,0,1
242323176,1,0,0,0,1
242312660,1,0,0,0,1
242289962,0,0,1,0,1
242094791,0,0,1,0,1
246232599,1,0,0,0,1
246351353,0,0,1,0,1
252575625,0,0,1,0,1
251548891,0,0,1,0,1
251447997,0,0,1,0,1
251126565,1,0,0,0,1
250993231,1,0,0,0,1
250965815,1,0,0,0,1
250828434,1,0,0,0,1
250771864,0,0,1,0,1
250734878,0,0,1,0,1
250689404,1,0,0,0,1
250660226,0,0,1,0,1
250585210,1,0,0,0,1
250566250,0,0,1,0,1
250512369,0,0,1,0,1
250413062,0,0,1,0,1
250390126,0,0,1,0,1
250207981,0,0,1,0,1
250149612,1,0,0,0,1
250124566,0,0,1,0,1
251468079,1,0,0,0,1
251578356,0,0,1,0,1
249983430,1,0,0,0,1
251588030,1,0,0,0,1
252541268,1,0,0,0,1
252437123,1,0,0,0,1
252432969,1,0,0,0,1
252372862,1,0,0,0,1
252320023,1,0,0,0,1
252171508,1,0,0,0,1
252168489,1,0,0,0,1
252105385,1,0,0,0,1
252034303,1,0,0,0,1
252026677,1,0,0,0,1
252010316,0,0,1,0,1
251968645,0,0,1,0,1
251943568,0,0,1,0,1
251807178,0,0,1,0,1
251805741,1,0,0,0,1
251781156,0,0,0,1,1
251772611,1,0,0,0,1
250079079,0,0,1,0,1
249965987,0,0,1,0,1
246422621,0,0,1,0,1
248153521,0,0,1,0,1
247671409,1,0,0,0,1
247662050,0,0,1,0,1
247644516,1,0,0,0,1
247538066,1,0,0,0,1
247312114,0,0,1,0,1
247296095,0,0,1,0,1
247280132,0,0,1,0,1
247126284,0,0,0,1,1
247064022,1,0,0,0,1
246791914,1,0,0,0,1
246717334,0,0,1,0,1
246630641,1,0,0,0,1
246623234,0,0,1,0,1
246620766,1,0,0,0,1
246611685,0,0,1,0,1
246499229,0,0,1,0,1
246481831,1,0,0,0,1
247713791,1,0,0,0,1
248161322,0,0,1,0,1
249846765,1,0,0,0,1
248404100,0,0,1,0,1
249681695,1,0,0,0,1
249676515,1,0,0,0,1
249637449,1,0,0,0,1
249500015,1,0,0,0,1
249308542,1,0,0,0,1
249286477,1,0,0,0,1
249210688,1,0,0,0,1
249104360,1,0,0,0,1
248971869,1,0,0,0,1
248944870,1,0,0,0,1
248788151,1,0,0,0,1
248747404,1,0,0,0,1
248707422,1,0,0,0,1
248665016,0,0,1,0,1
248547635,1,0,0,0,1
248444631,0,0,1,0,1
248406276,0,0,1,0,1
262582989,1,0,0,0,1
263009707,0,0,1,0,1
283807152,1,0,0,0,1
275527991,0,0,1,0,1
275402560,1,0,0,0,1
275343844,1,0,0,0,1
275337720,1,0,0,0,1
275322789,0,0,1,0,1
275162834,0,0,1,0,1
275149572,1,0,0,0,1
275061156,0,0,1,0,1
275031666,1,0,0,0,1
274911319,1,0,0,0,1
274665786,0,0,1,0,1
274615416,0,0,1,0,1
274606309,1,0,0,0,1
274605727,1,0,0,0,1
274604450,1,0,0,0,1
274591718,0,0,1,0,1
274590847,1,0,0,0,1
274298453,0,0,1,0,1
275435375,1,0,0,0,1
275548200,0,0,1,0,1
274278847,1,0,0,0,1
275821782,0,0,1,0,1
276933704,1,0,0,0,1
276931527,1,0,0,0,1
276866466,1,0,0,0,1
276865574,0,0,1,0,1
276831272,0,0,1,0,1
276713973,0,0,1,0,1
276702827,1,0,0,0,1
276684135,1,0,0,0,1
276683878,0,0,1,0,1
276558543,1,0,0,0,1
276381047,1,0,0,0,1
276365271,1,0,0,0,1
276314480,0,0,1,0,1
276308587,1,0,0,0,1
275948508,1,0,0,0,1
275839005,0,0,1,0,1
275822205,0,0,1,0,1
274285325,1,0,0,0,1
274078776,0,0,1,0,1
277164807,1,0,0,0,1
272602584,0,0,1,0,1
272571748,1,0,0,0,1
272545283,1,0,0,0,1
272538658,0,0,1,0,1
272536186,1,0,0,0,1
272504878,0,0,1,0,1
272336961,1,0,0,0,1
272326092,0,0,1,0,1
272290982,0,0,1,0,1
272265577,0,0,1,0,1
272265146,0,0,1,0,1
272210934,1,0,0,0,1
271990524,0,0,1,0,1
271980909,1,0,0,0,1
271928929,1,0,0,0,1
271910029,1,0,0,0,1
271880907,1,0,0,0,1
271841308,1,0,0,0,1
272591633,1,0,0,0,1
272771643,0,0,1,0,1
274050333,1,0,0,0,1
272787571,1,0,0,0,1
273812306,0,0,1,0,1
273792273,1,0,0,0,1
273768652,0,0,1,0,1
273645762,0,0,1,0,1
273632292,1,0,0,0,1
273596828,1,0,0,0,1
273544738,1,0,0,0,1
273519401,1,0,0,0,1
273344288,1,0,0,0,1
273324213,0,1,0,0,1
273312989,0,0,0,1,1
273177557,0,0,1,0,1
273057459,1,0,0,0,1
273044119,1,0,0,0,1
273031004,1,0,0,0,1
272966057,1,0,0,0,1
272806641,1,0,0,0,1
276950232,0,0,1,0,1
277189219,0,0,1,0,1
271782977,1,0,0,0,1
281974355,1,0,0,0,1
281493619,1,0,0,0,1
281458215,1,0,0,0,1
281417951,1,0,0,0,1
281199191,0,0,1,0,1
281152341,0,0,1,0,1
281122138,0,0,1,0,1
281015475,1,0,0,0,1
281003986,1,0,0,0,1
280968606,1,0,0,0,1
280953829,0,0,1,0,1
280926705,1,0,0,0,1
280893022,1,0,0,0,1
280764765,1,0,0,0,1
280749450,1,0,0,0,1
280477593,0,0,1,0,1
280461278,1,0,0,0,1
280427391,0,0,1,0,1
281842543,0,0,1,0,1
281986949,0,0,1,0,1
280351346,1,0,0,0,1
282074657,1,0,0,0,1
283679638,1,0,0,0,1
283451319,1,0,0,0,1
283430433,1,0,0,0,1
283377009,1,0,0,0,1
283307781,1,0,0,0,1
283247630,0,0,1,0,1
283085325,1,0,0,0,1
282898143,0,0,1,0,1
282860733,1,0,0,0,1
282782716,1,0,0,0,1
282769227,0,0,1,0,1
282748938,0,0,1,0,1
282462794,1,0,0,0,1
282450479,1,0,0,0,1
282409256,0,0,1,0,1
282262765,1,0,0,0,1
282224851,1,0,0,0,1
280383714,0,0,1,0,1
280343690,0,0,1,0,1
277249537,0,0,1,0,1
278922840,1,0,0,0,1
278691646,0,0,1,0,1
278685224,0,0,1,0,1
278361252,0,0,1,0,1
278330859,1,0,0,0,1
278304113,1,0,0,0,1
278241305,0,0,1,0,1
278161659,1,0,0,0,1
278054491,0,0,1,0,1
278032477,0,0,1,0,1
278026489,1,0,0,0,1
277969285,1,0,0,0,1
277939812,0,0,1,0,1
277844755,1,0,0,0,1
277742686,0,0,1,0,1
277736044,0,0,1,0,1
277690245,0,0,1,0,1
277359592,1,0,0,0,1
278790486,1,0,0,0,1
278934194,1,0,0,0,1
280209892,0,0,1,0,1
278938434,0,0,0,1,1
280209639,1,0,0,0,1
280178314,0,0,1,0,1
280163640,0,0,1,0,1
280097786,1,0,0,0,1
280066421,1,0,0,0,1
279752271,0,0,1,0,1
279749737,1,0,0,0,1
279728593,0,0,1,0,1
279594397,0,0,1,0,1
279516836,1,0,0,0,1
279498742,1,0,0,0,1
279469957,1,0,0,0,1
279333303,1,0,0,0,1
279237710,1,0,0,0,1
279208415,1,0,0,0,1
278991522,0,0,1,0,1
278964509,1,0,0,0,1
271784048,0,0,1,0,1
271663737,1,0,0,0,1
263113162,1,0,0,0,1
265644639,0,0,1,0,1
265620278,0,0,1,0,1
265576141,0,0,1,0,1
265524694,0,0,1,0,1
265512187,0,0,0,1,1
265458818,0,1,0,0,1
265288059,0,0,1,0,1
265286065,0,0,1,0,1
265263410,0,0,1,0,1
265248832,1,0,0,0,1
265204049,1,0,0,0,1
265188674,1,0,0,0,1
265171569,1,0,0,0,1
264966630,1,0,0,0,1
264965107,1,0,0,0,1
264963423,1,0,0,0,1
264962468,1,0,0,0,1
264950723,1,0,0,0,1
265628724,1,0,0,0,1
265648986,1,0,0,0,1
264851724,1,0,0,0,1
265651637,1,0,0,0,1
266582506,0,0,1,0,1
266561432,1,0,0,0,1
266505967,0,0,1,0,1
266502082,0,0,1,0,1
266476728,1,0,0,0,1
266413128,1,0,0,0,1
266346965,1,0,0,0,1
266316634,1,0,0,0,1
266310389,0,0,1,0,1
266291058,1,0,0,0,1
266152296,1,0,0,0,1
266128085,0,0,1,0,1
266026569,1,0,0,0,1
265891670,1,0,0,0,1
265888743,0,0,1,0,1
265876442,1,0,0,0,1
265666981,0,0,1,0,1
264934283,1,0,0,0,1
264849595,1,0,0,0,1
266836650,0,0,1,0,1
264113441,0,0,1,0,1
264094985,1,0,0,0,1
264090943,0,0,1,0,1
264088176,1,0,0,0,1
263984220,1,0,0,0,1
263969450,1,0,0,0,1
263951701,1,0,0,0,1
263945896,0,0,1,0,1
263916265,0,0,1,0,1
263755555,0,0,1,0,1
263566379,1,0,0,0,1
263564835,1,0,0,0,1
263453123,1,0,0,0,1
263408737,1,0,0,0,1
263351102,1,0,0,0,1
263312677,1,0,0,0,1
263259304,1,0,0,0,1
263200383,0,0,1,0,1
264109370,0,0,1,0,1
264149311,0,0,1,0,1
264842412,1,0,0,0,1
264156969,0,0,1,0,1
264829290,1,0,0,0,1
264817559,1,0,0,0,1
264816557,0,0,1,0,1
264809787,1,0,0,0,1
264777522,1,0,0,0,1
264722462,1,0,0,0,1
264693056,1,0,0,0,1
264676469,0,0,1,0,1
264601920,1,0,0,0,1
264587520,1,0,0,0,1
264527995,1,0,0,0,1
264514482,1,0,0,0,1
264493502,1,0,0,0,1
264358932,1,0,0,0,1
264330387,0,0,1,0,1
264324328,1,0,0,0,1
264157833,0,0,1,0,1
266800773,1,0,0,0,1
267015745,1,0,0,0,1
271641582,1,0,0,0,1
270280544,1,0,0,0,1
270144441,1,0,0,0,1
270123215,1,0,0,0,1
270074042,1,0,0,0,1
270029540,1,0,0,0,1
269909179,1,0,0,0,1
269885851,1,0,0,0,1
269840768,1,0,0,0,1
269838822,0,0,1,0,1
269836191,1,0,0,0,1
269818165,0,0,1,0,1
269763887,1,0,0,0,1
269756516,1,0,0,0,1
269633006,1,0,0,0,1
269526666,0,0,1,0,1
269510225,1,0,0,0,1
269375490,0,0,1,0,1
269345069,1,0,0,0,1
270278177,1,0,0,0,1
270309706,1,0,0,0,1
269215864,1,0,0,0,1
270314994,1,0,0,0,1
271638104,1,0,0,0,1
271602880,1,0,0,0,1
271391063,1,0,0,0,1
271337124,1,0,0,0,1
271300364,1,0,0,0,1
271299609,0,0,1,0,1
271282883,0,0,1,0,1
271146927,1,0,0,0,1
271110030,1,0,0,0,1
271094569,1,0,0,0,1
271050162,1,0,0,0,1
271035656,1,0,0,0,1
270796745,1,0,0,0,1
270645572,1,0,0,0,1
270554496,0,0,1,0,1
270536732,0,0,1,0,1
270340525,1,0,0,0,1
269311462,0,1,0,0,1
269116777,1,0,0,0,1
267046022,1,0,0,0,1
267933377,0,0,1,0,1
267860635,1,0,0,0,1
267839371,0,0,1,0,1
267753974,0,0,1,0,1
267744284,1,0,0,0,1
267713201,1,0,0,0,1
267708388,1,0,0,0,1
267702696,0,0,1,0,1
267696544,0,0,1,0,1
267681228,0,0,1,0,1
267636558,1,0,0,0,1
267591172,1,0,0,0,1
267582985,0,0,1,0,1
267405973,1,0,0,0,1
267369381,1,0,0,0,1
267223765,0,0,1,0,1
267163589,1,0,0,0,1
267113508,0,0,0,1,1
267927605,1,0,0,0,1
267938006,0,0,1,0,1
269114687,1,0,0,0,1
268149303,0,0,1,0,1
269078087,0,0,1,0,1
269049125,1,0,0,0,1
268896283,0,0,1,0,1
268885345,1,0,0,0,1
268868462,1,0,0,0,1
268831865,1,0,0,0,1
268802089,1,0,0,0,1
268757078,0,0,1,0,1
268644876,1,0,0,0,1
268631641,0,0,1,0,1
268537798,0,0,1,0,1
268529394,0,0,1,0,1
268417148,0,1,0,0,1
268298026,1,0,0,0,1
268219508,0,0,1,0,1
268194413,1,0,0,0,1
268149976,0,0,1,0,1
223393782,0,0,1,0,1
47988409,1,0,0,0,1
56193545,0,0,0,1,1
6430105,0,0,1,0,1
6445684,1,0,0,0,1
6444987,1,0,0,0,1
6444711,1,0,0,0,1
6444696,0,0,1,0,1
6441411,1,0,0,0,1
6439477,1,0,0,0,1
6438118,0,0,1,0,1
6434434,1,0,0,0,1
6433320,0,0,1,0,1
6426063,1,0,0,0,1
6392776,1,0,0,0,1
6415261,0,0,1,0,1
6407741,0,0,1,0,1
6404225,1,0,0,0,1
6403403,1,0,0,0,1
6397629,1,0,0,0,1
6396827,1,0,0,0,1
6394738,0,0,1,0,1
6394409,1,0,0,0,1
6393112,0,0,1,0,1
6447944,1,0,0,0,1
6452596,1,0,0,0,1
6455775,1,0,0,0,1
6456799,1,0,0,0,1
6491377,0,0,1,0,1
6487616,1,0,0,0,1
6486737,1,0,0,0,1
6486250,1,0,0,0,1
6483295,1,0,0,0,1
6476178,1,0,0,0,1
6474891,0,0,1,0,1
6474826,1,0,0,0,1
6472794,0,0,1,0,1
6471326,0,0,1,0,1
6470787,1,0,0,0,1
6467048,0,0,1,0,1
6466505,1,0,0,0,1
6465781,1,0,0,0,1
6459374,0,0,1,0,1
6458590,0,0,1,0,1
6458446,1,0,0,0,1
6458347,1,0,0,0,1
6457253,0,0,1,0,1
6393008,1,0,0,0,1
6391886,1,0,0,0,1
6494389,0,0,1,0,1
6297882,1,0,0,0,1
6323006,1,0,0,0,1
6317137,1,0,0,0,1
6314010,0,0,1,0,1
6313991,1,0,0,0,1
6313448,1,0,0,0,1
6312670,1,0,0,0,1
6310115,0,0,1,0,1
6309019,1,0,0,0,1
6305367,1,0,0,0,1
6294995,1,0,0,0,1
6390340,0,0,1,0,1
6294856,0,0,1,0,1
6291509,1,0,0,0,1
6287848,0,0,1,0,1
6285979,1,0,0,0,1
6283678,1,0,0,0,1
6279607,0,0,1,0,1
6279066,1,0,0,0,1
6278716,1,0,0,0,1
6278387,1,0,0,0,1
6324250,1,0,0,0,1
6327629,0,0,1,0,1
6334250,1,0,0,0,1
6335037,1,0,0,0,1
6389984,1,0,0,0,1
6388666,0,0,1,0,1
6388234,0,0,1,0,1
6387541,1,0,0,0,1
6386894,1,0,0,0,1
6382046,1,0,0,0,1
6378149,0,0,1,0,1
6376364,1,0,0,0,1
6369681,0,0,1,0,1
6367907,0,0,1,0,1
6365660,1,0,0,0,1
6357668,1,0,0,0,1
6357228,0,0,1,0,1
6356476,1,0,0,0,1
6344971,1,0,0,0,1
6338496,1,0,0,0,1
6338005,0,0,1,0,1
6337952,1,0,0,0,1
6337882,1,0,0,0,1
6492234,0,0,1,0,1
6495511,1,0,0,0,1
5781885,1,0,0,0,1
6662358,1,0,0,0,1
6683775,0,0,1,0,1
6680071,0,0,1,0,1
6677589,0,0,1,0,1
6676046,0,0,1,0,1
6674211,1,0,0,0,1
6672450,1,0,0,0,1
6672223,1,0,0,0,1
6670822,1,0,0,0,1
6670007,1,0,0,0,1
6661559,0,0,1,0,1
6624772,1,0,0,0,1
6655162,0,0,1,0,1
6654682,1,0,0,0,1
6650559,0,0,1,0,1
6648437,0,0,1,0,1
6645613,1,0,0,0,1
6645134,0,0,1,0,1
6645096,0,0,1,0,1
6636303,1,0,0,0,1
6630320,1,0,0,0,1
6688471,0,0,1,0,1
6694436,1,0,0,0,1
6695224,1,0,0,0,1
6696648,1,0,0,0,1
6721139,1,0,0,0,1
6720617,0,0,1,0,1
6720254,1,0,0,0,1
6717488,1,0,0,0,1
6716450,1,0,0,0,1
6713072,1,0,0,0,1
6712411,1,0,0,0,1
6707833,1,0,0,0,1
6707708,1,0,0,0,1
6707228,0,0,1,0,1
6707119,1,0,0,0,1
6706914,0,0,1,0,1
6706726,1,0,0,0,1
6706379,0,0,1,0,1
6705983,1,0,0,0,1
6705828,1,0,0,0,1
6702100,0,0,1,0,1
6697886,0,0,1,0,1
6697833,1,0,0,0,1
6625516,1,0,0,0,1
6623512,0,0,1,0,1
6499364,1,0,0,0,1
6519890,1,0,0,0,1
6533489,1,0,0,0,1
6532132,1,0,0,0,1
6531502,1,0,0,0,1
6528007,1,0,0,0,1
6527023,0,0,1,0,1
6524725,1,0,0,0,1
6524338,0,0,1,0,1
6523823,1,0,0,0,1
6520264,0,0,1,0,1
6517654,1,0,0,0,1
6623402,1,0,0,0,1
6515570,1,0,0,0,1
6515431,0,0,1,0,1
6513960,0,0,1,0,1
6504434,0,0,1,0,1
6503950,0,0,0,1,1
6502766,1,0,0,0,1
6502688,1,0,0,0,1
6501582,0,0,1,0,1
6501137,1,0,0,0,1
6534266,1,0,0,0,1
6541960,1,0,0,0,1
6543299,1,0,0,0,1
6544323,1,0,0,0,1
6621587,1,0,0,0,1
6617848,1,0,0,0,1
6615826,0,0,1,0,1
6609228,1,0,0,0,1
6608183,0,0,1,0,1
6606618,0,0,0,1,1
6600525,0,0,1,0,1
6588016,1,0,0,0,1
6582962,1,0,0,0,1
6575712,0,0,1,0,1
6575447,1,0,0,0,1
6574489,0,0,1,0,1
6571805,0,0,1,0,1
6570630,0,0,1,0,1
6570552,1,0,0,0,1
6569891,0,0,1,0,1
6567286,1,0,0,0,1
6565512,0,0,1,0,1
6564232,0,0,1,0,1
6275345,1,0,0,0,1
6274742,1,0,0,0,1
6274432,0,0,1,0,1
5954527,1,0,0,0,1
5976443,1,0,0,0,1
5974094,1,0,0,0,1
5972246,0,0,1,0,1
5970733,0,0,0,1,1
5968464,1,0,0,0,1
5962196,0,0,1,0,1
5961343,0,0,1,0,1
5959653,0,0,1,0,1
5955262,1,0,0,0,1
5945241,1,0,0,0,1
5919678,0,0,1,0,1
5944946,1,0,0,0,1
5944855,1,0,0,0,1
5943212,1,0,0,0,1
5941405,0,0,1,0,1
5938496,1,0,0,0,1
5937189,0,0,1,0,1
5926785,1,0,0,0,1
5925984,0,0,1,0,1
5925222,1,0,0,0,1
5976698,0,0,1,0,1
5983145,1,0,0,0,1
5987007,1,0,0,0,1
5988452,1,0,0,0,1
6032380,1,0,0,0,1
6032373,1,0,0,0,1
6031454,0,0,1,0,1
6029096,1,0,0,0,1
6028102,0,0,0,1,1
6025804,0,0,1,0,1
6023360,0,0,1,0,1
6022622,1,0,0,0,1
6012816,1,0,0,0,1
6012629,1,0,0,0,1
6010467,1,0,0,0,1
6007970,0,0,1,0,1
6004716,0,0,1,0,1
6003891,0,0,1,0,1
6002231,0,0,1,0,1
6001984,1,0,0,0,1
5999440,0,0,1,0,1
5998033,0,0,1,0,1
5990565,0,0,1,0,1
5922211,0,0,1,0,1
5918341,1,0,0,0,1
6274269,1,0,0,0,1
5800767,0,0,1,0,1
5838825,0,0,1,0,1
5832321,1,0,0,0,1
5827529,1,0,0,0,1
5826497,1,0,0,0,1
5816670,1,0,0,0,1
5814274,1,0,0,0,1
5812675,1,0,0,0,1
5810978,1,0,0,0,1
5808765,1,0,0,0,1
5800174,0,0,1,0,1
5917464,1,0,0,0,1
5792120,0,0,1,0,1
5790405,1,0,0,0,1
5789328,1,0,0,0,1
5789204,0,0,1,0,1
5788393,1,0,0,0,1
5787701,1,0,0,0,1
5785497,0,0,1,0,1
5785240,1,0,0,0,1
5783747,1,0,0,0,1
5844443,1,0,0,0,1
5851913,1,0,0,0,1
5854594,1,0,0,0,1
5854655,1,0,0,0,1
5917164,1,0,0,0,1
5912357,1,0,0,0,1
5907649,0,0,1,0,1
5900670,1,0,0,0,1
5898139,1,0,0,0,1
5897784,0,0,1,0,1
5897760,0,0,1,0,1
5895282,1,0,0,0,1
5894425,1,0,0,0,1
5893206,1,0,0,0,1
5887081,1,0,0,0,1
5879951,0,0,1,0,1
5879729,1,0,0,0,1
5878862,1,0,0,0,1
5868807,1,0,0,0,1
5865860,0,0,1,0,1
5865259,1,0,0,0,1
5861197,1,0,0,0,1
5857948,1,0,0,0,1
6034354,0,0,1,0,1
6034691,0,0,1,0,1
6040624,1,0,0,0,1
6189263,1,0,0,0,1
6223874,1,0,0,0,1
6219701,1,0,0,0,1
6218023,1,0,0,0,1
6216526,0,0,1,0,1
6209044,1,0,0,0,1
6200411,1,0,0,0,1
6198824,1,0,0,0,1
6198638,1,0,0,0,1
6194657,0,0,1,0,1
6187202,1,0,0,0,1
6044644,1,0,0,0,1
6185604,1,0,0,0,1
6183406,1,0,0,0,1
6180052,1,0,0,0,1
6179439,1,0,0,0,1
6177121,1,0,0,0,1
6175955,1,0,0,0,1
6172959,1,0,0,0,1
6171984,1,0,0,0,1
6171968,1,0,0,0,1
6226676,1,0,0,0,1
6227706,0,0,1,0,1
6230230,1,0,0,0,1
6230673,1,0,0,0,1
6273146,0,0,1,0,1
6272317,0,0,1,0,1
6271572,1,0,0,0,1
6271042,0,0,1,0,1
6265305,0,0,1,0,1
6263296,1,0,0,0,1
6263282,1,0,0,0,1
6260963,1,0,0,0,1
6259917,1,0,0,0,1
6255163,1,0,0,0,1
6253811,0,0,1,0,1
6250141,1,0,0,0,1
6245535,1,0,0,0,1
6238348,1,0,0,0,1
6238225,1,0,0,0,1
6237087,0,0,1,0,1
6236010,1,0,0,0,1
6234875,1,0,0,0,1
6231683,1,0,0,0,1
6169516,0,0,1,0,1
6158370,0,0,1,0,1
6156517,1,0,0,0,1
6083756,1,0,0,0,1
6080024,0,0,1,0,1
6079156,1,0,0,0,1
6076617,1,0,0,0,1
6075580,0,0,1,0,1
6075567,1,0,0,0,1
6073347,1,0,0,0,1
6072790,1,0,0,0,1
6069897,0,0,1,0,1
6067124,1,0,0,0,1
6060075,1,0,0,0,1
6057624,1,0,0,0,1
6053379,1,0,0,0,1
6051934,0,0,1,0,1
6051149,1,0,0,0,1
6050369,1,0,0,0,1
6050250,1,0,0,0,1
6050234,1,0,0,0,1
6048514,1,0,0,0,1
6047516,0,0,1,0,1
6082745,1,0,0,0,1
6089159,1,0,0,0,1
6154298,1,0,0,0,1
6089213,1,0,0,0,1
6153186,1,0,0,0,1
6150064,0,0,1,0,1
6146579,1,0,0,0,1
6145679,1,0,0,0,1
6144668,1,0,0,0,1
6143272,0,0,1,0,1
6142196,1,0,0,0,1
6133754,1,0,0,0,1
6131397,0,0,1,0,1
6121678,0,0,1,0,1
6119933,0,0,1,0,1
6116657,1,0,0,0,1
6114916,1,0,0,0,1
6111084,1,0,0,0,1
6105036,1,0,0,0,1
6104459,0,0,1,0,1
6104449,1,0,0,0,1
6097348,1,0,0,0,1
6097120,0,0,1,0,1
6722310,0,0,1,0,1
6723969,1,0,0,0,1
6725667,0,0,1,0,1
7256281,0,0,1,0,1
7285042,0,0,1,0,1
7281126,1,0,0,0,1
7268300,0,0,1,0,1
7265267,1,0,0,0,1
7265110,1,0,0,0,1
7262145,0,0,1,0,1
7259859,1,0,0,0,1
7258900,0,0,1,0,1
7257731,1,0,0,0,1
7249636,0,0,1,0,1
7234603,0,0,1,0,1
7245580,1,0,0,0,1
7245466,1,0,0,0,1
7244288,1,0,0,0,1
7244025,1,0,0,0,1
7243674,0,0,1,0,1
7241982,1,0,0,0,1
7241359,0,0,1,0,1
7239439,1,0,0,0,1
7239125,1,0,0,0,1
7285322,1,0,0,0,1
7291044,0,0,1,0,1
7301545,1,0,0,0,1
7304425,0,0,1,0,1
7360880,0,0,1,0,1
7359251,1,0,0,0,1
7356377,1,0,0,0,1
7355953,1,0,0,0,1
7353062,1,0,0,0,1
7349950,1,0,0,0,1
7344277,0,0,1,0,1
7342535,1,0,0,0,1
7342104,1,0,0,0,1
7340654,0,0,1,0,1
7339760,1,0,0,0,1
7329934,1,0,0,0,1
7324487,1,0,0,0,1
7324189,1,0,0,0,1
7322303,0,0,1,0,1
7320160,1,0,0,0,1
7310057,0,0,1,0,1
7309232,1,0,0,0,1
7305006,0,0,1,0,1
7236336,1,0,0,0,1
7229833,1,0,0,0,1
7116018,1,0,0,0,1
7138636,1,0,0,0,1
7159349,0,0,1,0,1
7159107,1,0,0,0,1
7156474,1,0,0,0,1
7155183,1,0,0,0,1
7152220,0,0,1,0,1
7149860,1,0,0,0,1
7145048,1,0,0,0,1
7139819,1,0,0,0,1
7138874,1,0,0,0,1
7137049,0,0,1,0,1
7229763,1,0,0,0,1
7133387,1,0,0,0,1
7132792,1,0,0,0,1
7130382,0,0,1,0,1
7130003,0,0,1,0,1
7125872,1,0,0,0,1
7120328,1,0,0,0,1
7119612,0,0,1,0,1
7118658,0,0,1,0,1
7117383,1,0,0,0,1
7165563,1,0,0,0,1
7167968,1,0,0,0,1
7169746,1,0,0,0,1
7173996,0,0,1,0,1
7228995,1,0,0,0,1
7227844,1,0,0,0,1
7226962,1,0,0,0,1
7216788,1,0,0,0,1
7216016,1,0,0,0,1
7215773,0,0,1,0,1
7214842,0,0,1,0,1
7213246,1,0,0,0,1
7212175,1,0,0,0,1
7207866,0,0,1,0,1
7203997,1,0,0,0,1
7202390,0,0,1,0,1
7195103,0,0,1,0,1
7189415,1,0,0,0,1
7186661,1,0,0,0,1
7182520,1,0,0,0,1
7182337,1,0,0,0,1
7178784,1,0,0,0,1
7177483,1,0,0,0,1
7361593,1,0,0,0,1
7363096,1,0,0,0,1
7363236,1,0,0,0,1
7559036,0,0,1,0,1
7579627,1,0,0,0,1
7577421,1,0,0,0,1
7575614,1,0,0,0,1
7573842,1,0,0,0,1
7571391,0,0,1,0,1
7571380,0,0,1,0,1
7567309,1,0,0,0,1
7566397,1,0,0,0,1
7561215,1,0,0,0,1
7557124,1,0,0,0,1
7364894,0,0,1,0,1
7556789,0,0,1,0,1
7556128,0,0,1,0,1
7555939,0,0,1,0,1
7550725,1,0,0,0,1
7550464,0,0,1,0,1
7539044,1,0,0,0,1
7532013,0,0,1,0,1
7531229,0,0,1,0,1
7512454,1,0,0,0,1
7580514,1,0,0,0,1
7581642,0,0,1,0,1
7590543,1,0,0,0,1
7590917,0,0,1,0,1
7635592,0,0,1,0,1
7634973,1,0,0,0,1
7633037,1,0,0,0,1
7632976,1,0,0,0,1
7628817,1,0,0,0,1
7624316,1,0,0,0,1
7622929,1,0,0,0,1
7621768,0,0,1,0,1
7620864,0,0,1,0,1
7618966,1,0,0,0,1
7616444,1,0,0,0,1
7614268,1,0,0,0,1
7611383,0,0,1,0,1
7607092,1,0,0,0,1
7605261,1,0,0,0,1
7599988,1,0,0,0,1
7598580,1,0,0,0,1
7594757,0,0,1,0,1
7594266,1,0,0,0,1
7511881,0,0,1,0,1
7505535,0,0,1,0,1
7503132,1,0,0,0,1
7411076,1,0,0,0,1
7409073,0,0,1,0,1
7408257,0,0,1,0,1
7407846,0,0,1,0,1
7402258,1,0,0,0,1
7401344,0,0,1,0,1
7398990,1,0,0,0,1
7388499,1,0,0,0,1
7388128,0,0,1,0,1
7385139,0,0,1,0,1
7380558,0,0,1,0,1
7379511,1,0,0,0,1
7379243,1,0,0,0,1
7377615,1,0,0,0,1
7377007,1,0,0,0,1
7375767,1,0,0,0,1
7371085,0,0,1,0,1
7370191,0,0,1,0,1
7367006,1,0,0,0,1
7365719,1,0,0,0,1
7410082,0,0,1,0,1
7412033,1,0,0,0,1
7498832,0,0,1,0,1
7416563,0,0,1,0,1
7495768,1,0,0,0,1
7489344,0,0,1,0,1
7483317,1,0,0,0,1
7476145,0,0,1,0,1
7465850,1,0,0,0,1
7465509,1,0,0,0,1
7462906,1,0,0,0,1
7461203,1,0,0,0,1
7460466,1,0,0,0,1
7453255,0,0,1,0,1
7451879,1,0,0,0,1
7451613,1,0,0,0,1
7450345,1,0,0,0,1
7449292,0,0,1,0,1
7445415,1,0,0,0,1
7432764,1,0,0,0,1
7432626,0,0,1,0,1
7430914,1,0,0,0,1
7420139,1,0,0,0,1
7116594,1,0,0,0,1
7114926,1,0,0,0,1
6725872,1,0,0,0,1
6865699,0,0,1,0,1
6885530,1,0,0,0,1
6884282,0,0,1,0,1
6882340,0,0,0,1,1
6881792,0,0,1,0,1
6880682,1,0,0,0,1
6878612,1,0,0,0,1
6874611,1,0,0,0,1
6869305,1,0,0,0,1
6866620,1,0,0,0,1
6857752,1,0,0,0,1
6843497,0,0,1,0,1
6856247,1,0,0,0,1
6854910,0,0,1,0,1
6854750,1,0,0,0,1
6854214,1,0,0,0,1
6853414,0,0,1,0,1
6850350,0,0,1,0,1
6847312,1,0,0,0,1
6846161,1,0,0,0,1
6845673,0,0,1,0,1
6895430,1,0,0,0,1
6896056,1,0,0,0,1
6897732,0,0,1,0,1
6898461,0,0,1,0,1
6926899,0,0,1,0,1
6923756,1,0,0,0,1
6919899,1,0,0,0,1
6918423,1,0,0,0,1
6918093,0,0,1,0,1
6916278,1,0,0,0,1
6914686,0,0,1,0,1
6913285,1,0,0,0,1
6913051,0,0,1,0,1
6911276,0,0,1,0,1
6909591,1,0,0,0,1
6908326,0,0,1,0,1
6904334,0,0,1,0,1
6903071,1,0,0,0,1
6902571,1,0,0,0,1
6902218,1,0,0,0,1
6901734,1,0,0,0,1
6899124,1,0,0,0,1
6898927,1,0,0,0,1
6844007,0,0,1,0,1
6842719,1,0,0,0,1
7112947,1,0,0,0,1
6761185,1,0,0,0,1
6789600,1,0,0,0,1
6788279,1,0,0,0,1
6787564,1,0,0,0,1
6779066,1,0,0,0,1
6772512,1,0,0,0,1
6771815,0,0,1,0,1
6771594,0,0,1,0,1
6770859,1,0,0,0,1
6761373,1,0,0,0,1
6757150,1,0,0,0,1
6837618,1,0,0,0,1
6756905,1,0,0,0,1
6755968,1,0,0,0,1
6755111,0,0,1,0,1
6754000,1,0,0,0,1
6745095,0,0,1,0,1
6744636,1,0,0,0,1
6743604,1,0,0,0,1
6742535,1,0,0,0,1
6735659,0,0,1,0,1
6789857,1,0,0,0,1
6789936,1,0,0,0,1
6789992,1,0,0,0,1
6792797,1,0,0,0,1
6837486,1,0,0,0,1
6835125,1,0,0,0,1
6834165,0,0,0,1,1
6833598,1,0,0,0,1
6833018,0,0,1,0,1
6826449,0,0,1,0,1
6824234,0,0,1,0,1
6819812,1,0,0,0,1
6818674,1,0,0,0,1
6807894,1,0,0,0,1
6805463,0,0,1,0,1
6804141,1,0,0,0,1
6802844,1,0,0,0,1
6802796,1,0,0,0,1
6801469,1,0,0,0,1
6797332,1,0,0,0,1
6796668,1,0,0,0,1
6796395,0,0,1,0,1
6793885,0,0,1,0,1
6928558,1,0,0,0,1
6930315,1,0,0,0,1
6933112,0,0,1,0,1
7033514,1,0,0,0,1
7051379,0,0,1,0,1
7049728,1,0,0,0,1
7041731,1,0,0,0,1
7041668,0,0,1,0,1
7041410,0,0,1,0,1
7039396,1,0,0,0,1
7038904,1,0,0,0,1
7034736,1,0,0,0,1
7033731,0,0,1,0,1
7031196,1,0,0,0,1
6933440,1,0,0,0,1
7028387,1,0,0,0,1
7028046,1,0,0,0,1
7027396,0,0,1,0,1
7027191,1,0,0,0,1
7023935,1,0,0,0,1
7022470,1,0,0,0,1
7018895,1,0,0,0,1
7018179,1,0,0,0,1
7018154,1,0,0,0,1
7055319,0,0,1,0,1
7057608,0,0,1,0,1
7065413,0,0,1,0,1
7069480,1,0,0,0,1
7112116,0,0,1,0,1
7110202,1,0,0,0,1
7106617,1,0,0,0,1
7101220,0,0,1,0,1
7097844,1,0,0,0,1
7097558,1,0,0,0,1
7096964,1,0,0,0,1
7093576,0,0,1,0,1
7090408,1,0,0,0,1
7088466,1,0,0,0,1
7087709,1,0,0,0,1
7086450,0,0,1,0,1
7085117,1,0,0,0,1
7079175,0,0,1,0,1
7077897,1,0,0,0,1
7076939,1,0,0,0,1
7074749,1,0,0,0,1
7072861,1,0,0,0,1
7070648,0,0,0,1,1
7017213,1,0,0,0,1
7016520,1,0,0,0,1
7013830,1,0,0,0,1
6970732,0,0,1,0,1
6965700,0,0,1,0,1
6965682,1,0,0,0,1
6964353,1,0,0,0,1
6963310,1,0,0,0,1
6960621,1,0,0,0,1
6959061,0,0,1,0,1
6958439,1,0,0,0,1
6957798,1,0,0,0,1
6954579,0,0,1,0,1
6954001,0,0,1,0,1
6952789,1,0,0,0,1
6950431,1,0,0,0,1
6949594,1,0,0,0,1
6948005,0,0,1,0,1
6947307,0,0,1,0,1
6946573,1,0,0,0,1
6945333,0,0,0,1,1
6938506,0,0,1,0,1
6934546,0,0,1,0,1
6967723,1,0,0,0,1
6970733,1,0,0,0,1
7013452,1,0,0,0,1
6970862,1,0,0,0,1
7013442,0,0,1,0,1
7010789,0,0,1,0,1
7009234,1,0,0,0,1
7006878,1,0,0,0,1
7005540,0,0,1,0,1
7003397,0,0,1,0,1
7001027,1,0,0,0,1
6999831,1,0,0,0,1
6997654,1,0,0,0,1
6994503,1,0,0,0,1
6992420,0,0,1,0,1
6990590,1,0,0,0,1
6989825,1,0,0,0,1
6989380,1,0,0,0,1
6988653,0,0,1,0,1
6980995,1,0,0,0,1
6980650,1,0,0,0,1
6978404,1,0,0,0,1
6976808,1,0,0,0,1
5783039,1,0,0,0,1
5778935,1,0,0,0,1
7640852,0,0,1,0,1
4486811,1,0,0,0,1
4501003,1,0,0,0,1
4499676,1,0,0,0,1
4498389,0,0,1,0,1
4497670,0,0,1,0,1
4497387,1,0,0,0,1
4495918,0,0,1,0,1
4493085,1,0,0,0,1
4490676,1,0,0,0,1
4487224,1,0,0,0,1
4478946,1,0,0,0,1
4454372,1,0,0,0,1
4473420,0,0,1,0,1
4471600,1,0,0,0,1
4469832,0,0,1,0,1
4464764,1,0,0,0,1
4463379,1,0,0,0,1
4463195,1,0,0,0,1
4462547,0,0,1,0,1
4461031,1,0,0,0,1
4459883,0,0,1,0,1
4513827,1,0,0,0,1
4516038,0,0,1,0,1
4516365,1,0,0,0,1
4517005,1,0,0,0,1
4581489,0,0,1,0,1
4579864,1,0,0,0,1
4579626,1,0,0,0,1
4576698,1,0,0,0,1
4576564,0,0,1,0,1
4576234,0,0,1,0,1
4572968,0,0,1,0,1
4565786,1,0,0,0,1
4565614,1,0,0,0,1
4564600,1,0,0,0,1
4557936,0,0,1,0,1
4554793,1,0,0,0,1
4549552,1,0,0,0,1
4549440,0,0,1,0,1
4540122,1,0,0,0,1
4534686,1,0,0,0,1
4522418,0,0,1,0,1
4521174,1,0,0,0,1
4520672,1,0,0,0,1
4456000,1,0,0,0,1
4452717,1,0,0,0,1
4582155,1,0,0,0,1
4396038,1,0,0,0,1
4414774,1,0,0,0,1
4413909,1,0,0,0,1
4413028,1,0,0,0,1
4411751,1,0,0,0,1
4411040,0,0,1,0,1
4405241,1,0,0,0,1
4401973,0,0,1,0,1
4401527,0,0,1,0,1
4396337,1,0,0,0,1
4394871,1,0,0,0,1
4451246,0,0,1,0,1
4393358,0,0,1,0,1
4392992,1,0,0,0,1
4392549,1,0,0,0,1
4392420,1,0,0,0,1
4391922,1,0,0,0,1
4390881,1,0,0,0,1
4389871,1,0,0,0,1
4384444,1,0,0,0,1
4383475,1,0,0,0,1
4417493,0,0,1,0,1
4420306,0,0,1,0,1
4421323,1,0,0,0,1
4422368,1,0,0,0,1
4451240,0,0,1,0,1
4446593,1,0,0,0,1
4446138,1,0,0,0,1
4445796,0,0,1,0,1
4445677,1,0,0,0,1
4445616,1,0,0,0,1
4445005,1,0,0,0,1
4444524,0,0,1,0,1
4443863,1,0,0,0,1
4442608,1,0,0,0,1
4440389,1,0,0,0,1
4435623,1,0,0,0,1
4434798,1,0,0,0,1
4428757,0,0,1,0,1
4428742,0,0,1,0,1
4428278,1,0,0,0,1
4427679,1,0,0,0,1
4425694,1,0,0,0,1
4422465,1,0,0,0,1
4581860,0,0,1,0,1
4582357,0,0,1,0,1
5778653,0,0,1,0,1
4757826,1,0,0,0,1
4803103,0,0,1,0,1
4797755,1,0,0,0,1
4794638,1,0,0,0,1
4792032,1,0,0,0,1
4783987,0,0,1,0,1
4777135,0,0,1,0,1
4775716,1,0,0,0,1
4771202,1,0,0,0,1
4765290,0,0,1,0,1
4750434,1,0,0,0,1
4702833,1,0,0,0,1
4745560,1,0,0,0,1
4743258,0,0,1,0,1
4732500,1,0,0,0,1
4731046,0,0,1,0,1
4726696,1,0,0,0,1
4726355,1,0,0,0,1
4718049,1,0,0,0,1
4715469,1,0,0,0,1
4704914,1,0,0,0,1
4806989,1,0,0,0,1
4807448,0,0,1,0,1
4808242,0,0,0,1,1
4808450,0,0,1,0,1
4836650,1,0,0,0,1
4835582,1,0,0,0,1
4835399,1,0,0,0,1
4835177,0,0,1,0,1
4834868,1,0,0,0,1
4834187,1,0,0,0,1
4833238,0,0,1,0,1
4831440,1,0,0,0,1
4830699,1,0,0,0,1
4830421,0,0,1,0,1
4829797,0,0,1,0,1
4829216,1,0,0,0,1
4828055,1,0,0,0,1
4827009,0,0,1,0,1
4825815,0,0,1,0,1
4823243,1,0,0,0,1
4823146,1,0,0,0,1
4822956,1,0,0,0,1
4810688,1,0,0,0,1
4703687,1,0,0,0,1
4702135,0,0,1,0,1
4586937,1,0,0,0,1
4618480,0,0,1,0,1
4636483,0,0,1,0,1
4631581,1,0,0,0,1
4629474,1,0,0,0,1
4628519,1,0,0,0,1
4624753,1,0,0,0,1
4623612,0,0,1,0,1
4622317,1,0,0,0,1
4622027,1,0,0,0,1
4621134,0,0,1,0,1
4616773,1,0,0,0,1
4701443,0,0,1,0,1
4606577,1,0,0,0,1
4605212,1,0,0,0,1
4601948,1,0,0,0,1
4601412,0,0,1,0,1
4600589,0,0,1,0,1
4598848,1,0,0,0,1
4598714,0,0,1,0,1
4591403,0,0,1,0,1
4587045,1,0,0,0,1
4641918,1,0,0,0,1
4642186,1,0,0,0,1
4644172,0,0,1,0,1
4646395,1,0,0,0,1
4694251,1,0,0,0,1
4693148,1,0,0,0,1
4691878,0,0,1,0,1
4690301,1,0,0,0,1
4687722,0,0,1,0,1
4685815,0,0,1,0,1
4683415,1,0,0,0,1
4681227,0,0,1,0,1
4681134,0,0,1,0,1
4676971,1,0,0,0,1
4671389,0,0,1,0,1
4669488,0,0,1,0,1
4667102,0,0,1,0,1
4665764,1,0,0,0,1
4663899,1,0,0,0,1
4660888,1,0,0,0,1
4657597,1,0,0,0,1
4655461,1,0,0,0,1
4646764,0,0,1,0,1
4380395,1,0,0,0,1
4380358,0,0,1,0,1
4378919,1,0,0,0,1
4246574,1,0,0,0,1
4264360,1,0,0,0,1
4264248,1,0,0,0,1
4263511,0,0,1,0,1
4262510,0,0,1,0,1
4259154,0,0,1,0,1
4255290,1,0,0,0,1
4255130,1,0,0,0,1
4252490,0,0,1,0,1
4248868,1,0,0,0,1
4244200,1,0,0,0,1
4231401,1,0,0,0,1
4244052,1,0,0,0,1
4239809,1,0,0,0,1
4238591,0,0,1,0,1
4237535,1,0,0,0,1
4233535,0,0,1,0,1
4233288,1,0,0,0,1
4233168,0,0,1,0,1
4233005,1,0,0,0,1
4231845,1,0,0,0,1
4264648,1,0,0,0,1
4265028,0,0,1,0,1
4266017,1,0,0,0,1
4266202,0,0,1,0,1
4284154,1,0,0,0,1
4283974,1,0,0,0,1
4282125,1,0,0,0,1
4281844,0,0,1,0,1
4281159,1,0,0,0,1
4280869,1,0,0,0,1
4279827,1,0,0,0,1
4279005,0,0,1,0,1
4277248,1,0,0,0,1
4276251,1,0,0,0,1
4275400,0,0,1,0,1
4275336,1,0,0,0,1
4275254,1,0,0,0,1
4274594,1,0,0,0,1
4273740,1,0,0,0,1
4272748,1,0,0,0,1
4271676,1,0,0,0,1
4269459,0,0,1,0,1
4267075,1,0,0,0,1
4231636,0,0,1,0,1
4229387,1,0,0,0,1
4378763,0,0,1,0,1
4182164,1,0,0,0,1
4194142,1,0,0,0,1
4192716,0,0,1,0,1
4191076,1,0,0,0,1
4189538,1,0,0,0,1
4186145,1,0,0,0,1
4185984,0,0,1,0,1
4185342,1,0,0,0,1
4185119,1,0,0,0,1
4183061,1,0,0,0,1
4181677,1,0,0,0,1
4227531,1,0,0,0,1
4177178,1,0,0,0,1
4176842,1,0,0,0,1
4176838,1,0,0,0,1
4176137,1,0,0,0,1
4175606,1,0,0,0,1
4175473,1,0,0,0,1
4173868,0,0,1,0,1
4173726,1,0,0,0,1
4173415,0,0,1,0,1
4194830,0,0,1,0,1
4194894,1,0,0,0,1
4198645,0,0,1,0,1
4199653,1,0,0,0,1
4225997,1,0,0,0,1
4224588,0,0,1,0,1
4224513,1,0,0,0,1
4224480,0,0,1,0,1
4224309,0,0,1,0,1
4223227,1,0,0,0,1
4223044,1,0,0,0,1
4220920,1,0,0,0,1
4218873,0,0,1,0,1
4218449,1,0,0,0,1
4217878,0,0,1,0,1
4210456,1,0,0,0,1
4210130,1,0,0,0,1
4210082,0,0,1,0,1
4207560,0,0,1,0,1
4205588,1,0,0,0,1
4205149,0,0,1,0,1
4204890,1,0,0,0,1
4202248,0,0,1,0,1
4290578,0,0,1,0,1
4291088,1,0,0,0,1
4292600,1,0,0,0,1
4345735,1,0,0,0,1
4357223,0,0,1,0,1
4355788,1,0,0,0,1
4354856,0,0,1,0,1
4354289,1,0,0,0,1
4352502,1,0,0,0,1
4352085,1,0,0,0,1
4351695,0,0,1,0,1
4351028,0,0,1,0,1
4348003,1,0,0,0,1
4343834,1,0,0,0,1
4293110,1,0,0,0,1
4343152,1,0,0,0,1
4342052,0,0,1,0,1
4336763,1,0,0,0,1
4336107,0,0,1,0,1
4335872,1,0,0,0,1
4334757,0,0,1,0,1
4334736,1,0,0,0,1
4333612,1,0,0,0,1
4332666,1,0,0,0,1
4358264,1,0,0,0,1
4358812,1,0,0,0,1
4361344,1,0,0,0,1
4362140,1,0,0,0,1
4376320,1,0,0,0,1
4376076,0,0,1,0,1
4376062,1,0,0,0,1
4375819,1,0,0,0,1
4374828,1,0,0,0,1
4374433,0,0,1,0,1
4373699,1,0,0,0,1
4372934,1,0,0,0,1
4372524,0,0,0,1,1
4372160,0,0,1,0,1
4370956,1,0,0,0,1
4368043,0,0,1,0,1
4366974,1,0,0,0,1
4365662,0,0,1,0,1
4365496,0,0,1,0,1
4365106,1,0,0,0,1
4363775,0,0,1,0,1
4363605,0,0,1,0,1
4363412,1,0,0,0,1
4331864,1,0,0,0,1
4331581,1,0,0,0,1
4330726,1,0,0,0,1
4308094,1,0,0,0,1
4307922,1,0,0,0,1
4307662,1,0,0,0,1
4306959,1,0,0,0,1
4306950,0,0,0,1,1
4305955,1,0,0,0,1
4305407,1,0,0,0,1
4303181,1,0,0,0,1
4302160,0,0,1,0,1
4301655,1,0,0,0,1
4298896,1,0,0,0,1
4298654,1,0,0,0,1
4298167,1,0,0,0,1
4298073,1,0,0,0,1
4298040,0,0,1,0,1
4297109,1,0,0,0,1
4296770,1,0,0,0,1
4296422,1,0,0,0,1
4295671,1,0,0,0,1
4294646,1,0,0,0,1
4308068,0,0,1,0,1
4309521,0,0,1,0,1
4328272,1,0,0,0,1
4311243,1,0,0,0,1
4328005,0,0,1,0,1
4327888,1,0,0,0,1
4327859,1,0,0,0,1
4327300,1,0,0,0,1
4327100,1,0,0,0,1
4324105,1,0,0,0,1
4323625,0,0,1,0,1
4320908,1,0,0,0,1
4319841,1,0,0,0,1
4319369,1,0,0,0,1
4318729,1,0,0,0,1
4318363,1,0,0,0,1
4317615,1,0,0,0,1
4316973,1,0,0,0,1
4316439,0,0,1,0,1
4314639,0,0,1,0,1
4313527,1,0,0,0,1
4311832,0,0,0,1,1
4311270,1,0,0,0,1
4837614,1,0,0,0,1
4843750,1,0,0,0,1
4845585,0,0,1,0,1
5474579,1,0,0,0,1
5502239,1,0,0,0,1
5499612,1,0,0,0,1
5489956,1,0,0,0,1
5487321,0,0,1,0,1
5485733,1,0,0,0,1
5481358,1,0,0,0,1
5480274,0,0,1,0,1
5479559,0,0,1,0,1
5476372,0,0,1,0,1
5468901,0,0,1,0,1
5444717,1,0,0,0,1
5468033,1,0,0,0,1
5468026,0,0,1,0,1
5466113,1,0,0,0,1
5465947,0,0,1,0,1
5460788,1,0,0,0,1
5454862,0,0,1,0,1
5452701,1,0,0,0,1
5448955,1,0,0,0,1
5446918,1,0,0,0,1
5504415,1,0,0,0,1
5507676,1,0,0,0,1
5513694,1,0,0,0,1
5515591,1,0,0,0,1
5564276,0,0,1,0,1
5563508,1,0,0,0,1
5563142,1,0,0,0,1
5561950,1,0,0,0,1
5561816,0,0,1,0,1
5561136,0,0,1,0,1
5560425,1,0,0,0,1
5559432,1,0,0,0,1
5557073,1,0,0,0,1
5553355,1,0,0,0,1
5548597,1,0,0,0,1
5545354,1,0,0,0,1
5545129,1,0,0,0,1
5536278,0,0,1,0,1
5530093,1,0,0,0,1
5524401,0,0,1,0,1
5522547,0,0,1,0,1
5520355,1,0,0,0,1
5519122,1,0,0,0,1
5445371,1,0,0,0,1
5440952,0,0,0,1,1
5328880,1,0,0,0,1
5351965,1,0,0,0,1
5368671,0,0,1,0,1
5368201,1,0,0,0,1
5367097,0,0,1,0,1
5362783,1,0,0,0,1
5362257,1,0,0,0,1
5361360,1,0,0,0,1
5354927,0,0,1,0,1
5354200,1,0,0,0,1
5353151,0,0,1,0,1
5350896,1,0,0,0,1
5437444,1,0,0,0,1
5350711,1,0,0,0,1
5350185,1,0,0,0,1
5346874,1,0,0,0,1
5346743,1,0,0,0,1
5346314,1,0,0,0,1
5341060,1,0,0,0,1
5339881,1,0,0,0,1
5339839,1,0,0,0,1
5334994,0,0,1,0,1
5374258,1,0,0,0,1
5376008,1,0,0,0,1
5380471,1,0,0,0,1
5383703,1,0,0,0,1
5435713,1,0,0,0,1
5435208,1,0,0,0,1
5435074,0,0,1,0,1
5434492,1,0,0,0,1
5423999,1,0,0,0,1
5418972,1,0,0,0,1
5417600,1,0,0,0,1
5407403,0,0,1,0,1
5406114,1,0,0,0,1
5402500,1,0,0,0,1
5400884,0,0,1,0,1
5400205,0,0,1,0,1
5399418,0,0,1,0,1
5392354,1,0,0,0,1
5391472,0,0,1,0,1
5390302,1,0,0,0,1
5388411,1,0,0,0,1
5387997,0,0,1,0,1
5385913,1,0,0,0,1
5565918,1,0,0,0,1
5569141,0,0,1,0,1
5570436,0,0,1,0,1
5719357,1,0,0,0,1
5740022,0,0,1,0,1
5738733,1,0,0,0,1
5736671,1,0,0,0,1
5735174,1,0,0,0,1
5734689,1,0,0,0,1
5733298,1,0,0,0,1
5722995,1,0,0,0,1
5721788,0,0,1,0,1
5720054,1,0,0,0,1
5718871,0,0,1,0,1
5574620,1,0,0,0,1
5716241,1,0,0,0,1
5710183,0,0,1,0,1
5709606,1,0,0,0,1
5708402,1,0,0,0,1
5707409,1,0,0,0,1
5704732,1,0,0,0,1
5699385,1,0,0,0,1
5695874,1,0,0,0,1
5693756,1,0,0,0,1
5740424,1,0,0,0,1
5741089,0,0,1,0,1
5742112,1,0,0,0,1
5742948,1,0,0,0,1
5777821,0,0,1,0,1
5776966,0,0,1,0,1
5771331,1,0,0,0,1
5769963,1,0,0,0,1
5769728,1,0,0,0,1
5769367,1,0,0,0,1
5768011,1,0,0,0,1
5765610,1,0,0,0,1
5764038,0,0,1,0,1
5761173,1,0,0,0,1
5761096,0,0,1,0,1
5760970,1,0,0,0,1
5759665,1,0,0,0,1
5751765,0,0,1,0,1
5751206,0,0,1,0,1
5749240,0,0,1,0,1
5744488,0,0,1,0,1
5744362,0,0,1,0,1
5743711,0,0,1,0,1
5693024,0,0,1,0,1
5691429,1,0,0,0,1
5689587,1,0,0,0,1
5641114,0,0,1,0,1
5641042,0,0,1,0,1
5636015,1,0,0,0,1
5634395,0,0,1,0,1
5628243,0,0,1,0,1
5623376,0,0,1,0,1
5622341,0,0,1,0,1
5612625,0,0,1,0,1
5611846,1,0,0,0,1
5610823,1,0,0,0,1
5609081,1,0,0,0,1
5607925,1,0,0,0,1
5606448,1,0,0,0,1
5605897,0,0,1,0,1
5603037,1,0,0,0,1
5600259,1,0,0,0,1
5599375,1,0,0,0,1
5592601,0,0,1,0,1
5588820,1,0,0,0,1
5581683,0,0,1,0,1
5641057,1,0,0,0,1
5642757,1,0,0,0,1
5687989,1,0,0,0,1
5643575,1,0,0,0,1
5684746,1,0,0,0,1
5684580,1,0,0,0,1
5681654,1,0,0,0,1
5680409,0,0,0,1,1
5678260,1,0,0,0,1
5671308,1,0,0,0,1
5668786,0,0,1,0,1
5668546,1,0,0,0,1
5668544,1,0,0,0,1
5665728,1,0,0,0,1
5665583,1,0,0,0,1
5659683,1,0,0,0,1
5657752,0,0,1,0,1
5650847,1,0,0,0,1
5650826,0,0,1,0,1
5650457,1,0,0,0,1
5647813,0,0,1,0,1
5644215,1,0,0,0,1
5644061,1,0,0,0,1
5334909,1,0,0,0,1
5325499,0,0,1,0,1
4847926,1,0,0,0,1
4983469,1,0,0,0,1
5007316,1,0,0,0,1
5004109,0,0,1,0,1
5003239,0,0,1,0,1
5001656,1,0,0,0,1
4996789,1,0,0,0,1
4993337,1,0,0,0,1
4992555,1,0,0,0,1
4991034,1,0,0,0,1
4990142,1,0,0,0,1
4982496,0,0,1,0,1
4965751,1,0,0,0,1
4982459,0,0,1,0,1
4980714,1,0,0,0,1
4979775,1,0,0,0,1
4976277,1,0,0,0,1
4976240,1,0,0,0,1
4974196,1,0,0,0,1
4973668,0,0,1,0,1
4969033,1,0,0,0,1
4967319,1,0,0,0,1
5008870,1,0,0,0,1
5008954,1,0,0,0,1
5014989,0,0,1,0,1
5016524,0,0,1,0,1
5072123,1,0,0,0,1
5071632,1,0,0,0,1
5067409,1,0,0,0,1
5064699,0,0,1,0,1
5060814,1,0,0,0,1
5053976,0,0,1,0,1
5052897,0,0,1,0,1
5050537,1,0,0,0,1
5047156,1,0,0,0,1
5037071,1,0,0,0,1
5026324,0,0,1,0,1
5025813,1,0,0,0,1
5025809,1,0,0,0,1
5022712,0,0,1,0,1
5022142,1,0,0,0,1
5019619,0,0,1,0,1
5018907,1,0,0,0,1
5017967,1,0,0,0,1
5017615,1,0,0,0,1
4966907,1,0,0,0,1
4965107,0,0,1,0,1
5325455,1,0,0,0,1
4907227,0,0,1,0,1
4920738,1,0,0,0,1
4914270,1,0,0,0,1
4912957,0,0,1,0,1
4911933,1,0,0,0,1
4910820,0,0,1,0,1
4910758,0,0,1,0,1
4909978,1,0,0,0,1
4909308,1,0,0,0,1
4907734,0,0,1,0,1
4906960,1,0,0,0,1
4964848,0,0,1,0,1
4900788,1,0,0,0,1
4900726,1,0,0,0,1
4888319,0,0,1,0,1
4887529,1,0,0,0,1
4878479,1,0,0,0,1
4876817,0,0,1,0,1
4875631,0,0,1,0,1
4865463,1,0,0,0,1
4865452,1,0,0,0,1
4922378,1,0,0,0,1
4922765,0,0,1,0,1
4923854,0,0,1,0,1
4924435,1,0,0,0,1
4964173,0,0,1,0,1
4961381,0,0,1,0,1
4960457,1,0,0,0,1
4956248,1,0,0,0,1
4955499,1,0,0,0,1
4955205,1,0,0,0,1
4950369,1,0,0,0,1
4946655,1,0,0,0,1
4942658,0,0,1,0,1
4942450,1,0,0,0,1
4940414,1,0,0,0,1
4940167,1,0,0,0,1
4938998,0,0,1,0,1
4938247,0,0,1,0,1
4936739,0,0,1,0,1
4930847,0,0,1,0,1
4929807,1,0,0,0,1
4928687,1,0,0,0,1
4924711,1,0,0,0,1
5072735,1,0,0,0,1
5073548,1,0,0,0,1
5074556,0,0,1,0,1
5226800,1,0,0,0,1
5259567,1,0,0,0,1
5252741,0,0,1,0,1
5251483,1,0,0,0,1
5245797,1,0,0,0,1
5245744,1,0,0,0,1
5242693,0,0,1,0,1
5238263,1,0,0,0,1
5235811,0,0,1,0,1
5234625,0,0,1,0,1
5225392,1,0,0,0,1
5074654,0,0,1,0,1
5225104,1,0,0,0,1
5225042,1,0,0,0,1
5224789,1,0,0,0,1
5221013,0,0,1,0,1
5220670,0,0,1,0,1
5215966,0,0,1,0,1
5215764,1,0,0,0,1
5202490,1,0,0,0,1
5200688,1,0,0,0,1
5270447,0,0,1,0,1
5273020,0,0,1,0,1
5281273,1,0,0,0,1
5282689,1,0,0,0,1
5321232,0,0,1,0,1
5318185,1,0,0,0,1
5313607,1,0,0,0,1
5313154,1,0,0,0,1
5309991,1,0,0,0,1
5309521,1,0,0,0,1
5309143,0,0,1,0,1
5308961,1,0,0,0,1
5300585,0,0,1,0,1
5299551,0,0,1,0,1
5295202,0,0,1,0,1
5293735,1,0,0,0,1
5292893,1,0,0,0,1
5291405,0,0,1,0,1
5288902,0,0,1,0,1
5288346,1,0,0,0,1
5287536,1,0,0,0,1
5283769,1,0,0,0,1
5283121,1,0,0,0,1
5191980,1,0,0,0,1
5190491,1,0,0,0,1
5190439,0,0,1,0,1
5130514,1,0,0,0,1
5125173,1,0,0,0,1
5124670,1,0,0,0,1
5123677,0,0,1,0,1
5123299,0,0,1,0,1
5123160,1,0,0,0,1
5120972,1,0,0,0,1
5119817,1,0,0,0,1
5117805,1,0,0,0,1
5111513,1,0,0,0,1
5110884,0,0,1,0,1
5110818,1,0,0,0,1
5109037,1,0,0,0,1
5107938,0,0,1,0,1
5092111,1,0,0,0,1
5085140,1,0,0,0,1
5081260,0,0,1,0,1
5075088,1,0,0,0,1
5075049,1,0,0,0,1
5074874,1,0,0,0,1
5125933,1,0,0,0,1
5133087,0,0,1,0,1
5189524,1,0,0,0,1
5134018,1,0,0,0,1
5188582,1,0,0,0,1
5179817,1,0,0,0,1
5172606,1,0,0,0,1
5165317,1,0,0,0,1
5164124,1,0,0,0,1
5163395,0,0,1,0,1
5162530,1,0,0,0,1
5159717,1,0,0,0,1
5153110,1,0,0,0,1
5152761,1,0,0,0,1
5152671,1,0,0,0,1
5151544,1,0,0,0,1
5148966,1,0,0,0,1
5147704,1,0,0,0,1
5141480,1,0,0,0,1
5140287,0,0,1,0,1
5140244,1,0,0,0,1
5139965,1,0,0,0,1
5137740,0,0,0,1,1
7638924,1,0,0,0,1
7644834,1,0,0,0,1
4167779,1,0,0,0,1
10826173,0,0,1,0,1
10855721,0,0,1,0,1
10852093,1,0,0,0,1
10839658,1,0,0,0,1
10838291,1,0,0,0,1
10836962,1,0,0,0,1
10836122,0,0,1,0,1
10834152,1,0,0,0,1
10832128,0,0,1,0,1
10831168,0,0,1,0,1
10826049,0,0,1,0,1
10779300,1,0,0,0,1
10812002,0,0,1,0,1
10811498,1,0,0,0,1
10811427,1,0,0,0,1
10800237,1,0,0,0,1
10799035,0,0,1,0,1
10787148,1,0,0,0,1
10786332,0,0,0,1,1
10785187,1,0,0,0,1
10784618,0,0,1,0,1
10856201,1,0,0,0,1
10859032,0,0,1,0,1
10859164,1,0,0,0,1
10864311,0,0,1,0,1
10952361,0,0,1,0,1
10952317,1,0,0,0,1
10945216,0,0,1,0,1
10929586,0,0,1,0,1
10921790,1,0,0,0,1
10916642,1,0,0,0,1
10915812,1,0,0,0,1
10910171,1,0,0,0,1
10909193,0,0,1,0,1
10906528,1,0,0,0,1
10903292,1,0,0,0,1
10902665,1,0,0,0,1
10896859,1,0,0,0,1
10896584,1,0,0,0,1
10894722,1,0,0,0,1
10884574,1,0,0,0,1
10870477,0,0,1,0,1
10870163,1,0,0,0,1
10870019,0,0,1,0,1
10782510,1,0,0,0,1
10777592,0,0,0,1,1
10974421,1,0,0,0,1
10674441,1,0,0,0,1
10700163,0,0,1,0,1
10697117,0,0,1,0,1
10694601,1,0,0,0,1
10692401,1,0,0,0,1
10685632,0,0,1,0,1
10683147,0,0,1,0,1
10681247,1,0,0,0,1
10679309,1,0,0,0,1
10677720,0,0,1,0,1
10674184,1,0,0,0,1
10777266,1,0,0,0,1
10672594,1,0,0,0,1
10671495,1,0,0,0,1
10667912,1,0,0,0,1
10666587,1,0,0,0,1
10665495,1,0,0,0,1
10665009,1,0,0,0,1
10661536,1,0,0,0,1
10659007,0,0,1,0,1
10657268,1,0,0,0,1
10700780,1,0,0,0,1
10703999,1,0,0,0,1
10710522,1,0,0,0,1
10711342,1,0,0,0,1
10771238,0,0,1,0,1
10771121,1,0,0,0,1
10770088,1,0,0,0,1
10764579,0,0,1,0,1
10763733,1,0,0,0,1
10762635,1,0,0,0,1
10746800,0,0,1,0,1
10744966,0,0,1,0,1
10744485,1,0,0,0,1
10736629,1,0,0,0,1
10736621,1,0,0,0,1
10736013,1,0,0,0,1
10721506,1,0,0,0,1
10721093,1,0,0,0,1
10720264,1,0,0,0,1
10718241,0,0,1,0,1
10717291,1,0,0,0,1
10716114,1,0,0,0,1
10711933,1,0,0,0,1
10952538,1,0,0,0,1
10975389,0,0,1,0,1
10150870,1,0,0,0,1
11196496,0,0,1,0,1
11243113,1,0,0,0,1
11241615,1,0,0,0,1
11241345,1,0,0,0,1
11234583,1,0,0,0,1
11231506,1,0,0,0,1
11228023,0,0,1,0,1
11203708,0,0,1,0,1
11200970,0,0,1,0,1
11199830,0,0,1,0,1
11192207,1,0,0,0,1
11136995,0,0,1,0,1
11191325,1,0,0,0,1
11189098,1,0,0,0,1
11181551,1,0,0,0,1
11179915,0,0,1,0,1
11179499,1,0,0,0,1
11168804,0,0,1,0,1
11163915,1,0,0,0,1
11158514,0,0,1,0,1
11157618,1,0,0,0,1
11243357,1,0,0,0,1
11246260,1,0,0,0,1
11249126,0,0,1,0,1
11249304,0,0,1,0,1
11306420,0,0,1,0,1
11304670,0,0,1,0,1
11303788,0,0,1,0,1
11302433,1,0,0,0,1
11301701,0,0,1,0,1
11298622,1,0,0,0,1
11296515,1,0,0,0,1
11293987,1,0,0,0,1
11286990,1,0,0,0,1
11280566,0,0,1,0,1
11280333,1,0,0,0,1
11279503,0,0,1,0,1
11279303,1,0,0,0,1
11274802,0,0,1,0,1
11273677,1,0,0,0,1
11268262,1,0,0,0,1
11262790,0,0,1,0,1
11260510,1,0,0,0,1
11249746,1,0,0,0,1
11138792,1,0,0,0,1
11136538,1,0,0,0,1
10976977,1,0,0,0,1
11012377,1,0,0,0,1
11045893,0,0,1,0,1
11042893,1,0,0,0,1
11028650,0,0,1,0,1
11026055,0,0,1,0,1
11025878,0,0,1,0,1
11021180,1,0,0,0,1
11018124,0,0,1,0,1
11016187,0,0,1,0,1
11013791,1,0,0,0,1
10999883,0,0,1,0,1
11129295,1,0,0,0,1
10995969,0,0,1,0,1
10995888,1,0,0,0,1
10994839,0,0,1,0,1
10994250,0,0,1,0,1
10994160,0,0,0,1,1
10992588,1,0,0,0,1
10987233,1,0,0,0,1
10981634,0,0,1,0,1
10981050,1,0,0,0,1
11048791,0,0,1,0,1
11050667,1,0,0,0,1
11051885,1,0,0,0,1
11052073,1,0,0,0,1
11126880,1,0,0,0,1
11123843,1,0,0,0,1
11122099,0,0,1,0,1
11121151,0,0,1,0,1
11120994,1,0,0,0,1
11111521,1,0,0,0,1
11105949,1,0,0,0,1
11084962,1,0,0,0,1
11081099,0,0,1,0,1
11079691,1,0,0,0,1
11079245,0,0,1,0,1
11078770,1,0,0,0,1
11073109,1,0,0,0,1
11071605,1,0,0,0,1
11071244,0,0,1,0,1
11068351,1,0,0,0,1
11057719,0,0,1,0,1
11057321,1,0,0,0,1
11056171,0,0,1,0,1
10656683,1,0,0,0,1
10646374,0,0,1,0,1
10643341,1,0,0,0,1
10338497,0,0,1,0,1
10365281,1,0,0,0,1
10364617,1,0,0,0,1
10352865,1,0,0,0,1
10350245,1,0,0,0,1
10348933,1,0,0,0,1
10347684,1,0,0,0,1
10346273,1,0,0,0,1
10346084,1,0,0,0,1
10338528,0,0,1,0,1
10337114,1,0,0,0,1
10303277,1,0,0,0,1
10335937,1,0,0,0,1
10335193,1,0,0,0,1
10335025,0,0,1,0,1
10331194,0,0,1,0,1
10328631,1,0,0,0,1
10323901,1,0,0,0,1
10320658,1,0,0,0,1
10319096,1,0,0,0,1
10314085,1,0,0,0,1
10366196,1,0,0,0,1
10366292,0,0,1,0,1
10367782,1,0,0,0,1
10371008,0,0,1,0,1
10406601,1,0,0,0,1
10403367,1,0,0,0,1
10399992,0,0,1,0,1
10398270,1,0,0,0,1
10396710,0,0,1,0,1
10396448,0,0,1,0,1
10396079,1,0,0,0,1
10394112,1,0,0,0,1
10391716,1,0,0,0,1
10391137,1,0,0,0,1
10388850,1,0,0,0,1
10388662,1,0,0,0,1
10387797,1,0,0,0,1
10384362,1,0,0,0,1
10384087,1,0,0,0,1
10383481,1,0,0,0,1
10374669,0,0,1,0,1
10373779,0,0,1,0,1
10371038,1,0,0,0,1
10304316,0,0,1,0,1
10302140,1,0,0,0,1
10643230,1,0,0,0,1
10197436,1,0,0,0,1
10225447,1,0,0,0,1
10217559,1,0,0,0,1
10212139,1,0,0,0,1
10210950,0,0,1,0,1
10208450,1,0,0,0,1
10200352,1,0,0,0,1
10199873,0,0,1,0,1
10199059,0,0,1,0,1
10198498,1,0,0,0,1
10197136,0,0,1,0,1
10295496,0,0,1,0,1
10194134,0,0,1,0,1
10191995,0,0,1,0,1
10186459,1,0,0,0,1
10184093,1,0,0,0,1
10184022,0,0,1,0,1
10179999,0,0,1,0,1
10162189,1,0,0,0,1
10160214,1,0,0,0,1
10154339,1,0,0,0,1
10238618,1,0,0,0,1
10239152,1,0,0,0,1
10240682,1,0,0,0,1
10240786,1,0,0,0,1
10294707,1,0,0,0,1
10291534,1,0,0,0,1
10286572,1,0,0,0,1
10285950,1,0,0,0,1
10284594,1,0,0,0,1
10283798,0,0,1,0,1
10283677,0,0,1,0,1
10277424,0,0,1,0,1
10273945,1,0,0,0,1
10273046,1,0,0,0,1
10265485,0,0,1,0,1
10264377,1,0,0,0,1
10264372,0,0,1,0,1
10259705,1,0,0,0,1
10256663,1,0,0,0,1
10255757,0,0,1,0,1
10252755,1,0,0,0,1
10251511,1,0,0,0,1
10241822,0,0,1,0,1
10406845,1,0,0,0,1
10410631,1,0,0,0,1
10411359,1,0,0,0,1
10563051,1,0,0,0,1
10577123,1,0,0,0,1
10576263,1,0,0,0,1
10574166,1,0,0,0,1
10573806,1,0,0,0,1
10573404,1,0,0,0,1
10572169,1,0,0,0,1
10571574,1,0,0,0,1
10564283,1,0,0,0,1
10563705,1,0,0,0,1
10557160,0,0,1,0,1
10411521,1,0,0,0,1
10553771,1,0,0,0,1
10553573,1,0,0,0,1
10552208,1,0,0,0,1
10551295,1,0,0,0,1
10549906,1,0,0,0,1
10549792,1,0,0,0,1
10547661,1,0,0,0,1
10545845,0,0,1,0,1
10545523,1,0,0,0,1
10577541,0,0,1,0,1
10577999,1,0,0,0,1
10584659,1,0,0,0,1
10590692,1,0,0,0,1
10642609,1,0,0,0,1
10642483,1,0,0,0,1
10641733,1,0,0,0,1
10638597,0,0,1,0,1
10621862,1,0,0,0,1
10621509,1,0,0,0,1
10621137,1,0,0,0,1
10620222,1,0,0,0,1
10620037,1,0,0,0,1
10619345,0,0,1,0,1
10618980,0,0,1,0,1
10610482,1,0,0,0,1
10609846,0,0,1,0,1
10606171,0,0,1,0,1
10606156,1,0,0,0,1
10600973,0,0,1,0,1
10599067,1,0,0,0,1
10594253,1,0,0,0,1
10593364,0,0,1,0,1
10535116,1,0,0,0,1
10533538,1,0,0,0,1
10533381,1,0,0,0,1
10471097,1,0,0,0,1
10459727,0,0,1,0,1
10459563,1,0,0,0,1
10458297,1,0,0,0,1
10458139,1,0,0,0,1
10457092,1,0,0,0,1
10454742,1,0,0,0,1
10451389,1,0,0,0,1
10449710,0,0,1,0,1
10448306,1,0,0,0,1
10447807,1,0,0,0,1
10445838,0,0,1,0,1
10441070,1,0,0,0,1
10440985,0,0,1,0,1
10437461,1,0,0,0,1
10433019,1,0,0,0,1
10428873,0,0,1,0,1
10418386,0,0,1,0,1
10416292,1,0,0,0,1
10413379,1,0,0,0,1
10461612,1,0,0,0,1
10473713,1,0,0,0,1
10532169,0,0,1,0,1
10474877,1,0,0,0,1
10529692,1,0,0,0,1
10527201,0,0,0,1,1
10526877,1,0,0,0,1
10526077,1,0,0,0,1
10516325,1,0,0,0,1
10512098,1,0,0,0,1
10511044,1,0,0,0,1
10506157,1,0,0,0,1
10503555,0,0,1,0,1
10500831,1,0,0,0,1
10499050,1,0,0,0,1
10491406,1,0,0,0,1
10490291,1,0,0,0,1
10489069,1,0,0,0,1
10487850,1,0,0,0,1
10485182,1,0,0,0,1
10478551,0,0,1,0,1
10478532,1,0,0,0,1
10478217,1,0,0,0,1
11307072,1,0,0,0,1
11308483,0,0,1,0,1
11308807,0,0,1,0,1
12428583,1,0,0,0,1
12474780,0,0,1,0,1
12465884,0,0,1,0,1
12462016,1,0,0,0,1
12460642,1,0,0,0,1
12458767,1,0,0,0,1
12454759,0,0,1,0,1
12449641,0,0,1,0,1
12435489,0,0,1,0,1
12428813,1,0,0,0,1
12426390,1,0,0,0,1
12386614,1,0,0,0,1
12424361,1,0,0,0,1
12421549,1,0,0,0,1
12420115,1,0,0,0,1
12419083,1,0,0,0,1
12417880,1,0,0,0,1
12404650,1,0,0,0,1
12398671,1,0,0,0,1
12394900,1,0,0,0,1
12394498,1,0,0,0,1
12478601,1,0,0,0,1
12484100,1,0,0,0,1
12485000,1,0,0,0,1
12495861,0,0,1,0,1
12570191,1,0,0,0,1
12551625,1,0,0,0,1
12541753,0,0,1,0,1
12541502,1,0,0,0,1
12541368,1,0,0,0,1
12540615,1,0,0,0,1
12539110,1,0,0,0,1
12535775,1,0,0,0,1
12534916,0,0,1,0,1
12533228,1,0,0,0,1
12528462,1,0,0,0,1
12517331,1,0,0,0,1
12514892,0,0,1,0,1
12512629,1,0,0,0,1
12511213,0,0,1,0,1
12511067,1,0,0,0,1
12505849,1,0,0,0,1
12502207,1,0,0,0,1
12498962,1,0,0,0,1
12388999,1,0,0,0,1
12385603,1,0,0,0,1
12114372,0,0,1,0,1
12162311,1,0,0,0,1
12222242,1,0,0,0,1
12220316,1,0,0,0,1
12215421,1,0,0,0,1
12213641,0,0,1,0,1
12213604,1,0,0,0,1
12191795,0,0,1,0,1
12190846,1,0,0,0,1
12186466,1,0,0,0,1
12176919,1,0,0,0,1
12155032,1,0,0,0,1
12374726,1,0,0,0,1
12154854,0,0,1,0,1
12151986,1,0,0,0,1
12149644,1,0,0,0,1
12146974,1,0,0,0,1
12145783,1,0,0,0,1
12140588,0,0,1,0,1
12129877,1,0,0,0,1
12128527,1,0,0,0,1
12126255,1,0,0,0,1
12223914,0,0,1,0,1
12226733,1,0,0,0,1
12231092,1,0,0,0,1
12241602,1,0,0,0,1
12368506,1,0,0,0,1
12368114,0,0,1,0,1
12361493,0,0,1,0,1
12360407,0,0,1,0,1
12353168,1,0,0,0,1
12348211,1,0,0,0,1
12346795,0,0,1,0,1
12330542,0,0,1,0,1
12303720,0,0,1,0,1
12300501,0,0,1,0,1
12298772,0,0,1,0,1
12292581,1,0,0,0,1
12290324,1,0,0,0,1
12276549,1,0,0,0,1
12269797,0,0,1,0,1
12267269,1,0,0,0,1
12261612,1,0,0,0,1
12256524,1,0,0,0,1
12254381,1,0,0,0,1
12573771,0,0,1,0,1
12575621,1,0,0,0,1
12577771,0,0,1,0,1
12796091,1,0,0,0,1
12845282,1,0,0,0,1
12841127,1,0,0,0,1
12827876,0,0,1,0,1
12825778,0,0,1,0,1
12802591,1,0,0,0,1
12802075,1,0,0,0,1
12801560,1,0,0,0,1
12798614,1,0,0,0,1
12797993,0,0,1,0,1
12795683,0,0,1,0,1
12584768,0,0,1,0,1
12795393,1,0,0,0,1
12776694,1,0,0,0,1
12776493,1,0,0,0,1
12774721,1,0,0,0,1
12773532,1,0,0,0,1
12767750,1,0,0,0,1
12764940,0,0,1,0,1
12764250,0,0,1,0,1
12762559,1,0,0,0,1
12859795,0,0,1,0,1
12878448,0,0,1,0,1
12879799,0,0,1,0,1
12881634,1,0,0,0,1
12986134,1,0,0,0,1
12968185,1,0,0,0,1
12967572,0,0,1,0,1
12966866,1,0,0,0,1
12965909,1,0,0,0,1
12965214,0,0,1,0,1
12965175,1,0,0,0,1
12959277,0,0,1,0,1
12950608,1,0,0,0,1
12949453,1,0,0,0,1
12943509,0,0,1,0,1
12938371,1,0,0,0,1
12933114,1,0,0,0,1
12930988,1,0,0,0,1
12913455,1,0,0,0,1
12903044,1,0,0,0,1
12899510,1,0,0,0,1
12898160,1,0,0,0,1
12895206,0,0,1,0,1
12760201,1,0,0,0,1
12758686,0,0,1,0,1
12757332,1,0,0,0,1
12642973,1,0,0,0,1
12638872,0,0,1,0,1
12637520,1,0,0,0,1
12633660,1,0,0,0,1
12625398,0,0,1,0,1
12624093,1,0,0,0,1
12621774,0,0,1,0,1
12619300,1,0,0,0,1
12616662,1,0,0,0,1
12615927,1,0,0,0,1
12614232,0,0,1,0,1
12610226,1,0,0,0,1
12608878,0,0,1,0,1
12608261,0,0,1,0,1
12606076,1,0,0,0,1
12605896,0,0,1,0,1
12603113,0,0,1,0,1
12602098,0,0,1,0,1
12586492,1,0,0,0,1
12586279,1,0,0,0,1
12641307,1,0,0,0,1
12646225,1,0,0,0,1
12749383,0,0,1,0,1
12647129,0,0,1,0,1
12744225,1,0,0,0,1
12743691,1,0,0,0,1
12743690,1,0,0,0,1
12732806,0,0,1,0,1
12730517,1,0,0,0,1
12729740,0,0,1,0,1
12722812,0,0,1,0,1
12711131,0,0,1,0,1
12703148,1,0,0,0,1
12703112,0,0,1,0,1
12699062,1,0,0,0,1
12697791,1,0,0,0,1
12690012,0,0,1,0,1
12679657,1,0,0,0,1
12674973,1,0,0,0,1
12672672,1,0,0,0,1
12662045,0,0,1,0,1
12655794,1,0,0,0,1
12649916,1,0,0,0,1
12122228,0,0,1,0,1
12109770,1,0,0,0,1
11332307,1,0,0,0,1
11526701,0,0,1,0,1
11554405,1,0,0,0,1
11549342,1,0,0,0,1
11549078,1,0,0,0,1
11547083,1,0,0,0,1
11543355,1,0,0,0,1
11542546,1,0,0,0,1
11541034,1,0,0,0,1
11539672,1,0,0,0,1
11530808,1,0,0,0,1
11526146,1,0,0,0,1
11484819,1,0,0,0,1
11513446,1,0,0,0,1
11513145,0,0,1,0,1
11512483,1,0,0,0,1
11511386,0,0,1,0,1
11510329,1,0,0,0,1
11503864,0,0,0,1,1
11501956,1,0,0,0,1
11494661,0,0,1,0,1
11491637,1,0,0,0,1
11555258,0,0,0,1,1
11555466,1,0,0,0,1
11559476,1,0,0,0,1
11559667,1,0,0,0,1
11628194,1,0,0,0,1
11614416,1,0,0,0,1
11607949,1,0,0,0,1
11607339,1,0,0,0,1
11606007,1,0,0,0,1
11603608,1,0,0,0,1
11599731,1,0,0,0,1
11599506,1,0,0,0,1
11589542,0,0,1,0,1
11586857,1,0,0,0,1
11585415,0,0,1,0,1
11583998,1,0,0,0,1
11581619,1,0,0,0,1
11577427,1,0,0,0,1
11576606,1,0,0,0,1
11576459,0,0,1,0,1
11573876,1,0,0,0,1
11569309,1,0,0,0,1
11560683,1,0,0,0,1
11486122,0,0,1,0,1
11477369,1,0,0,0,1
12101562,1,0,0,0,1
11371357,1,0,0,0,1
11395111,0,0,1,0,1
11389260,1,0,0,0,1
11387702,1,0,0,0,1
11386786,0,0,1,0,1
11386273,0,0,1,0,1
11381575,0,0,1,0,1
11376647,1,0,0,0,1
11376150,1,0,0,0,1
11375556,1,0,0,0,1
11363395,1,0,0,0,1
11469296,1,0,0,0,1
11363157,0,0,1,0,1
11360902,1,0,0,0,1
11360525,1,0,0,0,1
11359705,1,0,0,0,1
11358628,1,0,0,0,1
11358093,1,0,0,0,1
11342037,0,0,1,0,1
11338827,0,0,1,0,1
11333699,0,0,1,0,1
11395856,1,0,0,0,1
11397354,1,0,0,0,1
11402749,1,0,0,0,1
11402865,1,0,0,0,1
11462251,0,0,1,0,1
11460541,1,0,0,0,1
11460365,0,0,1,0,1
11458977,1,0,0,0,1
11457159,1,0,0,0,1
11455361,0,0,1,0,1
11452850,0,0,1,0,1
11452065,0,0,1,0,1
11449978,1,0,0,0,1
11443640,1,0,0,0,1
11430909,1,0,0,0,1
11430355,1,0,0,0,1
11428056,0,0,1,0,1
11427289,0,0,1,0,1
11421002,0,0,1,0,1
11418277,1,0,0,0,1
11409310,0,0,1,0,1
11406067,1,0,0,0,1
11403173,0,0,1,0,1
11638358,1,0,0,0,1
11639562,1,0,0,0,1
11651884,1,0,0,0,1
11910319,0,0,1,0,1
11946229,1,0,0,0,1
11941241,1,0,0,0,1
11940121,1,0,0,0,1
11939794,0,0,1,0,1
11930874,0,0,1,0,1
11923041,1,0,0,0,1
11918958,0,0,1,0,1
11917311,1,0,0,0,1
11911154,0,0,1,0,1
11907194,0,0,1,0,1
11658596,1,0,0,0,1
11904916,1,0,0,0,1
11902072,1,0,0,0,1
11894522,1,0,0,0,1
11885649,1,0,0,0,1
11884239,1,0,0,0,1
11882768,1,0,0,0,1
11881734,0,0,1,0,1
11870917,1,0,0,0,1
11869986,1,0,0,0,1
11947308,0,0,1,0,1
11951550,1,0,0,0,1
11962385,1,0,0,0,1
11968309,1,0,0,0,1
12099193,1,0,0,0,1
12092726,1,0,0,0,1
12091973,0,0,1,0,1
12087651,0,0,1,0,1
12082653,1,0,0,0,1
12062317,0,0,1,0,1
12058024,1,0,0,0,1
12038925,1,0,0,0,1
12033348,0,0,1,0,1
12032765,0,0,1,0,1
12027050,0,0,1,0,1
12012671,0,0,1,0,1
12010675,1,0,0,0,1
12009770,1,0,0,0,1
12004780,1,0,0,0,1
12001318,0,0,1,0,1
11979072,1,0,0,0,1
11976770,0,0,1,0,1
11968663,1,0,0,0,1
11855341,1,0,0,0,1
11855185,1,0,0,0,1
11847492,0,0,1,0,1
11742675,1,0,0,0,1
11741577,1,0,0,0,1
11740479,1,0,0,0,1
11731168,0,0,1,0,1
11729215,1,0,0,0,1
11722972,1,0,0,0,1
11708293,1,0,0,0,1
11704017,1,0,0,0,1
11702175,1,0,0,0,1
11699652,1,0,0,0,1
11697746,1,0,0,0,1
11696537,0,0,1,0,1
11687702,1,0,0,0,1
11686822,0,0,1,0,1
11686214,1,0,0,0,1
11675441,1,0,0,0,1
11673798,0,0,1,0,1
11671329,0,0,1,0,1
11670463,1,0,0,0,1
11669123,1,0,0,0,1
11742138,1,0,0,0,1
11742895,1,0,0,0,1
11841497,0,0,1,0,1
11743513,0,0,1,0,1
11829141,1,0,0,0,1
11827970,1,0,0,0,1
11826802,1,0,0,0,1
11818785,0,0,1,0,1
11812868,1,0,0,0,1
11811612,1,0,0,0,1
11798551,1,0,0,0,1
11798436,1,0,0,0,1
11789134,1,0,0,0,1
11787695,1,0,0,0,1
11787449,0,0,1,0,1
11775328,1,0,0,0,1
11774785,1,0,0,0,1
11774035,1,0,0,0,1
11767770,1,0,0,0,1
11764444,1,0,0,0,1
11764237,1,0,0,0,1
11758216,1,0,0,0,1
11755545,0,0,1,0,1
10153970,1,0,0,0,1
10137323,0,0,1,0,1
7645338,0,0,1,0,1
8375500,0,0,1,0,1
8442593,0,0,1,0,1
8439929,1,0,0,0,1
8435480,1,0,0,0,1
8434244,0,0,1,0,1
8425251,1,0,0,0,1
8416362,1,0,0,0,1
8409547,1,0,0,0,1
8389062,1,0,0,0,1
8387315,1,0,0,0,1
8366847,0,0,1,0,1
8330049,1,0,0,0,1
8363605,1,0,0,0,1
8360989,0,0,1,0,1
8358654,0,0,1,0,1
8349905,1,0,0,0,1
8349334,1,0,0,0,1
8345393,1,0,0,0,1
8343772,0,0,1,0,1
8335875,1,0,0,0,1
8333776,1,0,0,0,1
8454981,1,0,0,0,1
8483704,1,0,0,0,1
8490286,1,0,0,0,1
8497788,1,0,0,0,1
8548453,1,0,0,0,1
8546088,0,0,1,0,1
8539684,1,0,0,0,1
8539550,0,0,1,0,1
8535372,1,0,0,0,1
8534610,0,0,1,0,1
8533891,1,0,0,0,1
8533032,1,0,0,0,1
8531067,1,0,0,0,1
8526279,1,0,0,0,1
8524356,0,0,1,0,1
8518298,0,0,1,0,1
8518291,0,0,1,0,1
8511553,1,0,0,0,1
8502743,0,0,1,0,1
8502406,1,0,0,0,1
8501698,1,0,0,0,1
8500680,0,0,1,0,1
8499760,1,0,0,0,1
8331436,0,0,1,0,1
8328948,1,0,0,0,1
8556751,0,0,1,0,1
8245913,1,0,0,0,1
8255401,1,0,0,0,1
8255208,1,0,0,0,1
8255157,0,0,0,1,1
8255021,1,0,0,0,1
8254006,1,0,0,0,1
8252663,1,0,0,0,1
8252253,1,0,0,0,1
8250822,1,0,0,0,1
8246221,1,0,0,0,1
8243469,0,0,1,0,1
8325079,1,0,0,0,1
8243103,1,0,0,0,1
8242397,1,0,0,0,1
8222437,1,0,0,0,1
8219931,1,0,0,0,1
8214568,1,0,0,0,1
8212880,0,0,1,0,1
8202815,1,0,0,0,1
8201520,0,0,1,0,1
8200984,1,0,0,0,1
8258991,0,0,1,0,1
8260004,1,0,0,0,1
8260418,0,0,1,0,1
8261145,1,0,0,0,1
8313953,1,0,0,0,1
8309054,0,0,1,0,1
8306638,1,0,0,0,1
8304751,1,0,0,0,1
8304377,1,0,0,0,1
8302904,0,0,1,0,1
8301763,1,0,0,0,1
8293900,1,0,0,0,1
8292927,1,0,0,0,1
8287316,0,0,1,0,1
8281195,1,0,0,0,1
8280182,0,0,1,0,1
8276592,0,0,1,0,1
8276361,1,0,0,0,1
8275765,1,0,0,0,1
8273903,1,0,0,0,1
8263074,1,0,0,0,1
8262339,1,0,0,0,1
8261208,0,0,1,0,1
8554637,0,0,1,0,1
8558145,1,0,0,0,1
10135159,1,0,0,0,1
8811222,1,0,0,0,1
8834412,0,0,1,0,1
8833885,1,0,0,0,1
8830191,1,0,0,0,1
8822946,1,0,0,0,1
8822845,1,0,0,0,1
8821936,0,0,1,0,1
8818855,1,0,0,0,1
8815907,1,0,0,0,1
8813443,1,0,0,0,1
8800532,1,0,0,0,1
8758237,1,0,0,0,1
8797392,1,0,0,0,1
8796895,1,0,0,0,1
8793489,0,0,1,0,1
8784903,1,0,0,0,1
8780729,1,0,0,0,1
8778997,1,0,0,0,1
8778189,1,0,0,0,1
8772693,1,0,0,0,1
8769461,1,0,0,0,1
8835180,1,0,0,0,1
8835932,1,0,0,0,1
8837750,1,0,0,0,1
8838470,1,0,0,0,1
8903368,0,0,1,0,1
8902883,1,0,0,0,1
8898944,1,0,0,0,1
8896831,0,0,1,0,1
8896489,1,0,0,0,1
8885753,0,0,1,0,1
8881924,1,0,0,0,1
8881505,0,0,1,0,1
8877881,1,0,0,0,1
8876603,1,0,0,0,1
8871907,1,0,0,0,1
8862886,1,0,0,0,1
8859950,0,0,1,0,1
8857791,0,0,1,0,1
8855004,0,0,1,0,1
8853277,1,0,0,0,1
8852945,0,0,1,0,1
8851665,1,0,0,0,1
8844412,1,0,0,0,1
8762765,1,0,0,0,1
8756821,1,0,0,0,1
8563244,1,0,0,0,1
8627814,1,0,0,0,1
8671974,0,0,1,0,1
8671253,0,0,1,0,1
8663057,1,0,0,0,1
8662157,1,0,0,0,1
8661571,1,0,0,0,1
8656650,0,0,1,0,1
8654456,1,0,0,0,1
8653725,1,0,0,0,1
8649457,1,0,0,0,1
8624212,1,0,0,0,1
8751800,1,0,0,0,1
8619985,1,0,0,0,1
8610441,1,0,0,0,1
8576020,0,0,1,0,1
8575784,1,0,0,0,1
8573805,0,0,1,0,1
8571056,1,0,0,0,1
8568891,1,0,0,0,1
8565572,1,0,0,0,1
8563684,1,0,0,0,1
8672281,1,0,0,0,1
8680097,1,0,0,0,1
8684081,1,0,0,0,1
8685072,1,0,0,0,1
8748976,0,0,1,0,1
8741682,0,0,1,0,1
8732038,0,0,1,0,1
8731758,1,0,0,0,1
8730700,1,0,0,0,1
8730513,0,0,1,0,1
8726365,1,0,0,0,1
8716709,1,0,0,0,1
8715723,0,0,1,0,1
8712859,1,0,0,0,1
8712217,1,0,0,0,1
8711250,1,0,0,0,1
8708720,1,0,0,0,1
8704042,1,0,0,0,1
8693741,0,0,1,0,1
8692598,0,0,1,0,1
8687478,1,0,0,0,1
8686752,1,0,0,0,1
8686625,1,0,0,0,1
8200795,1,0,0,0,1
8199671,1,0,0,0,1
8198553,0,0,1,0,1
7833913,0,0,1,0,1
7853503,1,0,0,0,1
7849770,1,0,0,0,1
7849109,1,0,0,0,1
7849107,0,0,1,0,1
7848317,0,0,1,0,1
7835116,0,0,1,0,1
7834371,1,0,0,0,1
7834073,1,0,0,0,1
7833929,0,0,1,0,1
7822683,0,0,1,0,1
7780030,1,0,0,0,1
7815949,1,0,0,0,1
7814786,0,0,1,0,1
7810471,1,0,0,0,1
7809712,1,0,0,0,1
7809661,1,0,0,0,1
7806471,0,0,1,0,1
7805184,1,0,0,0,1
7797973,1,0,0,0,1
7793849,1,0,0,0,1
7853680,1,0,0,0,1
7857773,1,0,0,0,1
7858405,1,0,0,0,1
7860852,1,0,0,0,1
7917224,0,0,1,0,1
7915676,0,0,1,0,1
7912845,0,0,1,0,1
7911103,1,0,0,0,1
7898626,0,0,1,0,1
7897952,1,0,0,0,1
7897301,1,0,0,0,1
7896605,0,0,1,0,1
7895505,1,0,0,0,1
7894614,1,0,0,0,1
7883985,0,0,1,0,1
7881946,1,0,0,0,1
7877557,0,0,1,0,1
7877504,1,0,0,0,1
7877288,1,0,0,0,1
7876900,0,0,1,0,1
7875127,0,0,1,0,1
7863991,1,0,0,0,1
7861502,1,0,0,0,1
7784696,1,0,0,0,1
7779204,1,0,0,0,1
8190806,1,0,0,0,1
7660014,1,0,0,0,1
7694993,1,0,0,0,1
7692618,1,0,0,0,1
7691955,0,0,1,0,1
7689009,1,0,0,0,1
7683847,1,0,0,0,1
7679928,1,0,0,0,1
7678203,0,0,1,0,1
7675569,0,0,1,0,1
7663501,1,0,0,0,1
7658934,1,0,0,0,1
7777902,1,0,0,0,1
7658427,1,0,0,0,1
7658123,0,0,1,0,1
7656338,0,0,1,0,1
7655962,1,0,0,0,1
7654837,1,0,0,0,1
7654246,0,0,1,0,1
7653249,0,0,1,0,1
7651028,1,0,0,0,1
7650212,1,0,0,0,1
7695223,0,0,1,0,1
7700456,1,0,0,0,1
7701992,1,0,0,0,1
7702854,1,0,0,0,1
7776144,1,0,0,0,1
7775937,1,0,0,0,1
7775447,1,0,0,0,1
7763913,0,0,1,0,1
7761429,1,0,0,0,1
7759020,1,0,0,0,1
7755411,1,0,0,0,1
7755092,0,0,1,0,1
7754646,1,0,0,0,1
7748180,1,0,0,0,1
7740184,1,0,0,0,1
7738881,1,0,0,0,1
7737249,1,0,0,0,1
7735666,1,0,0,0,1
7722968,0,0,1,0,1
7720086,1,0,0,0,1
7716888,1,0,0,0,1
7710878,1,0,0,0,1
7709305,1,0,0,0,1
7919277,0,0,1,0,1
7921167,0,0,1,0,1
7942072,1,0,0,0,1
8109174,1,0,0,0,1
8131878,1,0,0,0,1
8129088,0,0,1,0,1
8127120,1,0,0,0,1
8120180,0,0,1,0,1
8120005,1,0,0,0,1
8119681,1,0,0,0,1
8118080,0,0,1,0,1
8113117,0,0,1,0,1
8110430,1,0,0,0,1
8106327,0,0,1,0,1
7951613,1,0,0,0,1
8102595,1,0,0,0,1
8095903,1,0,0,0,1
8094859,1,0,0,0,1
8093077,1,0,0,0,1
8092818,1,0,0,0,1
8092286,1,0,0,0,1
8089285,1,0,0,0,1
8083568,0,0,1,0,1
8083094,1,0,0,0,1
8132596,1,0,0,0,1
8138665,0,0,1,0,1
8140066,1,0,0,0,1
8140134,0,0,1,0,1
8190381,1,0,0,0,1
8189649,0,0,1,0,1
8187215,1,0,0,0,1
8185223,0,0,1,0,1
8180517,1,0,0,0,1
8179150,0,0,1,0,1
8178950,1,0,0,0,1
8177511,0,0,1,0,1
8167735,1,0,0,0,1
8167593,1,0,0,0,1
8167445,0,0,1,0,1
8164199,1,0,0,0,1
8163438,0,0,1,0,1
8163133,1,0,0,0,1
8158276,1,0,0,0,1
8145820,0,0,1,0,1
8144643,1,0,0,0,1
8144242,1,0,0,0,1
8143711,0,0,1,0,1
8078460,1,0,0,0,1
8067740,1,0,0,0,1
8066318,1,0,0,0,1
7990635,0,0,1,0,1
7988328,1,0,0,0,1
7982432,0,0,1,0,1
7980049,1,0,0,0,1
7978448,1,0,0,0,1
7978169,0,0,1,0,1
7976263,0,0,1,0,1
7970340,0,0,1,0,1
7969836,1,0,0,0,1
7969715,1,0,0,0,1
7964926,1,0,0,0,1
7963317,0,0,1,0,1
7963238,0,0,1,0,1
7959444,1,0,0,0,1
7958923,1,0,0,0,1
7956889,1,0,0,0,1
7956821,1,0,0,0,1
7955696,1,0,0,0,1
7955289,0,0,1,0,1
7952263,1,0,0,0,1
7988793,0,0,1,0,1
7990995,0,0,1,0,1
8063576,1,0,0,0,1
7991797,1,0,0,0,1
8050082,1,0,0,0,1
8049757,1,0,0,0,1
8049682,0,0,1,0,1
8049219,1,0,0,0,1
8048803,1,0,0,0,1
8048355,0,0,1,0,1
8041720,1,0,0,0,1
8040003,1,0,0,0,1
8037917,1,0,0,0,1
8033291,1,0,0,0,1
8032842,1,0,0,0,1
8031366,1,0,0,0,1
8028752,1,0,0,0,1
8026393,0,0,1,0,1
8015397,1,0,0,0,1
8012008,1,0,0,0,1
8011670,1,0,0,0,1
8002158,0,0,1,0,1
7992346,1,0,0,0,1
8910286,1,0,0,0,1
8916358,0,0,1,0,1
8917825,1,0,0,0,1
9746153,1,0,0,0,1
9784206,0,0,1,0,1
9784153,0,0,1,0,1
9774018,1,0,0,0,1
9773128,1,0,0,0,1
9769764,0,0,1,0,1
9767363,0,0,1,0,1
9757948,1,0,0,0,1
9756051,1,0,0,0,1
9750462,1,0,0,0,1
9742120,1,0,0,0,1
9708374,1,0,0,0,1
9742010,0,0,1,0,1
9737900,1,0,0,0,1
9737872,1,0,0,0,1
9727867,1,0,0,0,1
9727832,1,0,0,0,1
9727058,1,0,0,0,1
9726872,0,0,0,1,1
9721574,1,0,0,0,1
9709235,1,0,0,0,1
9787502,1,0,0,0,1
9787825,1,0,0,0,1
9787976,1,0,0,0,1
9791461,1,0,0,0,1
9856492,1,0,0,0,1
9856328,0,0,1,0,1
9852787,1,0,0,0,1
9850389,1,0,0,0,1
9847270,1,0,0,0,1
9846972,0,0,1,0,1
9840180,1,0,0,0,1
9837129,0,0,1,0,1
9836692,1,0,0,0,1
9832158,0,0,1,0,1
9831559,1,0,0,0,1
9828418,0,0,1,0,1
9818387,0,0,1,0,1
9817255,1,0,0,0,1
9816503,1,0,0,0,1
9815198,1,0,0,0,1
9813350,1,0,0,0,1
9813233,1,0,0,0,1
9808458,0,0,1,0,1
9708443,0,0,1,0,1
9704072,0,0,1,0,1
9535767,0,0,1,0,1
9582999,1,0,0,0,1
9613050,1,0,0,0,1
9612349,0,0,1,0,1
9610339,1,0,0,0,1
9606640,1,0,0,0,1
9604972,1,0,0,0,1
9601461,1,0,0,0,1
9598750,1,0,0,0,1
9598256,1,0,0,0,1
9583320,1,0,0,0,1
9582456,1,0,0,0,1
9703336,1,0,0,0,1
9581668,0,0,1,0,1
9572607,1,0,0,0,1
9563496,0,0,1,0,1
9560240,0,0,1,0,1
9558820,1,0,0,0,1
9554965,0,0,1,0,1
9550049,1,0,0,0,1
9543143,1,0,0,0,1
9539170,0,0,1,0,1
9613595,1,0,0,0,1
9614389,1,0,0,0,1
9620852,1,0,0,0,1
9623701,1,0,0,0,1
9700935,1,0,0,0,1
9694856,1,0,0,0,1
9685977,1,0,0,0,1
9683962,0,0,1,0,1
9679974,1,0,0,0,1
9670774,0,0,1,0,1
9664520,1,0,0,0,1
9662924,0,0,1,0,1
9662608,1,0,0,0,1
9659504,1,0,0,0,1
9653082,0,0,1,0,1
9650172,1,0,0,0,1
9646150,0,0,1,0,1
9644281,1,0,0,0,1
9640446,0,0,0,1,1
9637585,1,0,0,0,1
9632197,0,0,1,0,1
9631746,1,0,0,0,1
9630921,1,0,0,0,1
9856784,1,0,0,0,1
9859148,1,0,0,0,1
9862206,0,0,1,0,1
10024006,0,0,1,0,1
10052540,1,0,0,0,1
10051267,1,0,0,0,1
10043726,1,0,0,0,1
10041857,0,0,1,0,1
10040649,1,0,0,0,1
10039614,1,0,0,0,1
10032016,1,0,0,0,1
10028635,0,0,1,0,1
10025306,1,0,0,0,1
10018530,0,0,1,0,1
9870519,1,0,0,0,1
10018391,1,0,0,0,1
10017420,1,0,0,0,1
10015933,0,0,1,0,1
10015683,1,0,0,0,1
10014644,0,0,1,0,1
10013093,0,0,1,0,1
10012271,1,0,0,0,1
10009047,0,0,1,0,1
10008086,1,0,0,0,1
10052561,1,0,0,0,1
10057035,1,0,0,0,1
10071119,0,0,1,0,1
10071397,1,0,0,0,1
10135094,1,0,0,0,1
10133373,0,0,1,0,1
10131727,1,0,0,0,1
10128779,1,0,0,0,1
10125456,1,0,0,0,1
10123226,0,0,1,0,1
10113487,1,0,0,0,1
10106994,1,0,0,0,1
10103520,1,0,0,0,1
10098825,0,0,1,0,1
10094431,0,0,1,0,1
10087976,0,0,1,0,1
10087006,1,0,0,0,1
10085003,0,0,0,1,1
10082935,1,0,0,0,1
10077970,0,0,1,0,1
10076276,1,0,0,0,1
10074473,0,0,1,0,1
10072710,1,0,0,0,1
10003254,0,0,1,0,1
10001551,0,0,1,0,1
9997747,1,0,0,0,1
9943097,0,0,1,0,1
9941315,1,0,0,0,1
9932811,1,0,0,0,1
9930918,0,0,1,0,1
9928808,1,0,0,0,1
9928037,1,0,0,0,1
9921108,1,0,0,0,1
9909635,0,0,1,0,1
9909455,1,0,0,0,1
9904977,1,0,0,0,1
9904775,1,0,0,0,1
9893040,1,0,0,0,1
9892520,1,0,0,0,1
9881214,1,0,0,0,1
9878956,1,0,0,0,1
9876064,1,0,0,0,1
9872650,1,0,0,0,1
9871799,0,0,1,0,1
9870919,0,0,1,0,1
9870528,1,0,0,0,1
9941923,0,0,1,0,1
9944244,0,0,1,0,1
9995094,1,0,0,0,1
9945748,1,0,0,0,1
9994745,1,0,0,0,1
9991763,1,0,0,0,1
9991314,1,0,0,0,1
9991075,1,0,0,0,1
9977688,0,0,1,0,1
9975046,0,0,1,0,1
9974520,0,0,1,0,1
9973574,1,0,0,0,1
9963151,1,0,0,0,1
9959323,1,0,0,0,1
9957946,1,0,0,0,1
9953808,0,0,1,0,1
9950152,1,0,0,0,1
9949214,1,0,0,0,1
9948798,1,0,0,0,1
9947332,0,0,1,0,1
9946550,1,0,0,0,1
9946315,1,0,0,0,1
9946160,1,0,0,0,1
9538192,1,0,0,0,1
9525999,1,0,0,0,1
8918030,0,0,1,0,1
9132087,1,0,0,0,1
9160985,1,0,0,0,1
9158874,1,0,0,0,1
9152003,1,0,0,0,1
9148721,0,0,1,0,1
9147223,0,0,1,0,1
9144345,1,0,0,0,1
9143200,1,0,0,0,1
9138141,1,0,0,0,1
9132107,1,0,0,0,1
9123948,0,0,1,0,1
9081271,1,0,0,0,1
9121644,0,0,1,0,1
9119676,1,0,0,0,1
9117590,0,0,1,0,1
9113022,0,0,1,0,1
9109049,1,0,0,0,1
9107715,1,0,0,0,1
9105586,1,0,0,0,1
9098653,1,0,0,0,1
9094952,1,0,0,0,1
9165860,0,0,1,0,1
9169717,0,0,1,0,1
9171271,0,0,1,0,1
9173924,1,0,0,0,1
9219155,0,0,1,0,1
9217610,1,0,0,0,1
9216472,1,0,0,0,1
9214999,1,0,0,0,1
9212686,0,0,1,0,1
9212402,1,0,0,0,1
9207152,1,0,0,0,1
9203654,1,0,0,0,1
9201921,1,0,0,0,1
9197647,1,0,0,0,1
9197440,1,0,0,0,1
9197353,1,0,0,0,1
9196903,0,0,1,0,1
9195264,1,0,0,0,1
9193762,0,0,1,0,1
9192860,0,0,1,0,1
9177920,1,0,0,0,1
9176756,1,0,0,0,1
9175058,0,0,1,0,1
9089934,0,0,1,0,1
9080288,1,0,0,0,1
9523962,1,0,0,0,1
8960577,1,0,0,0,1
8990438,1,0,0,0,1
8989844,0,0,1,0,1
8986314,0,0,1,0,1
8978839,1,0,0,0,1
8978169,0,0,1,0,1
8977237,0,0,1,0,1
8973065,0,0,1,0,1
8968224,0,0,1,0,1
8960858,1,0,0,0,1
8956323,1,0,0,0,1
9073820,0,0,1,0,1
8952737,0,0,1,0,1
8946948,0,0,1,0,1
8943770,1,0,0,0,1
8942638,0,0,1,0,1
8936313,1,0,0,0,1
8934751,1,0,0,0,1
8924899,0,0,1,0,1
8923129,1,0,0,0,1
8920465,1,0,0,0,1
8992812,1,0,0,0,1
8993896,1,0,0,0,1
8996336,0,0,1,0,1
9007512,1,0,0,0,1
9068084,1,0,0,0,1
9061159,1,0,0,0,1
9060287,1,0,0,0,1
9060143,1,0,0,0,1
9055412,0,0,1,0,1
9054750,1,0,0,0,1
9053876,1,0,0,0,1
9053036,1,0,0,0,1
9050420,0,0,1,0,1
9047774,1,0,0,0,1
9045252,1,0,0,0,1
9041334,1,0,0,0,1
9040879,1,0,0,0,1
9038714,1,0,0,0,1
9030221,1,0,0,0,1
9020266,1,0,0,0,1
9018136,0,0,1,0,1
9013390,0,0,1,0,1
9010960,0,0,1,0,1
9224914,1,0,0,0,1
9226441,1,0,0,0,1
9229424,1,0,0,0,1
9408841,1,0,0,0,1
9442045,1,0,0,0,1
9440328,1,0,0,0,1
9428817,1,0,0,0,1
9428025,1,0,0,0,1
9427915,1,0,0,0,1
9427555,0,0,1,0,1
9427289,1,0,0,0,1
9423379,1,0,0,0,1
9421493,0,0,1,0,1
9407785,1,0,0,0,1
9232428,1,0,0,0,1
9405848,1,0,0,0,1
9403624,1,0,0,0,1
9389685,1,0,0,0,1
9388460,1,0,0,0,1
9383056,0,0,1,0,1
9381867,1,0,0,0,1
9374496,1,0,0,0,1
9371210,1,0,0,0,1
9369977,0,0,1,0,1
9443112,1,0,0,0,1
9443343,1,0,0,0,1
9446761,0,0,1,0,1
9450203,0,0,1,0,1
9522851,1,0,0,0,1
9520651,0,0,1,0,1
9518420,1,0,0,0,1
9511935,0,0,0,1,1
9509125,0,0,1,0,1
9507017,0,0,1,0,1
9505527,1,0,0,0,1
9504403,1,0,0,0,1
9503874,1,0,0,0,1
9493977,0,0,1,0,1
9486005,1,0,0,0,1
9484127,1,0,0,0,1
9482236,0,0,1,0,1
9481706,1,0,0,0,1
9478555,0,0,1,0,1
9471525,1,0,0,0,1
9470468,1,0,0,0,1
9460898,1,0,0,0,1
9450412,1,0,0,0,1
9368118,1,0,0,0,1
9367785,0,0,1,0,1
9364330,0,0,1,0,1
9295169,0,0,1,0,1
9290968,1,0,0,0,1
9280524,1,0,0,0,1
9280078,1,0,0,0,1
9273561,1,0,0,0,1
9270927,1,0,0,0,1
9269794,0,0,1,0,1
9268156,0,0,1,0,1
9263105,0,0,1,0,1
9262949,1,0,0,0,1
9262409,0,0,1,0,1
9251010,1,0,0,0,1
9250609,0,0,1,0,1
9249156,0,0,1,0,1
9247072,0,0,1,0,1
9246334,1,0,0,0,1
9243105,1,0,0,0,1
9240896,1,0,0,0,1
9238069,1,0,0,0,1
9236677,0,0,1,0,1
9293512,0,0,1,0,1
9295237,1,0,0,0,1
9358748,1,0,0,0,1
9307590,0,0,1,0,1
9358396,1,0,0,0,1
9358058,1,0,0,0,1
9352563,1,0,0,0,1
9352452,1,0,0,0,1
9350960,1,0,0,0,1
9348961,1,0,0,0,1
9340324,0,0,1,0,1
9340104,1,0,0,0,1
9339818,1,0,0,0,1
9331695,1,0,0,0,1
9329143,1,0,0,0,1
9329037,0,0,1,0,1
9328891,0,0,1,0,1
9326099,1,0,0,0,1
9320996,1,0,0,0,1
9317567,1,0,0,0,1
9316328,0,0,1,0,1
9314442,1,0,0,0,1
9311147,0,0,1,0,1
4169722,1,0,0,0,1
4166175,1,0,0,0,1
12995701,1,0,0,0,1
941998,1,0,0,0,1
948064,0,0,1,0,1
947248,1,0,0,0,1
946323,1,0,0,0,1
945996,0,0,1,0,1
945880,1,0,0,0,1
945837,1,0,0,0,1
945407,1,0,0,0,1
943095,1,0,0,0,1
942933,1,0,0,0,1
940724,0,0,1,0,1
918668,0,0,1,0,1
936258,1,0,0,0,1
933378,0,0,0,1,1
932830,0,0,1,0,1
928165,0,0,1,0,1
925153,1,0,0,0,1
923791,0,0,1,0,1
922922,1,0,0,0,1
922478,1,0,0,0,1
922056,0,0,1,0,1
948164,0,0,1,0,1
949221,0,0,1,0,1
950041,1,0,0,0,1
950232,1,0,0,0,1
977716,1,0,0,0,1
975030,1,0,0,0,1
973036,0,0,1,0,1
970540,1,0,0,0,1
968805,0,0,1,0,1
966806,1,0,0,0,1
965976,0,0,0,1,1
965946,1,0,0,0,1
965061,0,0,1,0,1
964882,1,0,0,0,1
961809,1,0,0,0,1
959931,1,0,0,0,1
956848,1,0,0,0,1
956383,0,0,1,0,1
953913,1,0,0,0,1
953375,1,0,0,0,1
952909,1,0,0,0,1
951917,1,0,0,0,1
950826,1,0,0,0,1
920237,0,0,1,0,1
915640,1,0,0,0,1
980101,1,0,0,0,1
875439,1,0,0,0,1
881301,1,0,0,0,1
881214,0,0,1,0,1
880975,1,0,0,0,1
880323,0,0,1,0,1
879265,1,0,0,0,1
878546,0,0,1,0,1
877697,1,0,0,0,1
877452,0,0,1,0,1
875830,1,0,0,0,1
874471,1,0,0,0,1
915031,1,0,0,0,1
874355,1,0,0,0,1
872654,0,0,1,0,1
872527,1,0,0,0,1
870242,1,0,0,0,1
869794,1,0,0,0,1
868804,1,0,0,0,1
865580,1,0,0,0,1
865264,1,0,0,0,1
865148,0,0,1,0,1
881578,1,0,0,0,1
886646,1,0,0,0,1
886705,1,0,0,0,1
890425,1,0,0,0,1
912541,0,0,1,0,1
912400,0,0,1,0,1
910884,0,0,1,0,1
910677,1,0,0,0,1
910592,1,0,0,0,1
909710,0,0,1,0,1
909234,1,0,0,0,1
908906,0,0,1,0,1
908514,1,0,0,0,1
906295,1,0,0,0,1
904893,1,0,0,0,1
904833,1,0,0,0,1
900186,0,0,1,0,1
900154,1,0,0,0,1
900055,1,0,0,0,1
899579,1,0,0,0,1
898412,1,0,0,0,1
897723,1,0,0,0,1
892811,1,0,0,0,1
979144,1,0,0,0,1
983223,0,1,0,0,1
643512,1,0,0,0,1
1121064,1,0,0,0,1
1137008,1,0,0,0,1
1136724,0,0,1,0,1
1136532,1,0,0,0,1
1132121,1,0,0,0,1
1132004,1,0,0,0,1
1131394,1,0,0,0,1
1129218,0,0,1,0,1
1123923,0,0,1,0,1
1121193,1,0,0,0,1
1119998,1,0,0,0,1
1106731,1,0,0,0,1
1119739,1,0,0,0,1
1119209,1,0,0,0,1
1119058,1,0,0,0,1
1115741,1,0,0,0,1
1115260,1,0,0,0,1
1115218,1,0,0,0,1
1110208,1,0,0,0,1
1109658,1,0,0,0,1
1109143,0,0,1,0,1
1137079,0,0,1,0,1
1139222,1,0,0,0,1
1139574,0,0,1,0,1
1142835,1,0,0,0,1
1177128,0,0,1,0,1
1175504,1,0,0,0,1
1174963,1,0,0,0,1
1171812,1,0,0,0,1
1171707,0,0,1,0,1
1171704,0,0,1,0,1
1168704,1,0,0,0,1
1165231,0,0,1,0,1
1164642,1,0,0,0,1
1164568,1,0,0,0,1
1158300,1,0,0,0,1
1157620,1,0,0,0,1
1157105,1,0,0,0,1
1157099,1,0,0,0,1
1153993,1,0,0,0,1
1149785,1,0,0,0,1
1149419,1,0,0,0,1
1146744,0,0,1,0,1
1143620,1,0,0,0,1
1107305,1,0,0,0,1
1106098,1,0,0,0,1
985635,0,0,1,0,1
1001819,1,0,0,0,1
1014639,1,0,0,0,1
1014484,1,0,0,0,1
1012895,0,0,1,0,1
1012691,1,0,0,0,1
1010743,1,0,0,0,1
1010344,1,0,0,0,1
1010338,1,0,0,0,1
1010242,1,0,0,0,1
1003394,0,0,1,0,1
1000477,1,0,0,0,1
1104548,1,0,0,0,1
1000278,1,0,0,0,1
997892,1,0,0,0,1
997540,1,0,0,0,1
997334,1,0,0,0,1
988788,0,0,1,0,1
988350,1,0,0,0,1
988260,1,0,0,0,1
988069,1,0,0,0,1
985846,1,0,0,0,1
1014883,1,0,0,0,1
1017231,1,0,0,0,1
1017473,1,0,0,0,1
1020357,1,0,0,0,1
1103252,0,0,1,0,1
1100494,0,0,1,0,1
1098902,1,0,0,0,1
1096771,1,0,0,0,1
1096084,1,0,0,0,1
1093167,1,0,0,0,1
1092805,1,0,0,0,1
1092203,1,0,0,0,1
1038645,0,0,1,0,1
1035102,0,0,1,0,1
1033792,1,0,0,0,1
1031148,0,0,1,0,1
1030491,1,0,0,0,1
1028541,1,0,0,0,1
1024355,1,0,0,0,1
1023985,0,0,1,0,1
1021834,1,0,0,0,1
1021134,0,0,1,0,1
1021060,1,0,0,0,1
864766,1,0,0,0,1
864370,1,0,0,0,1
858318,1,0,0,0,1
716064,1,0,0,0,1
727084,1,0,0,0,1
726333,1,0,0,0,1
725286,1,0,0,0,1
724978,0,0,1,0,1
722320,1,0,0,0,1
722242,1,0,0,0,1
720558,1,0,0,0,1
720320,1,0,0,0,1
718630,1,0,0,0,1
715807,1,0,0,0,1
702103,0,0,1,0,1
713764,0,0,1,0,1
712992,1,0,0,0,1
710916,1,0,0,0,1
710782,1,0,0,0,1
709939,0,0,1,0,1
709334,1,0,0,0,1
707534,1,0,0,0,1
705450,1,0,0,0,1
704963,1,0,0,0,1
727114,0,0,1,0,1
729279,1,0,0,0,1
731582,0,0,1,0,1
731855,1,0,0,0,1
746415,1,0,0,0,1
745186,1,0,0,0,1
743742,1,0,0,0,1
743716,1,0,0,0,1
743321,1,0,0,0,1
742729,1,0,0,0,1
740812,1,0,0,0,1
740756,1,0,0,0,1
740029,1,0,0,0,1
739592,0,0,1,0,1
739499,0,0,1,0,1
737845,1,0,0,0,1
737515,1,0,0,0,1
736652,1,0,0,0,1
735786,0,0,1,0,1
733543,1,0,0,0,1
733370,0,0,1,0,1
733286,1,0,0,0,1
732535,1,0,0,0,1
703023,1,0,0,0,1
700913,1,0,0,0,1
857599,1,0,0,0,1
658618,1,0,0,0,1
666424,1,0,0,0,1
666271,0,0,1,0,1
665591,1,0,0,0,1
664670,1,0,0,0,1
663879,1,0,0,0,1
663517,1,0,0,0,1
663384,1,0,0,0,1
662225,1,0,0,0,1
660723,1,0,0,0,1
656798,1,0,0,0,1
699759,1,0,0,0,1
655956,1,0,0,0,1
655450,1,0,0,0,1
653405,0,0,1,0,1
652842,1,0,0,0,1
652092,1,0,0,0,1
650282,1,0,0,0,1
647528,1,0,0,0,1
646729,1,0,0,0,1
645887,1,0,0,0,1
666862,1,0,0,0,1
667926,1,0,0,0,1
668564,1,0,0,0,1
675317,0,0,1,0,1
698449,0,0,1,0,1
697678,1,0,0,0,1
697560,1,0,0,0,1
696487,1,0,0,0,1
696141,0,0,1,0,1
694455,1,0,0,0,1
693815,0,0,1,0,1
689427,1,0,0,0,1
687062,0,0,1,0,1
686768,1,0,0,0,1
684398,1,0,0,0,1
683457,0,0,1,0,1
683387,1,0,0,0,1
683230,1,0,0,0,1
683027,1,0,0,0,1
680818,1,0,0,0,1
678205,1,0,0,0,1
676690,1,0,0,0,1
676499,1,0,0,0,1
746552,0,0,1,0,1
747671,1,0,0,0,1
749126,1,0,0,0,1
825856,1,0,0,0,1
835019,1,0,0,0,1
834185,1,0,0,0,1
832757,1,0,0,0,1
832244,1,0,0,0,1
831572,1,0,0,0,1
828682,1,0,0,0,1
827235,1,0,0,0,1
826493,0,0,1,0,1
826459,0,0,1,0,1
822839,0,0,1,0,1
754464,1,0,0,0,1
820649,1,0,0,0,1
820046,0,0,1,0,1
820010,0,0,1,0,1
819257,1,0,0,0,1
818753,0,0,1,0,1
817948,0,0,1,0,1
815741,1,0,0,0,1
815436,1,0,0,0,1
812814,1,0,0,0,1
835105,1,0,0,0,1
835110,1,0,0,0,1
835318,1,0,0,0,1
836353,1,0,0,0,1
855437,0,0,1,0,1
855089,0,0,1,0,1
853502,1,0,0,0,1
853118,0,0,1,0,1
850526,0,0,1,0,1
849492,0,0,1,0,1
849356,1,0,0,0,1
849248,1,0,0,0,1
844862,0,0,1,0,1
844442,0,0,1,0,1
844422,1,0,0,0,1
844318,1,0,0,0,1
844096,1,0,0,0,1
842156,1,0,0,0,1
842125,1,0,0,0,1
841179,1,0,0,0,1
839702,1,0,0,0,1
839679,1,0,0,0,1
838325,0,0,1,0,1
810266,1,0,0,0,1
808068,1,0,0,0,1
807340,1,0,0,0,1
782008,0,0,1,0,1
780958,0,0,1,0,1
780952,1,0,0,0,1
780477,1,0,0,0,1
778994,1,0,0,0,1
776645,1,0,0,0,1
776290,1,0,0,0,1
774484,1,0,0,0,1
768181,1,0,0,0,1
766920,1,0,0,0,1
764790,1,0,0,0,1
764093,0,0,1,0,1
763439,0,0,1,0,1
762872,0,0,1,0,1
758152,1,0,0,0,1
757995,1,0,0,0,1
757166,1,0,0,0,1
756577,1,0,0,0,1
755603,1,0,0,0,1
754675,0,0,1,0,1
781674,1,0,0,0,1
782801,1,0,0,0,1
806214,0,0,1,0,1
785940,1,0,0,0,1
806010,1,0,0,0,1
805843,1,0,0,0,1
805344,1,0,0,0,1
803468,1,0,0,0,1
802971,1,0,0,0,1
801176,1,0,0,0,1
800780,1,0,0,0,1
800223,0,0,1,0,1
799566,0,0,1,0,1
799082,0,0,1,0,1
798949,1,0,0,0,1
795640,1,0,0,0,1
795181,1,0,0,0,1
795109,1,0,0,0,1
794042,1,0,0,0,1
793225,1,0,0,0,1
792159,0,0,1,0,1
791287,1,0,0,0,1
786862,0,0,1,0,1
1177400,1,0,0,0,1
1177947,1,0,0,0,1
1179779,0,0,1,0,1
1454772,1,0,0,0,1
1467387,1,0,0,0,1
1465030,0,0,1,0,1
1461630,1,0,0,0,1
1461441,1,0,0,0,1
1459609,1,0,0,0,1
1459392,1,0,0,0,1
1459377,1,0,0,0,1
1459260,1,0,0,0,1
1457505,1,0,0,0,1
1453801,1,0,0,0,1
1442412,1,0,0,0,1
1452026,0,0,1,0,1
1451743,1,0,0,0,1
1450728,0,0,1,0,1
1449904,0,0,1,0,1
1449710,1,0,0,0,1
1446988,1,0,0,0,1
1445298,1,0,0,0,1
1445060,0,0,1,0,1
1444040,1,0,0,0,1
1467989,1,0,0,0,1
1468231,1,0,0,0,1
1468247,1,0,0,0,1
1468472,1,0,0,0,1
1489423,0,0,1,0,1
1488809,1,0,0,0,1
1486224,1,0,0,0,1
1486107,1,0,0,0,1
1485675,0,0,1,0,1
1485117,1,0,0,0,1
1484799,1,0,0,0,1
1483578,0,0,1,0,1
1483464,1,0,0,0,1
1479833,1,0,0,0,1
1479666,1,0,0,0,1
1477622,1,0,0,0,1
1476954,1,0,0,0,1
1474071,0,0,1,0,1
1473630,0,0,1,0,1
1472745,0,0,1,0,1
1469036,0,0,1,0,1
1468658,1,0,0,0,1
1468617,1,0,0,0,1
1443186,1,0,0,0,1
1442022,0,0,1,0,1
1397115,1,0,0,0,1
1407104,1,0,0,0,1
1415590,1,0,0,0,1
1415417,1,0,0,0,1
1414616,0,0,1,0,1
1413098,0,0,1,0,1
1412548,0,0,1,0,1
1410387,1,0,0,0,1
1409854,0,0,1,0,1
1408733,1,0,0,0,1
1407737,1,0,0,0,1
1406773,1,0,0,0,1
1440109,1,0,0,0,1
1406458,1,0,0,0,1
1405974,1,0,0,0,1
1403096,1,0,0,0,1
1402454,0,0,1,0,1
1401919,1,0,0,0,1
1401526,1,0,0,0,1
1400194,1,0,0,0,1
1399910,1,0,0,0,1
1397707,1,0,0,0,1
1417489,1,0,0,0,1
1417893,1,0,0,0,1
1418307,1,0,0,0,1
1418912,1,0,0,0,1
1439611,1,0,0,0,1
1439222,0,0,1,0,1
1437621,1,0,0,0,1
1436404,1,0,0,0,1
1434956,1,0,0,0,1
1434654,1,0,0,0,1
1434120,1,0,0,0,1
1427352,0,0,1,0,1
1424716,1,0,0,0,1
1424084,0,0,1,0,1
1423613,1,0,0,0,1
1423123,0,0,1,0,1
1423098,0,0,1,0,1
1423082,1,0,0,0,1
1422833,1,0,0,0,1
1421199,1,0,0,0,1
1421116,1,0,0,0,1
1420868,1,0,0,0,1
1420715,1,0,0,0,1
1489696,1,0,0,0,1
1491538,1,0,0,0,1
1491770,1,0,0,0,1
1545977,1,0,0,0,1
1563660,1,0,0,0,1
1563352,0,0,1,0,1
1558246,0,0,1,0,1
1558222,1,0,0,0,1
1556712,1,0,0,0,1
1550888,1,0,0,0,1
1547578,1,0,0,0,1
1546620,1,0,0,0,1
1546476,1,0,0,0,1
1544804,1,0,0,0,1
1492339,0,0,1,0,1
1543205,1,0,0,0,1
1542506,0,0,1,0,1
1540270,1,0,0,0,1
1539941,1,0,0,0,1
1538057,1,0,0,0,1
1538023,0,0,0,1,1
1537650,1,0,0,0,1
1537501,1,0,0,0,1
1535300,1,0,0,0,1
1565828,1,0,0,0,1
1565924,0,0,1,0,1
1566042,0,0,1,0,1
1566167,1,0,0,0,1
1597481,0,0,1,0,1
1596626,1,0,0,0,1
1594185,1,0,0,0,1
1594083,1,0,0,0,1
1593922,1,0,0,0,1
1587834,0,0,1,0,1
1587123,1,0,0,0,1
1586060,1,0,0,0,1
1584064,1,0,0,0,1
1584008,1,0,0,0,1
1583461,1,0,0,0,1
1577961,0,0,1,0,1
1577803,0,0,1,0,1
1576926,0,0,1,0,1
1575372,1,0,0,0,1
1570801,1,0,0,0,1
1570799,1,0,0,0,1
1570170,1,0,0,0,1
1568820,0,0,1,0,1
1535167,0,0,1,0,1
1535115,1,0,0,0,1
1534243,0,0,1,0,1
1515607,1,0,0,0,1
1511614,1,0,0,0,1
1511206,0,0,1,0,1
1509863,1,0,0,0,1
1507336,1,0,0,0,1
1506795,1,0,0,0,1
1505217,1,0,0,0,1
1504702,0,0,1,0,1
1504257,1,0,0,0,1
1503493,0,0,1,0,1
1500733,1,0,0,0,1
1500550,1,0,0,0,1
1499286,1,0,0,0,1
1498000,1,0,0,0,1
1497263,0,0,1,0,1
1496847,1,0,0,0,1
1495881,1,0,0,0,1
1495584,1,0,0,0,1
1495090,1,0,0,0,1
1495021,0,0,1,0,1
1514100,0,0,1,0,1
1515730,1,0,0,0,1
1533756,1,0,0,0,1
1516947,0,0,1,0,1
1533576,1,0,0,0,1
1533248,1,0,0,0,1
1528114,1,0,0,0,1
1527888,1,0,0,0,1
1525669,1,0,0,0,1
1525582,0,0,1,0,1
1525033,1,0,0,0,1
1524765,1,0,0,0,1
1524762,1,0,0,0,1
1524708,0,0,1,0,1
1523559,1,0,0,0,1
1523206,0,0,1,0,1
1523018,0,0,1,0,1
1522929,0,0,1,0,1
1522383,1,0,0,0,1
1520623,1,0,0,0,1
1520436,1,0,0,0,1
1519648,1,0,0,0,1
1517723,1,0,0,0,1
1397160,1,0,0,0,1
1396546,1,0,0,0,1
1181122,1,0,0,0,1
1257071,1,0,0,0,1
1267021,0,0,1,0,1
1265619,1,0,0,0,1
1264407,0,0,1,0,1
1263574,0,0,1,0,1
1260792,1,0,0,0,1
1260642,0,0,1,0,1
1260391,1,0,0,0,1
1258363,1,0,0,0,1
1258319,1,0,0,0,1
1256874,1,0,0,0,1
1241818,0,0,1,0,1
1252820,0,0,1,0,1
1252743,0,0,1,0,1
1252733,1,0,0,0,1
1251372,0,0,1,0,1
1250061,1,0,0,0,1
1249116,0,0,1,0,1
1246073,1,0,0,0,1
1245423,1,0,0,0,1
1242636,1,0,0,0,1
1267556,0,0,0,1,1
1270026,1,0,0,0,1
1270076,1,0,0,0,1
1272714,1,0,0,0,1
1288460,1,0,0,0,1
1288057,1,0,0,0,1
1287826,1,0,0,0,1
1286417,0,0,1,0,1
1286331,1,0,0,0,1
1286286,1,0,0,0,1
1283659,0,0,1,0,1
1283476,0,0,1,0,1
1282611,1,0,0,0,1
1281637,1,0,0,0,1
1280731,1,0,0,0,1
1279181,0,0,1,0,1
1279152,1,0,0,0,1
1278978,0,0,1,0,1
1274269,0,0,1,0,1
1273890,1,0,0,0,1
1273825,1,0,0,0,1
1273385,1,0,0,0,1
1273081,1,0,0,0,1
1242357,1,0,0,0,1
1240958,0,0,1,0,1
1394711,1,0,0,0,1
1192659,0,0,1,0,1
1207422,1,0,0,0,1
1204785,1,0,0,0,1
1201534,0,0,1,0,1
1200603,1,0,0,0,1
1199486,1,0,0,0,1
1196848,1,0,0,0,1
1195295,1,0,0,0,1
1194377,1,0,0,0,1
1194064,0,0,1,0,1
1192630,1,0,0,0,1
1239959,0,0,1,0,1
1192424,1,0,0,0,1
1191142,1,0,0,0,1
1190938,1,0,0,0,1
1190019,0,0,1,0,1
1187935,1,0,0,0,1
1186604,1,0,0,0,1
1184707,0,0,0,1,1
1182294,1,0,0,0,1
1181366,1,0,0,0,1
1207773,1,0,0,0,1
1208337,1,0,0,0,1
1209728,1,0,0,0,1
1210541,1,0,0,0,1
1239272,1,0,0,0,1
1238879,1,0,0,0,1
1237691,1,0,0,0,1
1237358,1,0,0,0,1
1236817,1,0,0,0,1
1236070,1,0,0,0,1
1234405,1,0,0,0,1
1233402,1,0,0,0,1
1229609,1,0,0,0,1
1228668,0,0,1,0,1
1228328,1,0,0,0,1
1226375,0,0,1,0,1
1225763,1,0,0,0,1
1225020,1,0,0,0,1
1223685,0,0,1,0,1
1221228,0,0,1,0,1
1217241,1,0,0,0,1
1217086,0,0,1,0,1
1214161,0,0,1,0,1
1288653,1,0,0,0,1
1289635,0,0,1,0,1
1289936,0,0,1,0,1
1358077,0,0,1,0,1
1367165,1,0,0,0,1
1366194,1,0,0,0,1
1362759,1,0,0,0,1
1361993,1,0,0,0,1
1360043,0,0,1,0,1
1359611,1,0,0,0,1
1359519,1,0,0,0,1
1358627,0,0,1,0,1
1358304,1,0,0,0,1
1356834,1,0,0,0,1
1290508,1,0,0,0,1
1356573,1,0,0,0,1
1355616,0,0,1,0,1
1350846,0,0,1,0,1
1349266,1,0,0,0,1
1348989,1,0,0,0,1
1348312,0,0,1,0,1
1346505,1,0,0,0,1
1345769,0,0,1,0,1
1345611,0,0,1,0,1
1370324,1,0,0,0,1
1370358,1,0,0,0,1
1372786,0,0,1,0,1
1372837,1,0,0,0,1
1393515,1,0,0,0,1
1393469,1,0,0,0,1
1390947,1,0,0,0,1
1389487,1,0,0,0,1
1388987,1,0,0,0,1
1387370,1,0,0,0,1
1387341,1,0,0,0,1
1387051,1,0,0,0,1
1384388,1,0,0,0,1
1384111,1,0,0,0,1
1384016,0,0,1,0,1
1382749,1,0,0,0,1
1380703,1,0,0,0,1
1380312,1,0,0,0,1
1380060,1,0,0,0,1
1377201,1,0,0,0,1
1376778,1,0,0,0,1
1373836,1,0,0,0,1
1372942,1,0,0,0,1
1345194,0,0,1,0,1
1343630,1,0,0,0,1
1342918,1,0,0,0,1
1307773,0,0,1,0,1
1306587,1,0,0,0,1
1303542,1,0,0,0,1
1303352,1,0,0,0,1
1302843,1,0,0,0,1
1302599,1,0,0,0,1
1302317,0,0,1,0,1
1300215,0,0,1,0,1
1299166,0,0,1,0,1
1298759,1,0,0,0,1
1297675,1,0,0,0,1
1295985,1,0,0,0,1
1295576,1,0,0,0,1
1295284,1,0,0,0,1
1294674,0,0,1,0,1
1292250,1,0,0,0,1
1292205,1,0,0,0,1
1291410,1,0,0,0,1
1290870,1,0,0,0,1
1290628,1,0,0,0,1
1306850,1,0,0,0,1
1309418,0,0,1,0,1
1340207,0,0,1,0,1
1311104,0,0,1,0,1
1336542,1,0,0,0,1
1335736,1,0,0,0,1
1333485,1,0,0,0,1
1331850,0,0,1,0,1
1331063,1,0,0,0,1
1330961,1,0,0,0,1
1330500,0,0,1,0,1
1330116,0,0,1,0,1
1319661,0,0,1,0,1
1319214,1,0,0,0,1
1318986,1,0,0,0,1
1317588,1,0,0,0,1
1317343,0,0,1,0,1
1316648,1,0,0,0,1
1315670,0,0,1,0,1
1315306,0,0,1,0,1
1313385,1,0,0,0,1
1313306,0,0,1,0,1
1311870,1,0,0,0,1
644941,1,0,0,0,1
642986,1,0,0,0,1
1601454,0,0,1,0,1
153817,1,0,0,0,1
157798,0,0,1,0,1
157241,1,0,0,0,1
156959,0,0,1,0,1
156298,1,0,0,0,1
155627,1,0,0,0,1
155163,0,0,1,0,1
154956,0,0,1,0,1
154866,1,0,0,0,1
154061,1,0,0,0,1
153675,1,0,0,0,1
145609,1,0,0,0,1
153494,0,0,1,0,1
151654,0,0,1,0,1
150832,1,0,0,0,1
149929,1,0,0,0,1
149047,1,0,0,0,1
148545,1,0,0,0,1
148108,1,0,0,0,1
148014,0,0,1,0,1
146944,1,0,0,0,1
158284,1,0,0,0,1
159370,1,0,0,0,1
159457,1,0,0,0,1
159726,1,0,0,0,1
175408,1,0,0,0,1
173997,0,0,1,0,1
173938,0,0,1,0,1
173307,1,0,0,0,1
172735,1,0,0,0,1
172672,1,0,0,0,1
170094,1,0,0,0,1
170034,1,0,0,0,1
169843,0,0,1,0,1
169653,1,0,0,0,1
167796,0,0,1,0,1
167417,0,0,1,0,1
167031,1,0,0,0,1
166532,1,0,0,0,1
166014,1,0,0,0,1
164675,0,0,1,0,1
160356,1,0,0,0,1
160337,1,0,0,0,1
159936,0,0,1,0,1
146825,0,0,1,0,1
143589,1,0,0,0,1
177293,1,0,0,0,1
124352,1,0,0,0,1
128669,1,0,0,0,1
128663,1,0,0,0,1
128514,1,0,0,0,1
128480,1,0,0,0,1
128256,1,0,0,0,1
128194,1,0,0,0,1
127767,1,0,0,0,1
127608,0,0,1,0,1
125857,0,0,1,0,1
123097,1,0,0,0,1
143476,1,0,0,0,1
120835,1,0,0,0,1
120623,1,0,0,0,1
120223,1,0,0,0,1
119510,1,0,0,0,1
119441,1,0,0,0,1
119415,0,0,1,0,1
117949,0,0,1,0,1
116599,0,0,1,0,1
115256,1,0,0,0,1
128806,1,0,0,0,1
128890,1,0,0,0,1
128920,1,0,0,0,1
129558,1,0,0,0,1
143027,1,0,0,0,1
142695,0,0,1,0,1
142611,0,0,1,0,1
142147,0,0,1,0,1
141933,1,0,0,0,1
141300,1,0,0,0,1
139810,1,0,0,0,1
139311,1,0,0,0,1
139135,1,0,0,0,1
138243,0,0,1,0,1
137292,0,0,1,0,1
136962,0,0,1,0,1
136352,0,0,1,0,1
135619,1,0,0,0,1
134936,1,0,0,0,1
133518,1,0,0,0,1
133077,0,0,1,0,1
131886,1,0,0,0,1
130804,0,0,1,0,1
176836,0,0,1,0,1
177712,0,0,1,0,1
639785,1,0,0,0,1
228012,1,0,0,0,1
240584,1,0,0,0,1
239829,1,0,0,0,1
238113,1,0,0,0,1
236002,1,0,0,0,1
235719,1,0,0,0,1
234918,1,0,0,0,1
233161,1,0,0,0,1
232651,0,0,1,0,1
230574,0,0,1,0,1
226697,0,0,1,0,1
208983,1,0,0,0,1
221893,1,0,0,0,1
221266,0,0,1,0,1
220770,1,0,0,0,1
220001,1,0,0,0,1
219313,1,0,0,0,1
218425,1,0,0,0,1
215764,0,0,1,0,1
215570,1,0,0,0,1
213020,0,0,1,0,1
241395,1,0,0,0,1
243356,1,0,0,0,1
244071,1,0,0,0,1
244340,1,0,0,0,1
258674,1,0,0,0,1
258164,0,0,1,0,1
258023,1,0,0,0,1
255597,1,0,0,0,1
254847,1,0,0,0,1
254585,1,0,0,0,1
253784,1,0,0,0,1
253385,0,0,1,0,1
253057,1,0,0,0,1
252361,1,0,0,0,1
252121,1,0,0,0,1
252059,0,0,1,0,1
249753,1,0,0,0,1
249372,0,0,1,0,1
249006,1,0,0,0,1
246928,1,0,0,0,1
245881,0,0,1,0,1
244560,1,0,0,0,1
244444,1,0,0,0,1
210602,1,0,0,0,1
208410,1,0,0,0,1
177922,0,0,1,0,1
185364,1,0,0,0,1
190239,1,0,0,0,1
189538,0,0,1,0,1
189275,1,0,0,0,1
188896,1,0,0,0,1
188082,1,0,0,0,1
186946,0,0,1,0,1
186084,1,0,0,0,1
185978,0,0,1,0,1
185446,0,0,1,0,1
184913,1,0,0,0,1
206892,1,0,0,0,1
184110,0,0,1,0,1
182852,1,0,0,0,1
182477,1,0,0,0,1
182205,1,0,0,0,1
181756,1,0,0,0,1
180380,1,0,0,0,1
179249,1,0,0,0,1
179020,0,0,1,0,1
178551,1,0,0,0,1
191269,1,0,0,0,1
192316,1,0,0,0,1
192349,1,0,0,0,1
193877,1,0,0,0,1
206115,1,0,0,0,1
204586,0,0,1,0,1
204472,1,0,0,0,1
204326,1,0,0,0,1
203444,0,0,1,0,1
203039,0,0,1,0,1
202665,1,0,0,0,1
202249,1,0,0,0,1
201223,1,0,0,0,1
199392,1,0,0,0,1
198411,1,0,0,0,1
198010,1,0,0,0,1
197286,1,0,0,0,1
195783,1,0,0,0,1
195168,1,0,0,0,1
195137,0,0,1,0,1
194994,0,0,1,0,1
194540,1,0,0,0,1
194457,0,0,1,0,1
111837,0,0,1,0,1
110958,1,0,0,0,1
110506,0,0,1,0,1
31994,1,0,0,0,1
36897,1,0,0,0,1
36841,1,0,0,0,1
35944,1,0,0,0,1
33681,1,0,0,0,1
33188,0,0,1,0,1
33009,1,0,0,0,1
32613,1,0,0,0,1
32212,1,0,0,0,1
32045,0,0,1,0,1
30193,1,0,0,0,1
24000,0,0,1,0,1
29213,0,0,1,0,1
29096,0,0,1,0,1
28422,1,0,0,0,1
28336,0,0,1,0,1
26309,1,0,0,0,1
25810,1,0,0,0,1
25632,1,0,0,0,1
25459,0,0,1,0,1
25137,1,0,0,0,1
37413,1,0,0,0,1
39260,1,0,0,0,1
40100,0,0,1,0,1
40275,1,0,0,0,1
55121,1,0,0,0,1
55021,1,0,0,0,1
54241,0,0,1,0,1
53132,1,0,0,0,1
52043,1,0,0,0,1
51038,0,0,1,0,1
50912,1,0,0,0,1
50190,1,0,0,0,1
50148,1,0,0,0,1
50124,0,0,1,0,1
47459,1,0,0,0,1
45682,1,0,0,0,1
45609,1,0,0,0,1
45445,0,0,1,0,1
44631,1,0,0,0,1
44145,1,0,0,0,1
43772,1,0,0,0,1
42032,0,0,1,0,1
41612,0,0,1,0,1
25100,0,0,1,0,1
23684,1,0,0,0,1
109738,1,0,0,0,1
7378,1,0,0,0,1
8967,0,0,1,0,1
8703,0,0,0,1,1
8605,1,0,0,0,1
8526,1,0,0,0,1
8067,0,0,1,0,1
7702,1,0,0,0,1
7500,1,0,0,0,1
7490,0,0,1,0,1
7450,1,0,0,0,1
6485,1,0,0,0,1
23619,1,0,0,0,1
6296,1,0,0,0,1
6041,0,0,1,0,1
5089,1,0,0,0,1
3869,1,0,0,0,1
3647,1,0,0,0,1
2868,1,0,0,0,1
2782,1,0,0,0,1
2571,1,0,0,0,1
2438,1,0,0,0,1
10496,1,0,0,0,1
11175,1,0,0,0,1
12220,1,0,0,0,1
12399,1,0,0,0,1
23276,1,0,0,0,1
23238,0,0,1,0,1
22462,1,0,0,0,1
22323,1,0,0,0,1
21475,0,0,1,0,1
20805,1,0,0,0,1
20549,1,0,0,0,1
19562,1,0,0,0,1
19402,1,0,0,0,1
18742,1,0,0,0,1
18282,0,0,1,0,1
17985,0,0,1,0,1
16800,0,0,1,0,1
15991,1,0,0,0,1
15742,1,0,0,0,1
15574,0,0,1,0,1
15192,1,0,0,0,1
14751,1,0,0,0,1
14356,0,0,1,0,1
55176,1,0,0,0,1
56246,1,0,0,0,1
56252,1,0,0,0,1
85843,1,0,0,0,1
92436,1,0,0,0,1
92272,1,0,0,0,1
90643,1,0,0,0,1
90316,0,0,1,0,1
88191,1,0,0,0,1
87988,1,0,0,0,1
87494,0,0,1,0,1
87473,1,0,0,0,1
87266,1,0,0,0,1
84529,1,0,0,0,1
56350,1,0,0,0,1
84320,1,0,0,0,1
83834,1,0,0,0,1
82930,1,0,0,0,1
82685,0,0,1,0,1
82286,1,0,0,0,1
81970,0,0,1,0,1
81325,1,0,0,0,1
80447,1,0,0,0,1
79402,1,0,0,0,1
92451,1,0,0,0,1
92782,1,0,0,0,1
92788,1,0,0,0,1
93790,0,0,1,0,1
107853,0,0,1,0,1
107628,0,0,1,0,1
107243,0,0,1,0,1
107016,0,0,1,0,1
106125,1,0,0,0,1
105538,1,0,0,0,1
104250,0,0,1,0,1
101597,1,0,0,0,1
100718,1,0,0,0,1
100688,1,0,0,0,1
99212,1,0,0,0,1
98976,1,0,0,0,1
98047,1,0,0,0,1
97797,1,0,0,0,1
97580,1,0,0,0,1
96755,1,0,0,0,1
96598,1,0,0,0,1
95786,1,0,0,0,1
94946,1,0,0,0,1
78742,1,0,0,0,1
78251,1,0,0,0,1
77328,0,0,1,0,1
62855,1,0,0,0,1
62583,1,0,0,0,1
62505,0,0,1,0,1
62345,0,0,1,0,1
62165,0,0,1,0,1
62001,1,0,0,0,1
60923,1,0,0,0,1
60255,1,0,0,0,1
60252,0,0,1,0,1
60049,1,0,0,0,1
60046,1,0,0,0,1
58556,1,0,0,0,1
58546,1,0,0,0,1
58483,1,0,0,0,1
57994,1,0,0,0,1
57799,1,0,0,0,1
57101,1,0,0,0,1
57059,1,0,0,0,1
57013,1,0,0,0,1
56920,0,0,1,0,1
62745,1,0,0,0,1
63043,0,0,1,0,1
74857,1,0,0,0,1
63853,1,0,0,0,1
73549,1,0,0,0,1
73245,0,0,1,0,1
71876,0,0,1,0,1
70936,1,0,0,0,1
70857,0,0,1,0,1
70834,1,0,0,0,1
70767,1,0,0,0,1
70614,1,0,0,0,1
70234,0,0,1,0,1
69942,0,0,1,0,1
69685,0,0,1,0,1
69527,0,0,1,0,1
68890,1,0,0,0,1
67730,0,0,1,0,1
67523,1,0,0,0,1
67180,1,0,0,0,1
66926,0,0,1,0,1
66035,1,0,0,0,1
65837,1,0,0,0,1
259787,1,0,0,0,1
260958,1,0,0,0,1
262578,0,0,1,0,1
497672,1,0,0,0,1
506779,1,0,0,0,1
506208,0,0,1,0,1
506194,1,0,0,0,1
505917,1,0,0,0,1
503800,1,0,0,0,1
503555,0,0,1,0,1
501456,1,0,0,0,1
499232,1,0,0,0,1
498638,1,0,0,0,1
497606,1,0,0,0,1
482835,1,0,0,0,1
496979,1,0,0,0,1
496465,0,0,1,0,1
493093,1,0,0,0,1
489950,1,0,0,0,1
489734,1,0,0,0,1
489400,1,0,0,0,1
487814,1,0,0,0,1
486948,0,0,1,0,1
485738,1,0,0,0,1
506909,1,0,0,0,1
506980,1,0,0,0,1
510577,1,0,0,0,1
512101,0,0,1,0,1
535128,0,0,1,0,1
534776,1,0,0,0,1
532819,0,0,1,0,1
531006,1,0,0,0,1
530553,1,0,0,0,1
530032,0,0,1,0,1
529412,1,0,0,0,1
528594,1,0,0,0,1
528409,1,0,0,0,1
527811,0,0,1,0,1
527622,1,0,0,0,1
526805,1,0,0,0,1
525663,0,0,1,0,1
522164,1,0,0,0,1
520279,1,0,0,0,1
520189,1,0,0,0,1
518821,1,0,0,0,1
517772,1,0,0,0,1
516563,1,0,0,0,1
485349,0,0,1,0,1
482242,0,0,1,0,1
417652,1,0,0,0,1
433146,1,0,0,0,1
440396,1,0,0,0,1
438545,1,0,0,0,1
437960,0,0,1,0,1
437578,1,0,0,0,1
436599,1,0,0,0,1
436365,0,0,1,0,1
434987,0,0,1,0,1
434473,1,0,0,0,1
433917,1,0,0,0,1
432107,1,0,0,0,1
481603,0,0,1,0,1
430970,1,0,0,0,1
428210,1,0,0,0,1
425806,1,0,0,0,1
425506,1,0,0,0,1
425363,1,0,0,0,1
424656,1,0,0,0,1
421444,1,0,0,0,1
420954,1,0,0,0,1
420542,0,0,1,0,1
442106,0,0,1,0,1
444603,0,0,1,0,1
447754,1,0,0,0,1
447895,1,0,0,0,1
480923,1,0,0,0,1
479432,0,0,1,0,1
478771,1,0,0,0,1
473624,0,0,1,0,1
473497,1,0,0,0,1
473428,0,0,1,0,1
473113,1,0,0,0,1
471928,1,0,0,0,1
469086,1,0,0,0,1
468752,0,0,1,0,1
465278,1,0,0,0,1
461947,1,0,0,0,1
458021,1,0,0,0,1
457976,1,0,0,0,1
454274,1,0,0,0,1
453519,1,0,0,0,1
451545,1,0,0,0,1
449787,1,0,0,0,1
449001,0,0,1,0,1
535999,1,0,0,0,1
536686,1,0,0,0,1
538008,1,0,0,0,1
610466,1,0,0,0,1
620288,0,0,1,0,1
619693,1,0,0,0,1
617990,1,0,0,0,1
617127,1,0,0,0,1
616825,0,0,1,0,1
616808,0,0,1,0,1
612818,1,0,0,0,1
612563,1,0,0,0,1
612240,1,0,0,0,1
608396,0,0,1,0,1
538300,0,0,1,0,1
606135,0,0,1,0,1
605463,1,0,0,0,1
605354,1,0,0,0,1
603493,1,0,0,0,1
603099,1,0,0,0,1
600626,1,0,0,0,1
600569,0,0,1,0,1
598167,0,0,1,0,1
598090,0,0,1,0,1
620810,1,0,0,0,1
621652,1,0,0,0,1
621971,1,0,0,0,1
622694,1,0,0,0,1
639526,1,0,0,0,1
636319,1,0,0,0,1
634346,0,0,1,0,1
634195,1,0,0,0,1
634096,1,0,0,0,1
634004,1,0,0,0,1
633339,0,0,0,1,1
631747,0,0,1,0,1
631374,0,0,1,0,1
630519,1,0,0,0,1
630489,1,0,0,0,1
627898,1,0,0,0,1
627678,0,0,1,0,1
625403,1,0,0,0,1
625092,0,0,1,0,1
624441,1,0,0,0,1
624419,1,0,0,0,1
623474,1,0,0,0,1
622866,1,0,0,0,1
595368,1,0,0,0,1
593862,1,0,0,0,1
590825,1,0,0,0,1
567187,0,0,1,0,1
564647,1,0,0,0,1
564585,1,0,0,0,1
563530,0,0,1,0,1
558101,1,0,0,0,1
557166,1,0,0,0,1
557157,1,0,0,0,1
557034,1,0,0,0,1
555739,1,0,0,0,1
553964,1,0,0,0,1
552343,1,0,0,0,1
552288,1,0,0,0,1
551139,1,0,0,0,1
550520,1,0,0,0,1
547423,1,0,0,0,1
547386,0,0,1,0,1
545273,0,0,1,0,1
543959,1,0,0,0,1
542611,1,0,0,0,1
541486,1,0,0,0,1
566200,0,0,1,0,1
567972,1,0,0,0,1
588899,1,0,0,0,1
568224,1,0,0,0,1
587918,1,0,0,0,1
586409,0,0,1,0,1
585879,1,0,0,0,1
585273,0,0,1,0,1
585166,1,0,0,0,1
580696,1,0,0,0,1
579495,1,0,0,0,1
579126,1,0,0,0,1
579017,1,0,0,0,1
576652,1,0,0,0,1
576387,1,0,0,0,1
575906,0,0,1,0,1
573868,1,0,0,0,1
573316,0,0,1,0,1
572879,1,0,0,0,1
570850,1,0,0,0,1
568880,1,0,0,0,1
568585,1,0,0,0,1
568325,1,0,0,0,1
419579,1,0,0,0,1
416361,1,0,0,0,1
262760,0,0,1,0,1
308068,1,0,0,0,1
314377,0,0,1,0,1
314256,0,0,1,0,1
314008,1,0,0,0,1
313317,0,0,1,0,1
312288,1,0,0,0,1
310296,1,0,0,0,1
309393,1,0,0,0,1
309329,1,0,0,0,1
308930,1,0,0,0,1
306545,1,0,0,0,1
297176,0,0,1,0,1
305591,1,0,0,0,1
305207,1,0,0,0,1
304434,1,0,0,0,1
302529,1,0,0,0,1
301836,1,0,0,0,1
301549,1,0,0,0,1
299755,0,0,1,0,1
299598,1,0,0,0,1
298841,1,0,0,0,1
314714,0,0,1,0,1
315401,1,0,0,0,1
315606,0,0,1,0,1
315824,1,0,0,0,1
325862,1,0,0,0,1
325474,1,0,0,0,1
325455,1,0,0,0,1
325453,0,0,1,0,1
324657,1,0,0,0,1
324628,1,0,0,0,1
324460,1,0,0,0,1
322884,1,0,0,0,1
322548,1,0,0,0,1
322079,1,0,0,0,1
321756,0,0,1,0,1
321710,1,0,0,0,1
321386,1,0,0,0,1
320761,1,0,0,0,1
320114,1,0,0,0,1
319842,0,0,1,0,1
318899,1,0,0,0,1
318340,1,0,0,0,1
317692,1,0,0,0,1
297818,1,0,0,0,1
296491,1,0,0,0,1
415502,0,0,1,0,1
269710,1,0,0,0,1
275582,1,0,0,0,1
275578,1,0,0,0,1
274557,1,0,0,0,1
274333,0,0,0,1,1
272006,1,0,0,0,1
271799,1,0,0,0,1
271527,1,0,0,0,1
271073,0,0,1,0,1
270404,1,0,0,0,1
268502,1,0,0,0,1
295544,0,0,1,0,1
267955,1,0,0,0,1
266210,0,0,0,1,1
265832,0,0,1,0,1
265525,1,0,0,0,1
265109,1,0,0,0,1
264928,0,0,1,0,1
263614,1,0,0,0,1
263510,0,0,1,0,1
262812,1,0,0,0,1
277394,0,0,1,0,1
277747,1,0,0,0,1
279078,1,0,0,0,1
280883,0,0,1,0,1
293394,1,0,0,0,1
292522,1,0,0,0,1
292421,0,0,1,0,1
292137,0,0,1,0,1
292084,1,0,0,0,1
291854,1,0,0,0,1
290662,1,0,0,0,1
290503,1,0,0,0,1
290094,0,0,1,0,1
290055,1,0,0,0,1
289183,1,0,0,0,1
289135,1,0,0,0,1
288972,1,0,0,0,1
288766,1,0,0,0,1
287733,1,0,0,0,1
284207,1,0,0,0,1
282927,1,0,0,0,1
282668,1,0,0,0,1
282315,1,0,0,0,1
325994,1,0,0,0,1
326150,1,0,0,0,1
326329,1,0,0,0,1
386263,1,0,0,0,1
394752,1,0,0,0,1
394640,1,0,0,0,1
394223,1,0,0,0,1
393043,0,0,1,0,1
392929,1,0,0,0,1
391553,1,0,0,0,1
390251,0,0,1,0,1
389321,1,0,0,0,1
388608,1,0,0,0,1
383406,1,0,0,0,1
326465,1,0,0,0,1
382749,1,0,0,0,1
380838,1,0,0,0,1
377783,1,0,0,0,1
377361,1,0,0,0,1
374115,1,0,0,0,1
373260,1,0,0,0,1
373085,1,0,0,0,1
373019,1,0,0,0,1
372673,1,0,0,0,1
398617,1,0,0,0,1
400240,1,0,0,0,1
400262,0,0,1,0,1
401696,1,0,0,0,1
415290,1,0,0,0,1
415120,1,0,0,0,1
414999,1,0,0,0,1
414627,1,0,0,0,1
414477,1,0,0,0,1
413316,1,0,0,0,1
411697,1,0,0,0,1
411437,1,0,0,0,1
410665,1,0,0,0,1
409965,0,0,1,0,1
409766,1,0,0,0,1
407922,0,0,1,0,1
407078,1,0,0,0,1
405908,1,0,0,0,1
405555,1,0,0,0,1
405225,1,0,0,0,1
405090,1,0,0,0,1
403032,1,0,0,0,1
402569,1,0,0,0,1
368528,0,0,1,0,1
365153,1,0,0,0,1
364955,1,0,0,0,1
345252,1,0,0,0,1
342760,1,0,0,0,1
342734,1,0,0,0,1
342054,1,0,0,0,1
340692,0,0,1,0,1
339715,1,0,0,0,1
338921,1,0,0,0,1
337159,1,0,0,0,1
336228,0,0,1,0,1
335272,1,0,0,0,1
335016,0,0,1,0,1
334485,1,0,0,0,1
330976,0,0,1,0,1
330371,1,0,0,0,1
330347,1,0,0,0,1
329931,0,0,1,0,1
327900,1,0,0,0,1
327778,0,0,1,0,1
327489,1,0,0,0,1
326952,1,0,0,0,1
343250,0,0,1,0,1
347036,1,0,0,0,1
364558,1,0,0,0,1
347642,0,0,1,0,1
363834,1,0,0,0,1
363357,1,0,0,0,1
362418,1,0,0,0,1
361254,0,0,1,0,1
360537,1,0,0,0,1
359500,0,0,1,0,1
359480,1,0,0,0,1
357533,1,0,0,0,1
357117,0,0,1,0,1
355548,1,0,0,0,1
354887,1,0,0,0,1
354385,0,0,1,0,1
353990,1,0,0,0,1
352168,1,0,0,0,1
351650,1,0,0,0,1
350773,0,0,1,0,1
349596,1,0,0,0,1
347953,1,0,0,0,1
347808,1,0,0,0,1
1600626,1,0,0,0,1
1602568,1,0,0,0,1
4166168,1,0,0,0,1
3218951,0,0,1,0,1
3247050,1,0,0,0,1
3241305,1,0,0,0,1
3239574,1,0,0,0,1
3239302,1,0,0,0,1
3237558,0,0,1,0,1
3235547,1,0,0,0,1
3228992,1,0,0,0,1
3228795,0,0,1,0,1
3219752,1,0,0,0,1
3218421,1,0,0,0,1
3189999,1,0,0,0,1
3212875,1,0,0,0,1
3211428,1,0,0,0,1
3210626,1,0,0,0,1
3210447,0,0,1,0,1
3210260,1,0,0,0,1
3207395,0,0,1,0,1
3207348,1,0,0,0,1
3206521,1,0,0,0,1
3203693,1,0,0,0,1
3247267,0,0,1,0,1
3248277,1,0,0,0,1
3248699,1,0,0,0,1
3249409,1,0,0,0,1
3290436,1,0,0,0,1
3285138,0,0,1,0,1
3284564,0,0,1,0,1
3282552,1,0,0,0,1
3280997,1,0,0,0,1
3279858,1,0,0,0,1
3274376,1,0,0,0,1
3274316,0,0,1,0,1
3272988,1,0,0,0,1
3266476,0,0,1,0,1
3266249,0,0,1,0,1
3264855,1,0,0,0,1
3263765,0,0,1,0,1
3260084,1,0,0,0,1
3259724,1,0,0,0,1
3259274,1,0,0,0,1
3251778,1,0,0,0,1
3250169,0,0,1,0,1
3249903,0,0,1,0,1
3202210,1,0,0,0,1
3187645,1,0,0,0,1
3291898,1,0,0,0,1
3130534,0,0,1,0,1
3146353,1,0,0,0,1
3146317,0,0,1,0,1
3139829,0,0,1,0,1
3138868,1,0,0,0,1
3137269,1,0,0,0,1
3137237,1,0,0,0,1
3136117,1,0,0,0,1
3131306,1,0,0,0,1
3130819,1,0,0,0,1
3130040,1,0,0,0,1
3187466,1,0,0,0,1
3129460,1,0,0,0,1
3125516,1,0,0,0,1
3125234,1,0,0,0,1
3121134,0,0,1,0,1
3119145,1,0,0,0,1
3118776,0,0,1,0,1
3116219,0,0,1,0,1
3116204,1,0,0,0,1
3115626,1,0,0,0,1
3146957,1,0,0,0,1
3147746,0,0,1,0,1
3148473,0,0,1,0,1
3149121,0,0,1,0,1
3184878,1,0,0,0,1
3183567,0,0,1,0,1
3181226,0,0,1,0,1
3181155,1,0,0,0,1
3180741,0,0,1,0,1
3179146,1,0,0,0,1
3177516,0,0,1,0,1
3175065,0,0,1,0,1
3173210,1,0,0,0,1
3173105,1,0,0,0,1
3173002,0,0,1,0,1
3166393,1,0,0,0,1
3164949,1,0,0,0,1
3163428,0,0,1,0,1
3161518,1,0,0,0,1
3158797,0,0,1,0,1
3156480,1,0,0,0,1
3152385,1,0,0,0,1
3150902,1,0,0,0,1
3291022,1,0,0,0,1
3292437,1,0,0,0,1
2786764,0,0,1,0,1
3407346,1,0,0,0,1
3424719,0,0,1,0,1
3424306,1,0,0,0,1
3422859,1,0,0,0,1
3419446,1,0,0,0,1
3417940,1,0,0,0,1
3417088,0,0,1,0,1
3415891,0,0,1,0,1
3414967,1,0,0,0,1
3413015,1,0,0,0,1
3405917,0,0,1,0,1
3390942,0,0,1,0,1
3404110,1,0,0,0,1
3402375,1,0,0,0,1
3402039,1,0,0,0,1
3400827,1,0,0,0,1
3400687,0,0,1,0,1
3399308,0,0,1,0,1
3399151,1,0,0,0,1
3395876,1,0,0,0,1
3394386,1,0,0,0,1
3427065,0,0,1,0,1
3427262,1,0,0,0,1
3428456,0,0,1,0,1
3434070,1,0,0,0,1
3483222,0,0,1,0,1
3478341,1,0,0,0,1
3473471,1,0,0,0,1
3473097,1,0,0,0,1
3472623,1,0,0,0,1
3472283,1,0,0,0,1
3472148,1,0,0,0,1
3470710,1,0,0,0,1
3464148,1,0,0,0,1
3463177,1,0,0,0,1
3462232,0,0,1,0,1
3460956,1,0,0,0,1
3456334,1,0,0,0,1
3449848,1,0,0,0,1
3448931,1,0,0,0,1
3448594,1,0,0,0,1
3447539,0,0,1,0,1
3447309,0,0,1,0,1
3445172,0,0,1,0,1
3393434,1,0,0,0,1
3389541,1,0,0,0,1
3295012,0,0,1,0,1
3312524,1,0,0,0,1
3337974,0,0,1,0,1
3335559,1,0,0,0,1
3333213,0,0,1,0,1
3330459,0,0,1,0,1
3329894,1,0,0,0,1
3323929,0,0,1,0,1
3320650,0,0,1,0,1
3320288,1,0,0,0,1
3313475,1,0,0,0,1
3312111,1,0,0,0,1
3389163,1,0,0,0,1
3311928,1,0,0,0,1
3311657,1,0,0,0,1
3311487,0,0,1,0,1
3311124,1,0,0,0,1
3304514,1,0,0,0,1
3303420,1,0,0,0,1
3302537,1,0,0,0,1
3302103,0,0,1,0,1
3297475,0,0,1,0,1
3338975,0,0,1,0,1
3339901,1,0,0,0,1
3341869,1,0,0,0,1
3344231,1,0,0,0,1
3388510,1,0,0,0,1
3381805,0,0,1,0,1
3376141,1,0,0,0,1
3376018,0,0,1,0,1
3375376,0,0,1,0,1
3372562,1,0,0,0,1
3372001,1,0,0,0,1
3370939,1,0,0,0,1
3370705,1,0,0,0,1
3370169,1,0,0,0,1
3363555,1,0,0,0,1
3361696,1,0,0,0,1
3358001,0,0,1,0,1
3355679,1,0,0,0,1
3353772,0,0,1,0,1
3353295,1,0,0,0,1
3351317,1,0,0,0,1
3351261,1,0,0,0,1
3348610,1,0,0,0,1
3114551,0,0,1,0,1
3114411,1,0,0,0,1
3113316,1,0,0,0,1
2897094,1,0,0,0,1
2905589,1,0,0,0,1
2903840,1,0,0,0,1
2903063,1,0,0,0,1
2902496,1,0,0,0,1
2902266,0,0,1,0,1
2899693,1,0,0,0,1
2899508,1,0,0,0,1
2897835,0,0,1,0,1
2897548,1,0,0,0,1
2895424,1,0,0,0,1
2862308,1,0,0,0,1
2891643,0,0,1,0,1
2883798,0,0,1,0,1
2883788,1,0,0,0,1
2881953,1,0,0,0,1
2880848,0,0,1,0,1
2880824,1,0,0,0,1
2878399,1,0,0,0,1
2878358,0,0,1,0,1
2874433,1,0,0,0,1
2907609,0,0,1,0,1
2908101,1,0,0,0,1
2908180,0,0,1,0,1
2908554,1,0,0,0,1
2934378,1,0,0,0,1
2934010,1,0,0,0,1
2930482,0,0,1,0,1
2928867,1,0,0,0,1
2928796,1,0,0,0,1
2928681,1,0,0,0,1
2928002,0,0,1,0,1
2927446,1,0,0,0,1
2926593,1,0,0,0,1
2925668,0,0,1,0,1
2924286,0,0,1,0,1
2921350,1,0,0,0,1
2921109,1,0,0,0,1
2920855,1,0,0,0,1
2919467,0,0,1,0,1
2919299,1,0,0,0,1
2910662,1,0,0,0,1
2910317,1,0,0,0,1
2909288,1,0,0,0,1
2862454,1,0,0,0,1
2861820,1,0,0,0,1
3113116,1,0,0,0,1
2805772,1,0,0,0,1
2816129,1,0,0,0,1
2812842,1,0,0,0,1
2811974,1,0,0,0,1
2811538,1,0,0,0,1
2811458,1,0,0,0,1
2809854,1,0,0,0,1
2808971,1,0,0,0,1
2808153,1,0,0,0,1
2806561,1,0,0,0,1
2805766,1,0,0,0,1
2859194,0,0,1,0,1
2803589,0,0,1,0,1
2802223,1,0,0,0,1
2801328,1,0,0,0,1
2800064,1,0,0,0,1
2799768,1,0,0,0,1
2798644,1,0,0,0,1
2792179,0,0,1,0,1
2789221,1,0,0,0,1
2788262,1,0,0,0,1
2818232,1,0,0,0,1
2818245,1,0,0,0,1
2820776,0,0,1,0,1
2821175,1,0,0,0,1
2857722,1,0,0,0,1
2851409,1,0,0,0,1
2849386,1,0,0,0,1
2847655,1,0,0,0,1
2845014,1,0,0,0,1
2843987,1,0,0,0,1
2843970,1,0,0,0,1
2840710,1,0,0,0,1
2838861,0,0,1,0,1
2838365,0,0,1,0,1
2837527,1,0,0,0,1
2831384,1,0,0,0,1
2830735,0,0,1,0,1
2830216,0,0,1,0,1
2830197,1,0,0,0,1
2829908,1,0,0,0,1
2828476,1,0,0,0,1
2823757,1,0,0,0,1
2822245,0,0,1,0,1
2938302,1,0,0,0,1
2938381,1,0,0,0,1
2939479,0,0,1,0,1
3044041,1,0,0,0,1
3057531,1,0,0,0,1
3056690,0,0,1,0,1
3055496,0,0,1,0,1
3054174,1,0,0,0,1
3054124,1,0,0,0,1
3053280,1,0,0,0,1
3052833,1,0,0,0,1
3048003,1,0,0,0,1
3047107,1,0,0,0,1
3042136,1,0,0,0,1
2941712,1,0,0,0,1
3040104,1,0,0,0,1
3039478,1,0,0,0,1
3035426,1,0,0,0,1
3029414,1,0,0,0,1
3027903,1,0,0,0,1
3025128,1,0,0,0,1
3024373,0,0,1,0,1
3022852,1,0,0,0,1
3019795,1,0,0,0,1
3064885,0,0,1,0,1
3068045,1,0,0,0,1
3069996,1,0,0,0,1
3072696,1,0,0,0,1
3108771,0,0,1,0,1
3106679,1,0,0,0,1
3104336,0,0,1,0,1
3100823,0,0,1,0,1
3095778,1,0,0,0,1
3094303,0,0,1,0,1
3092054,1,0,0,0,1
3090082,1,0,0,0,1
3088873,1,0,0,0,1
3088202,1,0,0,0,1
3086826,0,0,1,0,1
3086048,1,0,0,0,1
3084731,0,0,1,0,1
3083244,0,0,1,0,1
3081990,1,0,0,0,1
3077147,1,0,0,0,1
3075854,0,0,1,0,1
3074342,1,0,0,0,1
3073721,1,0,0,0,1
3017533,1,0,0,0,1
3013025,0,0,1,0,1
3011750,1,0,0,0,1
2972733,1,0,0,0,1
2971300,1,0,0,0,1
2968869,1,0,0,0,1
2968247,1,0,0,0,1
2966937,1,0,0,0,1
2966628,0,0,1,0,1
2965915,1,0,0,0,1
2961779,1,0,0,0,1
2960920,0,0,1,0,1
2960351,0,0,1,0,1
2960046,0,0,1,0,1
2958784,1,0,0,0,1
2955491,0,0,1,0,1
2955296,1,0,0,0,1
2954680,1,0,0,0,1
2954574,1,0,0,0,1
2949355,1,0,0,0,1
2947857,1,0,0,0,1
2946771,1,0,0,0,1
2946319,1,0,0,0,1
2972546,1,0,0,0,1
2973437,1,0,0,0,1
3010260,1,0,0,0,1
2977901,1,0,0,0,1
3002643,1,0,0,0,1
3002017,1,0,0,0,1
3001268,0,0,1,0,1
2999210,1,0,0,0,1
2995352,0,0,1,0,1
2994135,0,0,1,0,1
2993160,1,0,0,0,1
2989773,1,0,0,0,1
2989617,0,0,1,0,1
2987524,1,0,0,0,1
2985394,1,0,0,0,1
2983459,1,0,0,0,1
2983302,0,0,1,0,1
2983089,1,0,0,0,1
2982441,1,0,0,0,1
2981910,1,0,0,0,1
2981156,0,0,1,0,1
2980990,0,0,1,0,1
2978784,1,0,0,0,1
3483600,0,0,1,0,1
3486202,0,0,1,0,1
3490097,0,0,1,0,1
3954840,1,0,0,0,1
3964655,1,0,0,0,1
3964453,1,0,0,0,1
3964276,1,0,0,0,1
3961636,1,0,0,0,1
3961158,1,0,0,0,1
3956850,1,0,0,0,1
3956436,1,0,0,0,1
3955766,1,0,0,0,1
3955342,0,0,1,0,1
3952962,0,0,1,0,1
3930799,1,0,0,0,1
3952722,0,0,1,0,1
3951033,1,0,0,0,1
3949502,0,0,1,0,1
3948178,1,0,0,0,1
3947310,1,0,0,0,1
3940516,0,0,1,0,1
3937646,1,0,0,0,1
3936600,1,0,0,0,1
3935522,1,0,0,0,1
3965297,1,0,0,0,1
3967827,1,0,0,0,1
3969780,1,0,0,0,1
3974249,1,0,0,0,1
4022922,1,0,0,0,1
4018726,1,0,0,0,1
4018660,1,0,0,0,1
4015459,0,0,1,0,1
4012917,1,0,0,0,1
4008899,1,0,0,0,1
4006238,1,0,0,0,1
4005049,0,0,1,0,1
4002775,1,0,0,0,1
4000059,1,0,0,0,1
3997164,0,0,1,0,1
3995271,1,0,0,0,1
3994331,1,0,0,0,1
3990540,1,0,0,0,1
3988830,1,0,0,0,1
3988482,1,0,0,0,1
3988031,1,0,0,0,1
3977693,0,0,1,0,1
3975066,1,0,0,0,1
3931900,1,0,0,0,1
3927655,1,0,0,0,1
3849776,1,0,0,0,1
3872251,1,0,0,0,1
3894843,0,0,1,0,1
3891399,0,0,1,0,1
3889739,0,0,1,0,1
3887151,1,0,0,0,1
3883648,1,0,0,0,1
3882708,1,0,0,0,1
3882661,1,0,0,0,1
3880974,1,0,0,0,1
3879284,0,0,1,0,1
3869531,0,0,1,0,1
3925275,1,0,0,0,1
3868692,0,0,1,0,1
3866196,1,0,0,0,1
3865502,1,0,0,0,1
3864968,1,0,0,0,1
3864482,0,0,1,0,1
3861392,1,0,0,0,1
3857631,1,0,0,0,1
3856750,1,0,0,0,1
3856533,0,0,1,0,1
3895498,0,0,1,0,1
3896287,1,0,0,0,1
3896863,1,0,0,0,1
3898627,1,0,0,0,1
3925093,1,0,0,0,1
3922367,1,0,0,0,1
3922258,0,0,1,0,1
3922019,1,0,0,0,1
3921565,1,0,0,0,1
3921081,1,0,0,0,1
3920522,0,0,1,0,1
3919533,1,0,0,0,1
3916340,0,0,1,0,1
3913087,1,0,0,0,1
3912009,1,0,0,0,1
3911928,1,0,0,0,1
3906249,1,0,0,0,1
3901962,1,0,0,0,1
3901166,1,0,0,0,1
3900540,1,0,0,0,1
3900093,1,0,0,0,1
3899139,1,0,0,0,1
3898812,1,0,0,0,1
4023094,1,0,0,0,1
4025188,0,0,1,0,1
4025420,0,0,1,0,1
4105474,1,0,0,0,1
4119786,0,0,1,0,1
4117834,1,0,0,0,1
4111640,0,0,1,0,1
4110869,0,0,1,0,1
4110759,0,0,1,0,1
4108348,0,0,1,0,1
4107826,0,0,1,0,1
4107600,0,0,0,1,1
4106401,1,0,0,0,1
4105376,0,0,1,0,1
4028092,1,0,0,0,1
4104874,1,0,0,0,1
4102722,1,0,0,0,1
4099467,1,0,0,0,1
4098796,0,0,1,0,1
4098538,1,0,0,0,1
4097085,0,0,1,0,1
4096046,1,0,0,0,1
4094857,1,0,0,0,1
4094284,1,0,0,0,1
4122424,1,0,0,0,1
4122771,1,0,0,0,1
4124666,1,0,0,0,1
4125000,1,0,0,0,1
4162828,0,0,1,0,1
4158981,0,0,1,0,1
4156449,0,0,1,0,1
4153591,1,0,0,0,1
4153233,0,0,1,0,1
4152479,0,0,1,0,1
4149263,1,0,0,0,1
4148174,1,0,0,0,1
4147380,1,0,0,0,1
4143813,0,0,1,0,1
4143186,0,0,1,0,1
4142684,1,0,0,0,1
4140255,1,0,0,0,1
4139266,1,0,0,0,1
4137840,0,0,1,0,1
4136824,0,0,1,0,1
4130492,1,0,0,0,1
4128972,0,0,1,0,1
4128829,1,0,0,0,1
4094151,1,0,0,0,1
4094013,1,0,0,0,1
4089912,1,0,0,0,1
4050500,1,0,0,0,1
4049004,0,0,1,0,1
4048704,0,0,1,0,1
4047395,0,0,1,0,1
4044889,0,0,1,0,1
4044499,0,0,1,0,1
4043468,0,0,1,0,1
4041877,1,0,0,0,1
4040200,1,0,0,0,1
4039873,0,0,1,0,1
4037192,1,0,0,0,1
4036700,1,0,0,0,1
4036685,1,0,0,0,1
4035493,1,0,0,0,1
4035309,1,0,0,0,1
4034995,0,0,1,0,1
4033160,0,0,1,0,1
4031913,0,0,1,0,1
4030621,1,0,0,0,1
4028470,1,0,0,0,1
4050348,0,0,1,0,1
4051711,1,0,0,0,1
4089400,1,0,0,0,1
4052055,0,0,1,0,1
4088417,1,0,0,0,1
4086839,1,0,0,0,1
4084075,1,0,0,0,1
4083145,0,0,1,0,1
4080758,1,0,0,0,1
4077292,0,0,1,0,1
4076045,0,0,1,0,1
4075380,1,0,0,0,1
4075128,0,0,1,0,1
4069855,0,0,1,0,1
4068562,1,0,0,0,1
4068325,1,0,0,0,1
4061660,0,0,1,0,1
4060346,0,0,1,0,1
4059918,1,0,0,0,1
4056243,1,0,0,0,1
4055295,1,0,0,0,1
4055091,0,0,1,0,1
4052356,0,0,1,0,1
3855454,1,0,0,0,1
3849025,1,0,0,0,1
3490498,0,0,1,0,1
3600065,0,0,1,0,1
3610129,1,0,0,0,1
3609819,1,0,0,0,1
3609524,1,0,0,0,1
3607821,1,0,0,0,1
3607695,1,0,0,0,1
3604436,1,0,0,0,1
3604124,0,0,1,0,1
3602785,1,0,0,0,1
3600282,1,0,0,0,1
3599579,1,0,0,0,1
3588693,1,0,0,0,1
3599088,0,0,1,0,1
3599030,0,0,1,0,1
3597769,0,0,1,0,1
3597708,1,0,0,0,1
3597177,1,0,0,0,1
3595395,1,0,0,0,1
3595138,1,0,0,0,1
3593603,1,0,0,0,1
3592883,1,0,0,0,1
3620205,0,0,1,0,1
3624487,1,0,0,0,1
3629010,1,0,0,0,1
3630017,0,0,1,0,1
3664194,1,0,0,0,1
3663769,1,0,0,0,1
3663033,1,0,0,0,1
3662459,1,0,0,0,1
3655401,1,0,0,0,1
3650456,0,0,1,0,1
3648735,1,0,0,0,1
3642035,1,0,0,0,1
3641421,1,0,0,0,1
3639678,1,0,0,0,1
3638277,1,0,0,0,1
3637890,1,0,0,0,1
3636827,1,0,0,0,1
3635762,1,0,0,0,1
3635302,1,0,0,0,1
3633413,0,0,1,0,1
3632170,1,0,0,0,1
3631872,1,0,0,0,1
3630400,0,0,1,0,1
3588854,0,0,1,0,1
3588028,1,0,0,0,1
3843401,1,0,0,0,1
3519805,1,0,0,0,1
3542562,0,0,1,0,1
3541594,1,0,0,0,1
3540041,1,0,0,0,1
3537298,0,0,1,0,1
3531288,1,0,0,0,1
3530018,0,0,1,0,1
3526617,1,0,0,0,1
3524653,0,0,1,0,1
3522798,1,0,0,0,1
3514707,1,0,0,0,1
3586725,0,0,1,0,1
3512437,1,0,0,0,1
3510997,1,0,0,0,1
3510638,1,0,0,0,1
3509166,1,0,0,0,1
3504234,1,0,0,0,1
3501090,0,0,1,0,1
3495471,1,0,0,0,1
3494371,1,0,0,0,1
3490818,1,0,0,0,1
3543739,1,0,0,0,1
3543836,1,0,0,0,1
3546483,0,0,1,0,1
3547840,1,0,0,0,1
3583973,1,0,0,0,1
3583662,1,0,0,0,1
3577509,1,0,0,0,1
3574249,1,0,0,0,1
3569392,0,0,1,0,1
3566048,1,0,0,0,1
3565422,1,0,0,0,1
3563303,1,0,0,0,1
3561489,1,0,0,0,1
3560446,1,0,0,0,1
3560299,0,0,1,0,1
3559865,1,0,0,0,1
3558909,1,0,0,0,1
3558158,1,0,0,0,1
3558042,1,0,0,0,1
3555480,1,0,0,0,1
3554055,1,0,0,0,1
3552356,0,0,1,0,1
3549531,0,0,1,0,1
3664605,1,0,0,0,1
3665794,1,0,0,0,1
3666608,0,0,1,0,1
3775799,0,0,1,0,1
3800548,0,0,1,0,1
3799437,1,0,0,0,1
3793540,1,0,0,0,1
3792156,1,0,0,0,1
3788789,1,0,0,0,1
3787962,1,0,0,0,1
3782356,0,0,1,0,1
3780975,1,0,0,0,1
3779326,1,0,0,0,1
3775509,1,0,0,0,1
3666809,0,0,1,0,1
3771945,0,0,1,0,1
3769020,1,0,0,0,1
3765042,1,0,0,0,1
3764548,1,0,0,0,1
3760161,0,0,1,0,1
3758073,0,0,1,0,1
3757699,1,0,0,0,1
3751841,1,0,0,0,1
3750905,1,0,0,0,1
3801047,1,0,0,0,1
3801427,1,0,0,0,1
3803423,1,0,0,0,1
3803638,1,0,0,0,1
3841446,1,0,0,0,1
3841371,1,0,0,0,1
3836868,1,0,0,0,1
3831783,1,0,0,0,1
3830753,1,0,0,0,1
3829864,1,0,0,0,1
3829665,1,0,0,0,1
3829471,0,0,1,0,1
3827805,1,0,0,0,1
3818314,1,0,0,0,1
3817362,1,0,0,0,1
3816296,1,0,0,0,1
3814039,0,0,1,0,1
3813758,1,0,0,0,1
3812968,1,0,0,0,1
3811358,1,0,0,0,1
3806936,1,0,0,0,1
3806282,1,0,0,0,1
3805397,1,0,0,0,1
3749996,1,0,0,0,1
3749703,1,0,0,0,1
3744921,0,0,1,0,1
3699733,1,0,0,0,1
3696938,1,0,0,0,1
3695778,0,0,1,0,1
3695529,1,0,0,0,1
3693847,1,0,0,0,1
3693307,0,0,1,0,1
3690070,1,0,0,0,1
3689829,0,0,1,0,1
3687880,0,0,1,0,1
3686796,1,0,0,0,1
3686511,1,0,0,0,1
3686379,0,0,1,0,1
3684360,0,0,1,0,1
3684332,0,0,1,0,1
3680044,1,0,0,0,1
3680008,1,0,0,0,1
3677131,0,0,1,0,1
3676701,1,0,0,0,1
3675389,1,0,0,0,1
3670982,1,0,0,0,1
3697130,1,0,0,0,1
3700250,1,0,0,0,1
3741891,0,0,1,0,1
3701760,0,0,1,0,1
3741154,0,0,1,0,1
3740293,0,0,1,0,1
3739543,1,0,0,0,1
3738167,1,0,0,0,1
3737986,1,0,0,0,1
3737582,1,0,0,0,1
3737483,0,0,1,0,1
3732261,1,0,0,0,1
3726366,1,0,0,0,1
3720000,1,0,0,0,1
3718821,1,0,0,0,1
3716646,1,0,0,0,1
3716130,1,0,0,0,1
3715873,1,0,0,0,1
3714721,0,0,1,0,1
3710931,1,0,0,0,1
3708965,1,0,0,0,1
3707465,1,0,0,0,1
3704762,1,0,0,0,1
2787824,0,0,1,0,1
2780938,1,0,0,0,1
1603471,0,0,1,0,1
2023694,1,0,0,0,1
2045777,1,0,0,0,1
2039385,1,0,0,0,1
2035472,1,0,0,0,1
2034361,1,0,0,0,1
2034343,0,0,1,0,1
2034271,0,0,1,0,1
2033628,1,0,0,0,1
2026554,1,0,0,0,1
2023993,0,0,1,0,1
2023582,1,0,0,0,1
1992020,1,0,0,0,1
2020152,1,0,0,0,1
2017752,1,0,0,0,1
2011516,1,0,0,0,1
2011110,1,0,0,0,1
2010460,0,0,1,0,1
2007714,1,0,0,0,1
2000165,0,0,1,0,1
2000143,1,0,0,0,1
1995093,1,0,0,0,1
2050328,1,0,0,0,1
2050954,0,0,0,1,1
2050957,1,0,0,0,1
2051075,1,0,0,0,1
2085639,1,0,0,0,1
2083759,1,0,0,0,1
2082420,1,0,0,0,1
2082345,1,0,0,0,1
2079633,1,0,0,0,1
2077383,1,0,0,0,1
2076525,1,0,0,0,1
2076284,0,0,1,0,1
2074433,0,0,1,0,1
2074014,0,0,1,0,1
2065971,1,0,0,0,1
2065673,1,0,0,0,1
2065453,0,0,1,0,1
2064585,0,0,1,0,1
2060383,1,0,0,0,1
2057341,1,0,0,0,1
2055744,1,0,0,0,1
2053735,1,0,0,0,1
2051376,1,0,0,0,1
1993811,1,0,0,0,1
1990120,1,0,0,0,1
2089329,1,0,0,0,1
1916737,0,0,1,0,1
1931414,0,0,1,0,1
1931205,1,0,0,0,1
1930204,0,0,1,0,1
1929442,1,0,0,0,1
1928798,1,0,0,0,1
1924825,1,0,0,0,1
1924750,0,0,1,0,1
1921498,0,0,1,0,1
1918272,1,0,0,0,1
1916500,0,0,1,0,1
1982268,1,0,0,0,1
1914516,1,0,0,0,1
1912541,1,0,0,0,1
1908606,0,0,1,0,1
1908073,1,0,0,0,1
1906804,1,0,0,0,1
1904415,1,0,0,0,1
1902623,1,0,0,0,1
1901846,1,0,0,0,1
1898675,1,0,0,0,1
1931828,0,0,1,0,1
1931990,1,0,0,0,1
1935291,0,0,1,0,1
1935605,1,0,0,0,1
1981742,1,0,0,0,1
1978940,0,0,1,0,1
1978714,1,0,0,0,1
1978457,1,0,0,0,1
1977947,0,0,1,0,1
1976325,1,0,0,0,1
1974212,0,0,1,0,1
1971850,0,0,1,0,1
1971142,1,0,0,0,1
1965783,1,0,0,0,1
1961551,0,0,1,0,1
1961411,1,0,0,0,1
1941852,1,0,0,0,1
1940613,1,0,0,0,1
1940153,1,0,0,0,1
1939728,0,0,1,0,1
1939708,1,0,0,0,1
1939680,0,0,1,0,1
1939376,0,0,1,0,1
2087636,1,0,0,0,1
2090668,1,0,0,0,1
2778578,0,0,1,0,1
2204078,1,0,0,0,1
2224802,1,0,0,0,1
2224337,0,0,1,0,1
2223241,1,0,0,0,1
2220859,1,0,0,0,1
2215854,0,0,1,0,1
2215648,1,0,0,0,1
2211566,1,0,0,0,1
2206491,1,0,0,0,1
2205455,0,0,1,0,1
2203415,1,0,0,0,1
2172367,0,0,1,0,1
2201963,0,0,1,0,1
2195853,0,0,1,0,1
2186974,0,0,1,0,1
2182322,1,0,0,0,1
2182167,0,0,1,0,1
2180661,0,0,1,0,1
2179407,0,0,1,0,1
2178877,0,0,1,0,1
2177462,1,0,0,0,1
2227376,1,0,0,0,1
2228082,1,0,0,0,1
2228137,0,0,1,0,1
2230419,0,0,1,0,1
2248626,1,0,0,0,1
2248545,1,0,0,0,1
2247818,1,0,0,0,1
2247187,0,0,1,0,1
2246253,0,0,1,0,1
2246215,0,0,1,0,1
2246147,1,0,0,0,1
2246071,1,0,0,0,1
2243431,1,0,0,0,1
2242911,1,0,0,0,1
2240143,1,0,0,0,1
2239235,1,0,0,0,1
2239196,1,0,0,0,1
2238348,0,0,1,0,1
2237283,1,0,0,0,1
2237267,1,0,0,0,1
2235105,1,0,0,0,1
2233165,0,0,1,0,1
2232821,0,0,1,0,1
2175110,1,0,0,0,1
2171676,0,0,1,0,1
2091048,1,0,0,0,1
2109282,0,0,1,0,1
2126994,0,0,1,0,1
2126399,1,0,0,0,1
2125773,1,0,0,0,1
2124716,0,0,1,0,1
2120259,1,0,0,0,1
2119928,1,0,0,0,1
2119451,1,0,0,0,1
2111332,1,0,0,0,1
2110601,1,0,0,0,1
2109258,0,0,1,0,1
2171626,1,0,0,0,1
2108671,1,0,0,0,1
2107636,1,0,0,0,1
2105276,1,0,0,0,1
2102682,0,0,1,0,1
2102205,1,0,0,0,1
2101858,0,0,1,0,1
2101238,1,0,0,0,1
2100968,1,0,0,0,1
2092089,1,0,0,0,1
2128535,0,0,1,0,1
2130954,1,0,0,0,1
2134232,0,0,1,0,1
2134465,1,0,0,0,1
2166065,1,0,0,0,1
2164856,0,0,1,0,1
2163683,1,0,0,0,1
2162887,1,0,0,0,1
2161203,1,0,0,0,1
2157562,1,0,0,0,1
2156741,1,0,0,0,1
2155917,1,0,0,0,1
2155593,1,0,0,0,1
2155360,1,0,0,0,1
2152359,1,0,0,0,1
2148881,0,0,1,0,1
2147475,1,0,0,0,1
2147438,0,0,1,0,1
2141311,0,0,1,0,1
2141246,1,0,0,0,1
2141109,1,0,0,0,1
2140823,1,0,0,0,1
2139368,1,0,0,0,1
1896159,1,0,0,0,1
1895793,1,0,0,0,1
1892706,0,0,1,0,1
1684332,1,0,0,0,1
1703438,0,0,1,0,1
1702298,0,0,1,0,1
1700398,1,0,0,0,1
1700359,1,0,0,0,1
1699505,0,0,1,0,1
1690322,1,0,0,0,1
1688742,0,0,1,0,1
1687425,0,0,1,0,1
1686834,0,0,1,0,1
1683860,1,0,0,0,1
1672734,1,0,0,0,1
1682447,0,0,1,0,1
1681142,1,0,0,0,1
1679238,1,0,0,0,1
1678861,1,0,0,0,1
1676600,0,0,1,0,1
1676487,1,0,0,0,1
1676172,1,0,0,0,1
1674691,1,0,0,0,1
1674102,1,0,0,0,1
1704042,1,0,0,0,1
1704370,1,0,0,0,1
1705205,1,0,0,0,1
1705617,1,0,0,0,1
1735342,1,0,0,0,1
1733622,0,0,1,0,1
1728785,0,0,1,0,1
1727954,0,0,1,0,1
1725122,1,0,0,0,1
1723734,1,0,0,0,1
1723702,1,0,0,0,1
1723475,1,0,0,0,1
1723406,0,0,1,0,1
1723222,1,0,0,0,1
1722812,1,0,0,0,1
1722490,1,0,0,0,1
1722054,1,0,0,0,1
1717520,1,0,0,0,1
1716576,1,0,0,0,1
1714427,1,0,0,0,1
1713011,1,0,0,0,1
1712843,0,0,1,0,1
1708922,1,0,0,0,1
1673750,1,0,0,0,1
1670585,0,0,1,0,1
1884204,1,0,0,0,1
1620498,1,0,0,0,1
1632428,0,0,1,0,1
1632149,0,0,1,0,1
1631330,1,0,0,0,1
1630247,1,0,0,0,1
1629906,0,0,1,0,1
1627760,1,0,0,0,1
1623346,0,0,1,0,1
1622733,1,0,0,0,1
1622421,1,0,0,0,1
1619994,1,0,0,0,1
1664473,1,0,0,0,1
1617817,0,0,1,0,1
1616218,1,0,0,0,1
1610862,0,0,1,0,1
1609585,1,0,0,0,1
1607879,1,0,0,0,1
1607289,1,0,0,0,1
1607087,0,0,1,0,1
1606152,1,0,0,0,1
1606133,0,0,1,0,1
1636933,1,0,0,0,1
1637060,1,0,0,0,1
1639309,1,0,0,0,1
1639979,1,0,0,0,1
1663994,1,0,0,0,1
1661965,1,0,0,0,1
1661244,1,0,0,0,1
1660906,1,0,0,0,1
1660841,0,0,1,0,1
1658443,1,0,0,0,1
1657540,0,0,1,0,1
1657228,0,0,1,0,1
1656285,1,0,0,0,1
1655982,1,0,0,0,1
1655939,1,0,0,0,1
1653404,0,0,1,0,1
1653265,0,0,1,0,1
1651591,0,0,1,0,1
1649300,1,0,0,0,1
1644999,1,0,0,0,1
1644452,1,0,0,0,1
1642096,1,0,0,0,1
1640615,1,0,0,0,1
1740216,0,0,1,0,1
1740784,0,0,1,0,1
1740952,1,0,0,0,1
1826449,1,0,0,0,1
1842714,0,0,1,0,1
1841580,1,0,0,0,1
1840581,0,0,1,0,1
1837068,1,0,0,0,1
1834658,1,0,0,0,1
1832751,0,0,1,0,1
1832228,1,0,0,0,1
1831089,1,0,0,0,1
1830864,1,0,0,0,1
1826093,1,0,0,0,1
1741498,1,0,0,0,1
1825554,1,0,0,0,1
1825030,1,0,0,0,1
1824881,0,0,1,0,1
1821771,0,0,1,0,1
1819657,0,0,1,0,1
1818225,1,0,0,0,1
1815738,1,0,0,0,1
1811344,1,0,0,0,1
1807608,1,0,0,0,1
1845333,0,0,1,0,1
1850631,1,0,0,0,1
1852207,1,0,0,0,1
1853437,1,0,0,0,1
1883594,0,0,1,0,1
1879438,1,0,0,0,1
1876539,1,0,0,0,1
1874429,0,0,1,0,1
1873830,1,0,0,0,1
1873589,1,0,0,0,1
1872051,1,0,0,0,1
1866827,0,0,1,0,1
1864338,1,0,0,0,1
1863756,1,0,0,0,1
1863598,1,0,0,0,1
1863597,0,0,1,0,1
1862880,1,0,0,0,1
1862040,1,0,0,0,1
1859395,0,0,0,1,1
1857899,1,0,0,0,1
1857457,1,0,0,0,1
1856829,1,0,0,0,1
1855214,1,0,0,0,1
1804774,1,0,0,0,1
1804283,0,0,1,0,1
1799971,1,0,0,0,1
1763852,1,0,0,0,1
1762555,0,0,1,0,1
1758019,1,0,0,0,1
1757016,1,0,0,0,1
1756362,1,0,0,0,1
1755999,0,0,1,0,1
1755123,1,0,0,0,1
1755036,1,0,0,0,1
1753078,1,0,0,0,1
1752434,1,0,0,0,1
1751800,1,0,0,0,1
1751498,1,0,0,0,1
1750685,1,0,0,0,1
1747467,1,0,0,0,1
1746838,1,0,0,0,1
1746811,1,0,0,0,1
1746765,1,0,0,0,1
1746238,0,0,1,0,1
1745926,0,0,1,0,1
1745402,1,0,0,0,1
1762558,0,0,1,0,1
1763862,1,0,0,0,1
1797637,1,0,0,0,1
1766929,1,0,0,0,1
1797304,0,0,1,0,1
1795207,1,0,0,0,1
1793569,1,0,0,0,1
1792688,1,0,0,0,1
1788746,0,0,1,0,1
1788377,1,0,0,0,1
1788010,1,0,0,0,1
1787313,1,0,0,0,1
1787284,0,0,0,1,1
1786943,1,0,0,0,1
1784813,0,0,1,0,1
1784096,1,0,0,0,1
1781401,1,0,0,0,1
1779599,1,0,0,0,1
1777689,1,0,0,0,1
1776707,1,0,0,0,1
1774431,1,0,0,0,1
1767228,0,0,1,0,1
1767221,0,0,1,0,1
2248897,1,0,0,0,1
2250865,1,0,0,0,1
2251176,0,0,1,0,1
2587806,1,0,0,0,1
2599473,1,0,0,0,1
2598844,1,0,0,0,1
2597207,1,0,0,0,1
2596736,1,0,0,0,1
2593223,1,0,0,0,1
2590864,1,0,0,0,1
2590006,1,0,0,0,1
2589215,0,0,1,0,1
2588147,1,0,0,0,1
2587748,1,0,0,0,1
2574452,0,0,1,0,1
2584324,1,0,0,0,1
2583234,1,0,0,0,1
2582890,0,0,1,0,1
2582762,1,0,0,0,1
2582224,1,0,0,0,1
2580352,1,0,0,0,1
2578638,1,0,0,0,1
2577135,1,0,0,0,1
2575895,1,0,0,0,1
2599664,1,0,0,0,1
2600116,1,0,0,0,1
2605064,1,0,0,0,1
2608356,1,0,0,0,1
2638379,1,0,0,0,1
2637874,1,0,0,0,1
2635819,0,0,1,0,1
2631348,1,0,0,0,1
2630510,1,0,0,0,1
2629017,1,0,0,0,1
2628810,1,0,0,0,1
2628742,1,0,0,0,1
2628354,1,0,0,0,1
2626535,0,0,1,0,1
2624554,0,0,1,0,1
2620162,1,0,0,0,1
2619307,1,0,0,0,1
2617418,1,0,0,0,1
2613671,1,0,0,0,1
2613455,0,0,1,0,1
2610706,1,0,0,0,1
2610233,1,0,0,0,1
2609535,1,0,0,0,1
2574806,1,0,0,0,1
2568690,1,0,0,0,1
2490963,0,0,1,0,1
2510744,1,0,0,0,1
2528671,1,0,0,0,1
2521848,1,0,0,0,1
2520559,1,0,0,0,1
2519631,1,0,0,0,1
2519491,0,0,1,0,1
2519289,1,0,0,0,1
2515274,1,0,0,0,1
2513294,1,0,0,0,1
2510754,0,0,1,0,1
2505262,1,0,0,0,1
2563284,1,0,0,0,1
2504825,1,0,0,0,1
2498724,1,0,0,0,1
2496464,1,0,0,0,1
2496299,1,0,0,0,1
2495483,0,0,1,0,1
2495361,1,0,0,0,1
2494666,0,0,1,0,1
2494204,1,0,0,0,1
2493847,0,0,1,0,1
2530670,1,0,0,0,1
2533026,1,0,0,0,1
2533934,1,0,0,0,1
2533991,1,0,0,0,1
2563199,1,0,0,0,1
2562882,1,0,0,0,1
2560891,1,0,0,0,1
2558534,1,0,0,0,1
2556219,1,0,0,0,1
2555556,1,0,0,0,1
2554853,1,0,0,0,1
2553182,1,0,0,0,1
2550683,0,0,1,0,1
2548258,1,0,0,0,1
2546941,0,0,1,0,1
2545448,0,0,1,0,1
2544216,1,0,0,0,1
2543955,1,0,0,0,1
2543296,1,0,0,0,1
2542371,1,0,0,0,1
2540010,1,0,0,0,1
2538522,1,0,0,0,1
2537749,0,0,1,0,1
2639910,1,0,0,0,1
2640845,1,0,0,0,1
2640854,1,0,0,0,1
2733815,1,0,0,0,1
2740824,1,0,0,0,1
2739935,1,0,0,0,1
2739450,1,0,0,0,1
2739367,0,0,1,0,1
2738676,0,0,1,0,1
2738309,1,0,0,0,1
2737854,1,0,0,0,1
2737410,1,0,0,0,1
2737373,1,0,0,0,1
2731960,0,0,1,0,1
2640945,1,0,0,0,1
2729850,1,0,0,0,1
2727797,0,0,1,0,1
2723812,1,0,0,0,1
2723661,0,0,1,0,1
2723489,0,0,1,0,1
2717428,0,0,1,0,1
2716515,1,0,0,0,1
2715121,1,0,0,0,1
2715062,1,0,0,0,1
2742794,0,0,1,0,1
2742827,1,0,0,0,1
2742979,1,0,0,0,1
2743716,1,0,0,0,1
2777118,1,0,0,0,1
2776152,0,0,1,0,1
2775685,1,0,0,0,1
2775107,1,0,0,0,1
2772230,1,0,0,0,1
2770788,1,0,0,0,1
2768182,1,0,0,0,1
2765870,0,0,1,0,1
2764786,0,0,1,0,1
2762303,1,0,0,0,1
2761278,1,0,0,0,1
2761047,1,0,0,0,1
2757243,1,0,0,0,1
2756032,1,0,0,0,1
2753256,1,0,0,0,1
2750745,1,0,0,0,1
2749988,0,0,1,0,1
2749534,1,0,0,0,1
2748575,0,0,1,0,1
2714997,0,0,1,0,1
2714897,0,0,1,0,1
2714164,1,0,0,0,1
2681672,1,0,0,0,1
2675998,1,0,0,0,1
2674637,1,0,0,0,1
2671491,1,0,0,0,1
2670322,0,0,1,0,1
2665690,1,0,0,0,1
2665225,1,0,0,0,1
2664763,0,0,1,0,1
2657134,0,0,1,0,1
2655287,1,0,0,0,1
2654865,1,0,0,0,1
2653648,1,0,0,0,1
2653156,1,0,0,0,1
2648341,1,0,0,0,1
2647893,1,0,0,0,1
2645592,0,0,1,0,1
2644519,1,0,0,0,1
2642222,1,0,0,0,1
2642103,1,0,0,0,1
2641574,1,0,0,0,1
2681144,1,0,0,0,1
2681756,1,0,0,0,1
2711820,0,0,1,0,1
2681924,1,0,0,0,1
2708284,0,0,1,0,1
2707299,1,0,0,0,1
2706505,0,0,1,0,1
2702777,0,0,1,0,1
2702563,1,0,0,0,1
2701094,1,0,0,0,1
2697468,0,0,1,0,1
2694253,0,0,1,0,1
2694183,1,0,0,0,1
2688409,0,0,1,0,1
2688383,1,0,0,0,1
2687435,1,0,0,0,1
2687071,1,0,0,0,1
2685965,0,0,1,0,1
2685910,0,0,1,0,1
2685753,0,0,1,0,1
2685092,1,0,0,0,1
2682735,1,0,0,0,1
2682346,1,0,0,0,1
2492533,1,0,0,0,1
2490915,0,0,1,0,1
2252261,1,0,0,0,1
2321321,0,0,0,1,1
2333304,1,0,0,0,1
2330750,0,0,1,0,1
2329909,1,0,0,0,1
2327106,1,0,0,0,1
2323652,1,0,0,0,1
2321877,1,0,0,0,1
2321870,0,0,1,0,1
2321783,1,0,0,0,1
2321360,1,0,0,0,1
2318452,1,0,0,0,1
2300366,1,0,0,0,1
2316542,1,0,0,0,1
2315692,1,0,0,0,1
2312420,1,0,0,0,1
2311767,0,0,1,0,1
2311451,1,0,0,0,1
2308616,1,0,0,0,1
2308459,0,0,1,0,1
2306962,1,0,0,0,1
2303270,1,0,0,0,1
2333508,0,0,1,0,1
2334269,0,0,1,0,1
2334794,1,0,0,0,1
2335804,1,0,0,0,1
2360794,0,0,1,0,1
2360150,1,0,0,0,1
2359328,1,0,0,0,1
2358032,1,0,0,0,1
2351242,0,0,1,0,1
2350439,1,0,0,0,1
2350311,1,0,0,0,1
2350014,0,0,1,0,1
2349563,0,0,1,0,1
2348712,0,0,1,0,1
2347281,0,0,1,0,1
2347173,1,0,0,0,1
2344389,0,0,1,0,1
2343136,1,0,0,0,1
2340947,1,0,0,0,1
2340370,0,0,1,0,1
2339049,1,0,0,0,1
2338762,1,0,0,0,1
2336118,1,0,0,0,1
2301624,1,0,0,0,1
2300134,0,0,1,0,1
2489602,0,0,1,0,1
2260367,1,0,0,0,1
2269285,1,0,0,0,1
2268292,1,0,0,0,1
2267864,1,0,0,0,1
2267508,1,0,0,0,1
2265389,1,0,0,0,1
2265022,1,0,0,0,1
2263462,0,0,1,0,1
2262706,0,0,1,0,1
2261706,0,0,1,0,1
2260289,1,0,0,0,1
2298141,1,0,0,0,1
2259113,0,0,1,0,1
2259061,1,0,0,0,1
2258666,1,0,0,0,1
2257960,1,0,0,0,1
2257289,0,0,1,0,1
2257005,0,0,1,0,1
2256583,1,0,0,0,1
2252859,1,0,0,0,1
2252514,0,0,1,0,1
2269517,0,0,1,0,1
2269789,0,0,1,0,1
2270166,0,0,1,0,1
2270454,0,0,1,0,1
2297544,1,0,0,0,1
2294061,1,0,0,0,1
2293050,1,0,0,0,1
2291000,1,0,0,0,1
2290932,1,0,0,0,1
2286764,1,0,0,0,1
2286174,1,0,0,0,1
2285974,1,0,0,0,1
2284111,1,0,0,0,1
2282687,1,0,0,0,1
2282450,1,0,0,0,1
2282355,1,0,0,0,1
2278573,1,0,0,0,1
2277244,1,0,0,0,1
2276965,1,0,0,0,1
2275829,1,0,0,0,1
2275401,1,0,0,0,1
2274545,1,0,0,0,1
2273886,1,0,0,0,1
2363574,1,0,0,0,1
2363988,0,0,1,0,1
2363997,1,0,0,0,1
2448117,0,0,1,0,1
2455544,1,0,0,0,1
2455303,0,0,1,0,1
2455259,1,0,0,0,1
2455178,0,0,1,0,1
2452616,1,0,0,0,1
2450852,1,0,0,0,1
2450665,1,0,0,0,1
2449215,1,0,0,0,1
2448443,1,0,0,0,1
2446016,1,0,0,0,1
2368634,1,0,0,0,1
2443535,1,0,0,0,1
2442340,0,0,1,0,1
2440317,0,0,1,0,1
2438907,1,0,0,0,1
2438549,1,0,0,0,1
2438262,0,0,1,0,1
2436695,1,0,0,0,1
2436599,1,0,0,0,1
2436411,1,0,0,0,1
2455580,1,0,0,0,1
2455767,1,0,0,0,1
2458913,0,0,1,0,1
2462300,1,0,0,0,1
2487309,1,0,0,0,1
2485019,1,0,0,0,1
2484520,0,0,1,0,1
2483766,1,0,0,0,1
2483628,1,0,0,0,1
2483508,0,0,1,0,1
2483350,1,0,0,0,1
2483236,0,0,1,0,1
2482069,0,0,1,0,1
2478763,0,0,1,0,1
2478424,1,0,0,0,1
2474134,1,0,0,0,1
2473527,1,0,0,0,1
2472358,1,0,0,0,1
2470606,0,0,1,0,1
2470568,1,0,0,0,1
2469662,1,0,0,0,1
2466334,1,0,0,0,1
2463894,0,0,1,0,1
2435523,1,0,0,0,1
2435392,1,0,0,0,1
2429432,1,0,0,0,1
2396741,1,0,0,0,1
2394401,1,0,0,0,1
2393537,1,0,0,0,1
2390260,1,0,0,0,1
2389600,0,0,1,0,1
2388537,1,0,0,0,1
2388516,1,0,0,0,1
2384086,0,0,1,0,1
2383846,1,0,0,0,1
2383619,0,0,1,0,1
2376644,0,0,1,0,1
2375701,0,0,1,0,1
2374423,0,0,1,0,1
2374010,1,0,0,0,1
2373167,1,0,0,0,1
2373009,0,0,1,0,1
2371814,1,0,0,0,1
2371673,1,0,0,0,1
2370635,1,0,0,0,1
2368753,0,0,1,0,1
2394687,1,0,0,0,1
2397411,1,0,0,0,1
2427868,0,0,1,0,1
2399919,1,0,0,0,1
2426779,0,0,1,0,1
2424336,1,0,0,0,1
2424168,1,0,0,0,1
2424166,1,0,0,0,1
2423751,0,0,1,0,1
2423570,1,0,0,0,1
2423554,0,0,1,0,1
2423107,1,0,0,0,1
2423061,1,0,0,0,1
2423042,1,0,0,0,1
2416036,1,0,0,0,1
2413971,0,0,1,0,1
2407821,1,0,0,0,1
2405940,0,0,1,0,1
2405781,1,0,0,0,1
2401923,0,0,1,0,1
2401823,1,0,0,0,1
2401228,1,0,0,0,1
2401111,0,0,1,0,1
12989163,1,0,0,0,1
12996782,0,0,1,0,1
56142507,0,0,0,1,1
36562419,0,0,1,0,1
36613427,0,0,1,0,1
36585734,0,0,1,0,1
36581036,1,0,0,0,1
36579046,0,0,1,0,1
36578169,1,0,0,0,1
36575841,0,0,1,0,1
36575174,0,0,1,0,1
36573096,1,0,0,0,1
36564046,1,0,0,0,1
36560763,1,0,0,0,1
36477189,1,0,0,0,1
36546997,0,0,1,0,1
36540358,0,0,1,0,1
36539736,1,0,0,0,1
36538690,1,0,0,0,1
36531150,1,0,0,0,1
36530547,0,0,1,0,1
36522433,1,0,0,0,1
36510847,1,0,0,0,1
36481078,1,0,0,0,1
36614978,1,0,0,0,1
36634420,1,0,0,0,1
36636596,1,0,0,0,1
36640518,1,0,0,0,1
36798066,1,0,0,0,1
36792245,0,0,1,0,1
36791609,1,0,0,0,1
36754170,1,0,0,0,1
36753915,1,0,0,0,1
36753279,0,0,1,0,1
36726560,1,0,0,0,1
36722666,1,0,0,0,1
36719835,1,0,0,0,1
36713105,1,0,0,0,1
36708202,1,0,0,0,1
36678842,1,0,0,0,1
36673376,1,0,0,0,1
36669277,0,0,1,0,1
36663321,0,0,1,0,1
36651854,0,0,1,0,1
36650631,1,0,0,0,1
36644635,0,0,1,0,1
36640587,1,0,0,0,1
36478779,1,0,0,0,1
36450406,0,0,1,0,1
36815239,0,0,1,0,1
36238826,1,0,0,0,1
36293942,1,0,0,0,1
36285615,0,0,1,0,1
36283215,0,0,1,0,1
36279810,0,0,1,0,1
36279488,1,0,0,0,1
36278966,1,0,0,0,1
36268893,1,0,0,0,1
36264666,1,0,0,0,1
36242220,0,0,1,0,1
36237566,0,0,1,0,1
36450391,1,0,0,0,1
36234842,1,0,0,0,1
36232508,1,0,0,0,1
36227371,0,0,1,0,1
36213174,1,0,0,0,1
36208205,0,0,1,0,1
36207962,1,0,0,0,1
36199306,1,0,0,0,1
36176332,1,0,0,0,1
36176203,1,0,0,0,1
36306552,1,0,0,0,1
36309568,0,0,1,0,1
36311143,0,0,1,0,1
36323224,0,0,1,0,1
36449329,0,0,1,0,1
36444228,0,0,1,0,1
36441990,1,0,0,0,1
36438456,1,0,0,0,1
36434721,1,0,0,0,1
36425865,0,0,1,0,1
36413917,0,0,1,0,1
36393546,1,0,0,0,1
36391065,1,0,0,0,1
36388501,0,0,1,0,1
36387290,1,0,0,0,1
36382944,1,0,0,0,1
36381094,1,0,0,0,1
36380016,1,0,0,0,1
36369314,1,0,0,0,1
36356923,0,0,1,0,1
36356065,0,0,1,0,1
36342576,1,0,0,0,1
36333834,1,0,0,0,1
36800887,0,0,1,0,1
36816110,0,0,1,0,1
34642925,1,0,0,0,1
37240458,1,0,0,0,1
37275619,0,0,1,0,1
37274021,0,0,1,0,1
37266055,1,0,0,0,1
37254146,1,0,0,0,1
37252712,1,0,0,0,1
37252076,0,0,1,0,1
37245965,1,0,0,0,1
37243004,1,0,0,0,1
37241656,1,0,0,0,1
37236633,0,0,1,0,1
37163418,0,0,1,0,1
37221425,0,0,1,0,1
37212082,1,0,0,0,1
37191710,0,0,1,0,1
37191276,0,0,1,0,1
37188272,1,0,0,0,1
37186427,0,0,1,0,1
37184114,1,0,0,0,1
37181980,0,0,1,0,1
37170601,1,0,0,0,1
37282412,1,0,0,0,1
37286422,0,0,1,0,1
37291339,1,0,0,0,1
37301466,1,0,0,0,1
37440707,0,0,1,0,1
37435755,0,0,1,0,1
37424221,0,0,1,0,1
37419591,1,0,0,0,1
37413524,0,0,1,0,1
37410568,1,0,0,0,1
37402024,0,0,1,0,1
37384607,1,0,0,0,1
37376980,1,0,0,0,1
37375079,1,0,0,0,1
37362312,0,0,1,0,1
37360127,0,0,1,0,1
37337372,0,0,1,0,1
37331914,0,0,1,0,1
37328457,1,0,0,0,1
37325782,0,0,1,0,1
37318968,1,0,0,0,1
37313491,1,0,0,0,1
37311655,1,0,0,0,1
37166807,0,0,1,0,1
37149695,1,0,0,0,1
36817279,0,0,1,0,1
36905253,1,0,0,0,1
36980964,1,0,0,0,1
36966894,1,0,0,0,1
36960740,1,0,0,0,1
36959636,0,0,1,0,1
36953468,1,0,0,0,1
36948675,0,0,1,0,1
36926132,1,0,0,0,1
36907706,0,0,1,0,1
36905682,1,0,0,0,1
36903907,1,0,0,0,1
37138251,1,0,0,0,1
36894011,0,0,1,0,1
36889987,0,0,0,1,1
36885622,1,0,0,0,1
36884151,1,0,0,0,1
36881439,0,0,1,0,1
36866768,1,0,0,0,1
36861300,1,0,0,0,1
36821356,1,0,0,0,1
36818639,1,0,0,0,1
36988907,1,0,0,0,1
36998357,1,0,0,0,1
36998520,1,0,0,0,1
36999491,0,0,1,0,1
37138042,0,0,1,0,1
37126920,1,0,0,0,1
37101534,1,0,0,0,1
37097159,1,0,0,0,1
37095710,1,0,0,0,1
37093995,1,0,0,0,1
37093442,1,0,0,0,1
37091023,0,0,1,0,1
37088780,0,0,1,0,1
37084465,1,0,0,0,1
37084362,1,0,0,0,1
37078185,0,0,1,0,1
37076121,0,0,1,0,1
37072476,0,0,1,0,1
37069987,0,0,1,0,1
37038571,1,0,0,0,1
37014165,1,0,0,0,1
37001610,1,0,0,0,1
37001535,1,0,0,0,1
36170398,1,0,0,0,1
36167966,1,0,0,0,1
36166297,0,0,1,0,1
35083661,0,0,1,0,1
35129440,1,0,0,0,1
35127770,1,0,0,0,1
35127141,0,0,1,0,1
35108207,1,0,0,0,1
35103398,1,0,0,0,1
35103293,0,0,1,0,1
35102629,1,0,0,0,1
35095754,1,0,0,0,1
35093829,1,0,0,0,1
35076223,1,0,0,0,1
34950721,0,0,1,0,1
35075473,1,0,0,0,1
35043513,1,0,0,0,1
35032837,0,0,1,0,1
35031975,1,0,0,0,1
35013306,1,0,0,0,1
35005938,1,0,0,0,1
35000945,0,0,1,0,1
34999969,0,0,1,0,1
34988058,1,0,0,0,1
35144920,0,0,1,0,1
35156158,1,0,0,0,1
35166784,1,0,0,0,1
35179914,1,0,0,0,1
35381438,1,0,0,0,1
35380551,0,0,1,0,1
35362734,0,0,1,0,1
35336392,0,0,1,0,1
35335572,1,0,0,0,1
35329442,1,0,0,0,1
35328956,0,0,1,0,1
35320932,1,0,0,0,1
35313655,0,0,1,0,1
35307662,0,0,1,0,1
35302724,0,0,1,0,1
35299368,0,0,1,0,1
35288455,1,0,0,0,1
35287916,1,0,0,0,1
35285033,1,0,0,0,1
35253342,1,0,0,0,1
35251433,0,0,1,0,1
35251374,1,0,0,0,1
35209591,1,0,0,0,1
34957712,0,0,1,0,1
34939187,1,0,0,0,1
36166165,0,0,1,0,1
34745360,0,0,1,0,1
34789416,0,0,1,0,1
34782697,0,0,1,0,1
34780872,1,0,0,0,1
34773529,0,0,1,0,1
34760853,0,0,1,0,1
34758340,1,0,0,0,1
34758216,1,0,0,0,1
34755288,1,0,0,0,1
34745760,1,0,0,0,1
34743395,1,0,0,0,1
34934128,0,0,1,0,1
34740215,1,0,0,0,1
34734634,1,0,0,0,1
34708353,1,0,0,0,1
34698196,0,0,1,0,1
34692600,0,0,1,0,1
34691404,0,0,1,0,1
34685168,1,0,0,0,1
34676783,1,0,0,0,1
34655986,1,0,0,0,1
34790915,0,0,1,0,1
34796316,0,0,1,0,1
34813492,1,0,0,0,1
34815041,0,0,1,0,1
34930811,1,0,0,0,1
34924449,1,0,0,0,1
34915405,1,0,0,0,1
34914311,0,0,1,0,1
34911424,1,0,0,0,1
34907341,0,0,1,0,1
34901185,1,0,0,0,1
34899836,1,0,0,0,1
34876980,0,0,1,0,1
34873920,1,0,0,0,1
34867672,1,0,0,0,1
34866807,1,0,0,0,1
34866720,0,0,1,0,1
34864863,0,0,1,0,1
34861715,1,0,0,0,1
34841020,0,0,1,0,1
34828488,0,0,1,0,1
34824417,1,0,0,0,1
34823255,1,0,0,0,1
35387196,1,0,0,0,1
35390592,1,0,0,0,1
35407948,0,0,1,0,1
35902083,1,0,0,0,1
35959348,0,0,1,0,1
35958095,1,0,0,0,1
35928174,1,0,0,0,1
35921273,1,0,0,0,1
35919822,1,0,0,0,1
35914632,1,0,0,0,1
35914251,1,0,0,0,1
35905254,0,0,1,0,1
35902297,0,0,1,0,1
35897162,0,0,1,0,1
35417042,0,0,1,0,1
35891761,1,0,0,0,1
35888574,1,0,0,0,1
35878048,0,0,1,0,1
35877638,1,0,0,0,1
35874285,0,0,1,0,1
35857384,1,0,0,0,1
35837024,1,0,0,0,1
35834269,0,0,1,0,1
35829854,0,0,1,0,1
35959584,0,0,1,0,1
35964684,0,0,1,0,1
35986301,0,0,1,0,1
35994109,0,0,1,0,1
36143506,0,0,1,0,1
36138575,0,0,1,0,1
36133913,1,0,0,0,1
36119026,1,0,0,0,1
36089395,1,0,0,0,1
36080537,1,0,0,0,1
36072889,1,0,0,0,1
36072139,0,0,1,0,1
36057973,0,0,1,0,1
36055888,0,0,1,0,1
36054372,1,0,0,0,1
36052067,1,0,0,0,1
36029533,0,0,1,0,1
36012265,0,0,1,0,1
36008682,1,0,0,0,1
36006178,1,0,0,0,1
35997540,1,0,0,0,1
35997506,0,0,1,0,1
35996743,1,0,0,0,1
35819327,1,0,0,0,1
35798207,0,0,1,0,1
35786659,0,0,1,0,1
35539450,0,0,1,0,1
35529867,0,0,1,0,1
35525179,0,0,1,0,1
35524203,0,0,1,0,1
35520775,1,0,0,0,1
35518413,1,0,0,0,1
35509560,1,0,0,0,1
35491006,1,0,0,0,1
35489917,0,0,1,0,1
35488245,1,0,0,0,1
35477424,1,0,0,0,1
35476687,1,0,0,0,1
35476099,1,0,0,0,1
35474485,0,0,1,0,1
35474168,1,0,0,0,1
35468163,1,0,0,0,1
35435470,1,0,0,0,1
35430339,1,0,0,0,1
35429361,0,0,1,0,1
35426209,1,0,0,0,1
35539248,0,0,1,0,1
35558078,0,0,1,0,1
35761677,1,0,0,0,1
35581556,1,0,0,0,1
35737680,1,0,0,0,1
35726649,1,0,0,0,1
35722822,1,0,0,0,1
35703699,0,0,1,0,1
35699609,0,0,1,0,1
35671352,1,0,0,0,1
35667639,0,0,1,0,1
35664937,0,0,1,0,1
35662746,0,0,1,0,1
35651880,1,0,0,0,1
35651501,1,0,0,0,1
35648363,1,0,0,0,1
35634594,1,0,0,0,1
35634314,0,0,1,0,1
35620036,0,0,1,0,1
35594087,1,0,0,0,1
35590273,1,0,0,0,1
35590013,0,0,1,0,1
35586793,1,0,0,0,1
37442404,0,0,1,0,1
37453881,0,0,1,0,1
37483411,1,0,0,0,1
39916890,0,0,1,0,1
39977656,0,0,1,0,1
39961541,1,0,0,0,1
39945901,1,0,0,0,1
39942368,1,0,0,0,1
39940356,1,0,0,0,1
39939372,0,0,1,0,1
39938343,1,0,0,0,1
39922917,1,0,0,0,1
39918716,1,0,0,0,1
39915371,1,0,0,0,1
39765154,1,0,0,0,1
39908190,1,0,0,0,1
39880500,1,0,0,0,1
39878175,1,0,0,0,1
39870381,1,0,0,0,1
39863896,1,0,0,0,1
39828340,0,0,1,0,1
39823351,0,0,1,0,1
39782325,1,0,0,0,1
39772436,0,0,1,0,1
39977845,1,0,0,0,1
39978070,1,0,0,0,1
39978385,1,0,0,0,1
39981142,0,0,1,0,1
40140854,0,0,1,0,1
40134417,1,0,0,0,1
40130852,1,0,0,0,1
40125957,0,0,1,0,1
40120584,1,0,0,0,1
40086875,0,0,1,0,1
40072723,0,0,1,0,1
40069144,0,0,1,0,1
40068602,0,0,1,0,1
40058595,1,0,0,0,1
40044130,0,0,1,0,1
40041424,0,0,1,0,1
40040638,1,0,0,0,1
40037773,0,0,1,0,1
40027302,1,0,0,0,1
40025069,1,0,0,0,1
40023709,1,0,0,0,1
40010465,0,0,1,0,1
40004714,1,0,0,0,1
39768761,1,0,0,0,1
39750809,0,0,1,0,1
39291648,1,0,0,0,1
39472888,0,0,1,0,1
39539952,1,0,0,0,1
39539913,0,0,1,0,1
39534066,0,0,1,0,1
39531775,1,0,0,0,1
39523758,1,0,0,0,1
39503857,0,0,1,0,1
39483454,1,0,0,0,1
39480845,0,0,1,0,1
39477098,1,0,0,0,1
39456887,1,0,0,0,1
39726129,0,0,1,0,1
39449252,1,0,0,0,1
39438060,1,0,0,0,1
39389693,1,0,0,0,1
39346203,0,0,1,0,1
39335488,0,0,1,0,1
39333015,0,0,1,0,1
39329872,1,0,0,0,1
39329047,1,0,0,0,1
39305652,1,0,0,0,1
39541683,0,0,1,0,1
39541748,1,0,0,0,1
39548500,1,0,0,0,1
39549563,1,0,0,0,1
39726069,0,0,1,0,1
39725165,0,0,1,0,1
39706334,1,0,0,0,1
39694819,1,0,0,0,1
39668851,1,0,0,0,1
39655899,1,0,0,0,1
39652597,1,0,0,0,1
39644709,0,0,1,0,1
39640098,0,0,1,0,1
39639929,1,0,0,0,1
39635423,1,0,0,0,1
39628195,1,0,0,0,1
39615319,0,0,1,0,1
39608626,0,0,1,0,1
39603281,1,0,0,0,1
39601665,0,0,1,0,1
39599671,1,0,0,0,1
39556296,1,0,0,0,1
39549996,0,0,1,0,1
40146696,1,0,0,0,1
40146897,0,0,1,0,1
40151792,1,0,0,0,1
40709140,1,0,0,0,1
40820275,1,0,0,0,1
40812084,0,0,1,0,1
40805731,0,0,1,0,1
40800717,1,0,0,0,1
40800505,1,0,0,0,1
40761063,1,0,0,0,1
40742174,1,0,0,0,1
40741110,1,0,0,0,1
40721357,1,0,0,0,1
40707667,0,0,1,0,1
40157206,1,0,0,0,1
40695843,1,0,0,0,1
40693481,0,0,1,0,1
40684968,0,0,1,0,1
40645778,1,0,0,0,1
40643524,0,0,0,1,1
40642269,0,0,1,0,1
40640586,1,0,0,0,1
40634008,1,0,0,0,1
40627479,1,0,0,0,1
40826687,1,0,0,0,1
40830849,1,0,0,0,1
40863393,1,0,0,0,1
40871485,0,0,0,1,1
41079797,1,0,0,0,1
41067998,0,0,1,0,1
41062475,0,0,1,0,1
41060321,0,0,1,0,1
41046343,0,0,1,0,1
41044972,0,0,0,1,1
41007099,0,0,1,0,1
41003664,0,0,1,0,1
40995200,0,0,1,0,1
40984551,0,0,1,0,1
40939327,0,0,1,0,1
40929418,1,0,0,0,1
40912903,1,0,0,0,1
40907910,1,0,0,0,1
40905449,1,0,0,0,1
40895328,0,0,1,0,1
40891373,1,0,0,0,1
40883581,1,0,0,0,1
40880743,1,0,0,0,1
40619768,1,0,0,0,1
40611169,1,0,0,0,1
40605120,1,0,0,0,1
40398107,1,0,0,0,1
40395108,1,0,0,0,1
40394783,1,0,0,0,1
40336824,0,0,1,0,1
40319733,1,0,0,0,1
40306612,1,0,0,0,1
40277743,0,0,1,0,1
40244009,1,0,0,0,1
40242880,1,0,0,0,1
40238772,0,0,1,0,1
40237377,0,0,1,0,1
40237342,0,0,1,0,1
40232160,1,0,0,0,1
40231738,1,0,0,0,1
40223194,0,0,1,0,1
40218397,0,0,1,0,1
40204929,1,0,0,0,1
40204585,1,0,0,0,1
40160805,1,0,0,0,1
40160128,1,0,0,0,1
40396791,1,0,0,0,1
40404813,0,0,1,0,1
40591396,0,0,1,0,1
40427171,1,0,0,0,1
40580433,1,0,0,0,1
40552516,0,0,1,0,1
40539880,1,0,0,0,1
40534407,0,0,1,0,1
40532707,0,0,1,0,1
40527701,1,0,0,0,1
40516440,0,0,1,0,1
40511631,0,0,1,0,1
40510005,0,0,1,0,1
40509550,0,0,0,1,1
40507839,1,0,0,0,1
40503875,0,0,1,0,1
40501530,1,0,0,0,1
40498479,0,0,1,0,1
40482521,1,0,0,0,1
40480205,1,0,0,0,1
40443551,1,0,0,0,1
40439772,0,0,1,0,1
40428881,1,0,0,0,1
39298265,0,0,1,0,1
39288710,1,0,0,0,1
37489854,1,0,0,0,1
38121779,0,0,1,0,1
38256284,1,0,0,0,1
38250741,1,0,0,0,1
38250051,0,0,1,0,1
38179715,1,0,0,0,1
38179415,1,0,0,0,1
38169148,0,0,1,0,1
38162443,1,0,0,0,1
38140449,1,0,0,0,1
38127209,1,0,0,0,1
38120363,0,0,1,0,1
37978030,1,0,0,0,1
38119088,1,0,0,0,1
38116129,0,0,1,0,1
38093343,1,0,0,0,1
38073985,1,0,0,0,1
38064272,0,0,1,0,1
38038797,1,0,0,0,1
38017497,1,0,0,0,1
37995238,1,0,0,0,1
37993952,0,0,1,0,1
38257016,1,0,0,0,1
38257043,1,0,0,0,1
38260715,0,0,1,0,1
38263259,1,0,0,0,1
38395419,1,0,0,0,1
38392972,1,0,0,0,1
38392850,1,0,0,0,1
38391974,1,0,0,0,1
38388018,0,0,1,0,1
38378985,1,0,0,0,1
38363932,0,0,0,1,1
38363621,1,0,0,0,1
38360286,0,0,1,0,1
38359380,0,0,1,0,1
38353649,1,0,0,0,1
38352423,0,0,1,0,1
38350640,1,0,0,0,1
38322121,0,0,1,0,1
38297695,1,0,0,0,1
38294553,1,0,0,0,1
38294027,1,0,0,0,1
38284667,1,0,0,0,1
38284609,0,0,1,0,1
37984527,1,0,0,0,1
37973669,1,0,0,0,1
39275815,1,0,0,0,1
37614545,0,0,1,0,1
37697640,1,0,0,0,1
37691482,1,0,0,0,1
37687663,0,0,1,0,1
37684272,0,0,1,0,1
37682130,0,0,1,0,1
37676608,1,0,0,0,1
37670256,1,0,0,0,1
37647538,1,0,0,0,1
37627534,0,0,1,0,1
37607383,0,0,1,0,1
37932285,0,0,1,0,1
37580284,1,0,0,0,1
37568440,0,0,1,0,1
37565381,1,0,0,0,1
37549393,1,0,0,0,1
37529115,1,0,0,0,1
37521233,0,0,1,0,1
37512618,1,0,0,0,1
37510066,1,0,0,0,1
37503617,1,0,0,0,1
37704874,0,0,1,0,1
37711914,1,0,0,0,1
37720533,0,0,1,0,1
37728157,1,0,0,0,1
37909396,0,0,1,0,1
37904263,1,0,0,0,1
37904015,0,0,1,0,1
37903935,0,0,1,0,1
37880566,1,0,0,0,1
37875894,0,0,1,0,1
37870902,1,0,0,0,1
37847510,0,0,1,0,1
37842947,0,0,1,0,1
37809789,1,0,0,0,1
37806185,0,0,0,1,1
37803660,1,0,0,0,1
37801911,1,0,0,0,1
37798237,0,0,1,0,1
37793159,1,0,0,0,1
37771318,1,0,0,0,1
37750296,1,0,0,0,1
37740031,1,0,0,0,1
37736307,0,0,1,0,1
38403770,1,0,0,0,1
38445572,0,0,1,0,1
38452274,1,0,0,0,1
39023795,1,0,0,0,1
39074591,0,0,1,0,1
39072477,0,0,1,0,1
39069377,1,0,0,0,1
39066993,0,0,1,0,1
39060578,1,0,0,0,1
39055365,0,0,1,0,1
39052053,1,0,0,0,1
39047190,1,0,0,0,1
39039509,1,0,0,0,1
38984746,1,0,0,0,1
38457889,0,0,1,0,1
38969811,0,0,1,0,1
38946305,0,0,1,0,1
38915391,1,0,0,0,1
38902136,1,0,0,0,1
38877452,0,0,1,0,1
38864859,1,0,0,0,1
38863621,0,0,1,0,1
38857566,0,0,1,0,1
38850266,1,0,0,0,1
39084892,1,0,0,0,1
39085295,1,0,0,0,1
39123185,0,0,1,0,1
39126862,1,0,0,0,1
39261381,0,0,1,0,1
39253607,1,0,0,0,1
39249461,0,0,1,0,1
39241960,0,0,1,0,1
39226206,1,0,0,0,1
39212192,0,0,1,0,1
39192815,1,0,0,0,1
39190931,1,0,0,0,1
39186813,0,0,1,0,1
39177865,1,0,0,0,1
39174588,0,0,1,0,1
39161138,1,0,0,0,1
39158104,0,0,1,0,1
39150374,0,0,1,0,1
39149459,1,0,0,0,1
39147880,1,0,0,0,1
39143718,1,0,0,0,1
39142433,1,0,0,0,1
39136040,0,0,1,0,1
38844508,1,0,0,0,1
38837666,1,0,0,0,1
38827405,0,0,1,0,1
38670785,0,0,1,0,1
38650653,1,0,0,0,1
38645516,1,0,0,0,1
38638199,0,0,1,0,1
38635971,0,0,1,0,1
38615080,0,0,1,0,1
38607397,0,0,1,0,1
38599690,0,0,1,0,1
38585625,1,0,0,0,1
38580398,1,0,0,0,1
38579823,0,0,1,0,1
38569616,1,0,0,0,1
38555920,1,0,0,0,1
38515690,1,0,0,0,1
38503320,0,0,1,0,1
38500630,1,0,0,0,1
38497438,1,0,0,0,1
38480982,1,0,0,0,1
38473130,1,0,0,0,1
38465372,1,0,0,0,1
38655309,1,0,0,0,1
38672291,0,0,1,0,1
38801257,0,0,1,0,1
38672932,1,0,0,0,1
38794144,0,0,1,0,1
38790056,1,0,0,0,1
38788236,1,0,0,0,1
38786890,1,0,0,0,1
38774068,1,0,0,0,1
38762515,1,0,0,0,1
38759330,0,0,1,0,1
38757107,1,0,0,0,1
38741040,0,0,1,0,1
38738475,1,0,0,0,1
38713773,0,0,1,0,1
38708976,1,0,0,0,1
38702813,0,0,1,0,1
38697590,1,0,0,0,1
38690873,1,0,0,0,1
38681422,1,0,0,0,1
38681372,1,0,0,0,1
38679669,0,0,1,0,1
38678875,0,0,1,0,1
34654571,1,0,0,0,1
34642159,1,0,0,0,1
41084247,1,0,0,0,1
30660336,0,0,1,0,1
30730392,1,0,0,0,1
30728749,0,0,1,0,1
30727828,0,0,1,0,1
30708411,1,0,0,0,1
30704814,1,0,0,0,1
30698503,0,0,1,0,1
30671396,1,0,0,0,1
30669247,1,0,0,0,1
30667773,0,0,1,0,1
30658746,0,0,1,0,1
30554088,1,0,0,0,1
30654905,1,0,0,0,1
30643058,1,0,0,0,1
30634931,1,0,0,0,1
30613046,0,0,1,0,1
30611802,0,0,1,0,1
30606207,0,0,1,0,1
30593595,1,0,0,0,1
30591049,0,0,1,0,1
30588612,0,0,1,0,1
30733725,1,0,0,0,1
30735525,0,0,1,0,1
30738895,0,0,1,0,1
30739576,1,0,0,0,1
30995747,1,0,0,0,1
30988026,1,0,0,0,1
30918671,0,0,1,0,1
30916064,0,0,1,0,1
30911020,1,0,0,0,1
30909882,1,0,0,0,1
30909338,1,0,0,0,1
30884023,1,0,0,0,1
30849492,1,0,0,0,1
30826993,1,0,0,0,1
30824695,0,0,1,0,1
30812813,1,0,0,0,1
30808123,0,0,1,0,1
30805991,1,0,0,0,1
30801515,1,0,0,0,1
30777013,1,0,0,0,1
30775529,0,0,1,0,1
30770358,0,0,1,0,1
30768511,1,0,0,0,1
30576651,0,0,1,0,1
30549225,0,0,1,0,1
31019553,1,0,0,0,1
30240636,1,0,0,0,1
30312537,0,0,1,0,1
30312382,1,0,0,0,1
30301198,1,0,0,0,1
30280316,0,0,1,0,1
30277418,1,0,0,0,1
30272105,1,0,0,0,1
30267389,0,0,1,0,1
30247185,1,0,0,0,1
30240946,0,0,1,0,1
30229638,1,0,0,0,1
30545042,0,0,1,0,1
30227707,0,0,1,0,1
30224326,1,0,0,0,1
30224269,1,0,0,0,1
30223355,1,0,0,0,1
30219814,1,0,0,0,1
30214562,1,0,0,0,1
30214212,1,0,0,0,1
30208406,1,0,0,0,1
30185313,1,0,0,0,1
30320622,0,0,1,0,1
30347426,1,0,0,0,1
30347639,1,0,0,0,1
30351086,1,0,0,0,1
30541205,0,0,1,0,1
30501498,0,0,1,0,1
30494687,0,0,1,0,1
30494262,0,0,1,0,1
30476503,1,0,0,0,1
30475154,1,0,0,0,1
30461967,1,0,0,0,1
30448028,1,0,0,0,1
30445086,1,0,0,0,1
30436731,1,0,0,0,1
30426158,1,0,0,0,1
30424811,1,0,0,0,1
30418939,1,0,0,0,1
30384092,1,0,0,0,1
30380500,1,0,0,0,1
30379314,0,0,1,0,1
30357478,0,0,1,0,1
30354475,1,0,0,0,1
30354449,1,0,0,0,1
30995829,0,0,1,0,1
31021293,0,0,1,0,1
34614054,0,0,0,1,1
31487349,1,0,0,0,1
31557132,1,0,0,0,1
31555753,0,0,1,0,1
31553738,0,0,1,0,1
31537314,1,0,0,0,1
31524577,0,0,1,0,1
31522757,1,0,0,0,1
31502455,0,0,1,0,1
31500454,1,0,0,0,1
31489150,1,0,0,0,1
31483029,1,0,0,0,1
31411094,1,0,0,0,1
31482341,0,0,1,0,1
31481921,1,0,0,0,1
31473824,1,0,0,0,1
31471563,1,0,0,0,1
31460662,0,0,0,1,1
31458100,0,0,1,0,1
31452390,0,0,1,0,1
31431421,1,0,0,0,1
31429931,0,0,1,0,1
31583052,1,0,0,0,1
31589149,0,0,1,0,1
31594375,0,0,1,0,1
31594857,0,0,1,0,1
31685194,0,0,1,0,1
31683042,0,0,0,1,1
31678869,0,0,1,0,1
31668272,1,0,0,0,1
31666407,0,0,1,0,1
31665926,0,0,1,0,1
31658722,0,0,1,0,1
31651673,0,0,1,0,1
31650939,1,0,0,0,1
31641659,1,0,0,0,1
31629890,1,0,0,0,1
31628863,0,0,1,0,1
31619241,0,0,1,0,1
31618700,0,0,1,0,1
31617949,1,0,0,0,1
31614694,1,0,0,0,1
31612339,1,0,0,0,1
31609967,1,0,0,0,1
31598220,0,0,1,0,1
31425596,1,0,0,0,1
31410976,1,0,0,0,1
31032957,0,0,1,0,1
31157531,0,0,1,0,1
31214940,1,0,0,0,1
31213925,1,0,0,0,1
31205165,1,0,0,0,1
31204913,0,0,1,0,1
31204745,1,0,0,0,1
31177258,1,0,0,0,1
31176490,0,0,1,0,1
31175385,1,0,0,0,1
31172289,0,0,1,0,1
31155644,1,0,0,0,1
31410393,0,0,1,0,1
31155262,0,0,1,0,1
31154454,0,0,1,0,1
31153462,1,0,0,0,1
31150792,1,0,0,0,1
31147528,0,0,1,0,1
31147377,1,0,0,0,1
31140577,1,0,0,0,1
31097883,1,0,0,0,1
31039254,0,0,1,0,1
31222791,1,0,0,0,1
31239845,1,0,0,0,1
31244515,1,0,0,0,1
31245355,1,0,0,0,1
31405259,0,0,1,0,1
31389734,1,0,0,0,1
31376006,0,0,1,0,1
31373840,0,0,1,0,1
31367619,0,0,1,0,1
31305991,0,0,1,0,1
31298029,0,0,1,0,1
31291159,0,0,1,0,1
31289942,1,0,0,0,1
31287099,1,0,0,0,1
31283971,0,0,1,0,1
31280252,1,0,0,0,1
31277514,1,0,0,0,1
31260008,1,0,0,0,1
31252117,0,0,1,0,1
31250542,1,0,0,0,1
31248442,1,0,0,0,1
31245915,1,0,0,0,1
31245408,0,0,1,0,1
30177875,1,0,0,0,1
30167099,1,0,0,0,1
30122420,0,0,1,0,1
29170051,0,0,1,0,1
29279330,1,0,0,0,1
29268760,0,0,1,0,1
29248621,0,0,1,0,1
29240443,1,0,0,0,1
29238030,0,0,1,0,1
29235148,0,0,1,0,1
29231871,0,0,1,0,1
29217011,0,0,1,0,1
29176423,1,0,0,0,1
29161738,0,0,1,0,1
29057249,0,0,1,0,1
29144304,1,0,0,0,1
29131657,1,0,0,0,1
29121672,1,0,0,0,1
29113977,1,0,0,0,1
29111960,0,0,1,0,1
29111684,0,0,1,0,1
29111260,0,0,1,0,1
29106164,0,0,1,0,1
29074849,0,0,1,0,1
29279378,1,0,0,0,1
29310877,1,0,0,0,1
29314677,0,0,1,0,1
29317213,1,0,0,0,1
29456424,1,0,0,0,1
29452212,1,0,0,0,1
29452204,1,0,0,0,1
29452152,1,0,0,0,1
29417940,1,0,0,0,1
29417590,0,0,1,0,1
29413554,1,0,0,0,1
29412145,0,0,1,0,1
29408218,0,0,1,0,1
29388574,1,0,0,0,1
29387731,1,0,0,0,1
29354052,0,0,1,0,1
29346825,0,0,1,0,1
29344465,1,0,0,0,1
29342746,0,0,1,0,1
29338009,1,0,0,0,1
29334963,1,0,0,0,1
29326392,0,0,1,0,1
29325684,0,0,1,0,1
29065752,1,0,0,0,1
29050715,1,0,0,0,1
30120135,1,0,0,0,1
28770493,1,0,0,0,1
28813132,0,0,1,0,1
28811902,1,0,0,0,1
28809821,0,0,0,1,1
28801224,1,0,0,0,1
28787513,1,0,0,0,1
28786801,0,0,1,0,1
28781526,1,0,0,0,1
28779108,1,0,0,0,1
28774044,1,0,0,0,1
28764867,1,0,0,0,1
29035593,1,0,0,0,1
28752891,0,0,1,0,1
28749352,1,0,0,0,1
28745989,1,0,0,0,1
28740462,0,0,1,0,1
28723229,0,0,1,0,1
28723165,0,0,1,0,1
28722598,1,0,0,0,1
28720717,1,0,0,0,1
28711190,0,0,1,0,1
28821748,0,0,1,0,1
28822278,1,0,0,0,1
28825500,0,0,1,0,1
28827640,1,0,0,0,1
29032861,1,0,0,0,1
29005043,0,0,1,0,1
29003640,1,0,0,0,1
28992997,0,0,1,0,1
28988568,1,0,0,0,1
28984530,1,0,0,0,1
28982848,1,0,0,0,1
28980092,0,0,1,0,1
28940517,0,0,1,0,1
28917123,1,0,0,0,1
28915396,1,0,0,0,1
28895303,0,0,1,0,1
28868609,0,0,0,1,1
28858522,0,0,1,0,1
28846474,0,0,1,0,1
28840768,1,0,0,0,1
28840396,0,0,1,0,1
28840058,0,0,1,0,1
28836096,0,0,1,0,1
29464755,0,0,1,0,1
29466025,1,0,0,0,1
29470566,0,0,1,0,1
29874427,1,0,0,0,1
29936265,1,0,0,0,1
29926901,1,0,0,0,1
29923547,0,0,1,0,1
29900881,1,0,0,0,1
29893120,0,0,1,0,1
29891117,1,0,0,0,1
29883522,0,0,1,0,1
29882817,0,0,1,0,1
29879873,1,0,0,0,1
29871437,0,0,1,0,1
29476718,1,0,0,0,1
29867161,0,0,1,0,1
29857291,0,0,1,0,1
29854797,1,0,0,0,1
29854689,0,0,1,0,1
29831344,1,0,0,0,1
29828037,1,0,0,0,1
29824461,0,0,1,0,1
29823680,1,0,0,0,1
29821368,1,0,0,0,1
29936494,1,0,0,0,1
29941723,0,0,1,0,1
29950960,0,0,1,0,1
29953329,1,0,0,0,1
30116728,1,0,0,0,1
30116009,1,0,0,0,1
30112106,0,0,1,0,1
30097523,1,0,0,0,1
30077950,1,0,0,0,1
30066784,0,0,1,0,1
30066276,0,0,1,0,1
30063582,0,0,1,0,1
30050649,1,0,0,0,1
30046603,1,0,0,0,1
30021924,0,0,1,0,1
30007302,0,0,1,0,1
30001439,1,0,0,0,1
29999716,1,0,0,0,1
29997245,1,0,0,0,1
29990425,1,0,0,0,1
29988752,0,0,1,0,1
29967368,1,0,0,0,1
29959914,0,0,1,0,1
29810614,1,0,0,0,1
29792577,0,0,1,0,1
29790457,1,0,0,0,1
29590865,1,0,0,0,1
29584774,1,0,0,0,1
29583716,1,0,0,0,1
29577190,1,0,0,0,1
29574418,1,0,0,0,1
29571112,1,0,0,0,1
29563688,1,0,0,0,1
29544115,0,0,1,0,1
29539922,1,0,0,0,1
29537636,1,0,0,0,1
29531913,1,0,0,0,1
29528182,0,0,1,0,1
29528165,1,0,0,0,1
29518961,1,0,0,0,1
29513279,0,0,1,0,1
29510483,0,0,1,0,1
29505367,1,0,0,0,1
29499028,0,0,1,0,1
29497388,1,0,0,0,1
29480685,1,0,0,0,1
29590110,1,0,0,0,1
29594719,1,0,0,0,1
29788934,1,0,0,0,1
29599415,0,0,1,0,1
29766266,1,0,0,0,1
29741970,0,0,1,0,1
29721928,1,0,0,0,1
29707420,1,0,0,0,1
29702921,0,0,1,0,1
29700603,1,0,0,0,1
29693386,0,0,1,0,1
29690423,1,0,0,0,1
29683852,1,0,0,0,1
29665527,1,0,0,0,1
29664627,1,0,0,0,1
29658310,1,0,0,0,1
29651191,1,0,0,0,1
29651137,1,0,0,0,1
29642992,0,0,1,0,1
29637230,1,0,0,0,1
29628369,1,0,0,0,1
29621848,1,0,0,0,1
29599980,1,0,0,0,1
31697949,0,0,1,0,1
31698014,1,0,0,0,1
31719788,0,0,1,0,1
33680384,1,0,0,0,1
33746505,0,0,1,0,1
33741028,0,0,1,0,1
33739627,0,0,1,0,1
33722691,1,0,0,0,1
33701866,1,0,0,0,1
33695224,0,0,1,0,1
33684730,1,0,0,0,1
33683538,1,0,0,0,1
33681829,1,0,0,0,1
33680030,1,0,0,0,1
33611370,1,0,0,0,1
33677512,0,0,1,0,1
33667014,0,0,1,0,1
33660636,1,0,0,0,1
33656228,1,0,0,0,1
33649887,1,0,0,0,1
33640698,1,0,0,0,1
33620899,1,0,0,0,1
33616515,0,0,1,0,1
33616159,0,0,1,0,1
33750239,0,0,1,0,1
33776302,1,0,0,0,1
33780262,1,0,0,0,1
33782746,1,0,0,0,1
33889947,1,0,0,0,1
33876689,0,0,1,0,1
33861246,1,0,0,0,1
33854837,0,0,1,0,1
33836993,0,0,1,0,1
33834627,1,0,0,0,1
33832598,1,0,0,0,1
33827790,1,0,0,0,1
33825321,1,0,0,0,1
33822427,1,0,0,0,1
33821265,0,0,1,0,1
33817836,0,0,1,0,1
33816358,1,0,0,0,1
33803881,1,0,0,0,1
33788184,0,0,1,0,1
33787022,1,0,0,0,1
33786372,1,0,0,0,1
33783958,1,0,0,0,1
33782884,0,0,1,0,1
33614329,1,0,0,0,1
33605216,0,0,1,0,1
33231070,1,0,0,0,1
33377685,1,0,0,0,1
33396510,1,0,0,0,1
33395500,0,0,1,0,1
33394459,1,0,0,0,1
33391501,0,0,1,0,1
33386679,0,0,1,0,1
33386619,1,0,0,0,1
33386258,0,0,1,0,1
33386194,0,0,1,0,1
33383915,1,0,0,0,1
33365473,1,0,0,0,1
33593407,1,0,0,0,1
33363604,0,0,1,0,1
33362434,0,0,1,0,1
33357856,1,0,0,0,1
33326232,0,0,1,0,1
33299125,1,0,0,0,1
33294012,1,0,0,0,1
33283726,1,0,0,0,1
33279657,1,0,0,0,1
33273074,1,0,0,0,1
33401596,1,0,0,0,1
33420052,1,0,0,0,1
33426004,1,0,0,0,1
33436431,1,0,0,0,1
33592161,1,0,0,0,1
33588156,0,0,1,0,1
33587458,1,0,0,0,1
33555400,1,0,0,0,1
33535733,0,0,1,0,1
33532865,1,0,0,0,1
33529126,1,0,0,0,1
33526253,1,0,0,0,1
33519200,0,0,1,0,1
33513998,0,0,1,0,1
33499491,1,0,0,0,1
33499326,0,0,1,0,1
33480709,0,0,0,1,1
33472611,1,0,0,0,1
33470925,1,0,0,0,1
33464426,0,0,1,0,1
33452526,1,0,0,0,1
33449936,0,0,1,0,1
33438197,1,0,0,0,1
33902900,0,0,1,0,1
33908393,1,0,0,0,1
33924547,0,0,1,0,1
34320483,0,0,1,0,1
34371968,1,0,0,0,1
34361146,1,0,0,0,1
34360053,0,0,1,0,1
34358062,1,0,0,0,1
34351646,1,0,0,0,1
34351124,0,0,1,0,1
34343792,1,0,0,0,1
34325962,1,0,0,0,1
34322330,1,0,0,0,1
34308537,0,0,1,0,1
33926722,1,0,0,0,1
34304490,1,0,0,0,1
34281260,0,0,1,0,1
34276823,1,0,0,0,1
34269923,0,0,1,0,1
34268824,1,0,0,0,1
34262042,1,0,0,0,1
34241368,1,0,0,0,1
34238426,0,0,1,0,1
34233009,1,0,0,0,1
34386255,0,0,1,0,1
34387513,0,0,1,0,1
34389449,1,0,0,0,1
34397256,0,0,1,0,1
34607505,1,0,0,0,1
34598519,1,0,0,0,1
34590955,1,0,0,0,1
34578795,0,0,1,0,1
34556363,1,0,0,0,1
34547856,0,0,1,0,1
34546087,0,0,1,0,1
34514781,0,0,1,0,1
34508000,0,0,1,0,1
34507633,0,0,1,0,1
34468564,1,0,0,0,1
34468399,1,0,0,0,1
34466355,1,0,0,0,1
34453577,1,0,0,0,1
34426902,1,0,0,0,1
34404823,0,0,1,0,1
34404232,0,0,1,0,1
34398769,1,0,0,0,1
34397375,1,0,0,0,1
34232055,0,0,1,0,1
34226735,0,0,1,0,1
34203575,0,0,1,0,1
34014150,1,0,0,0,1
34010790,0,0,1,0,1
34009194,1,0,0,0,1
34000566,1,0,0,0,1
33998591,1,0,0,0,1
33992697,0,0,1,0,1
33990883,1,0,0,0,1
33983182,0,0,1,0,1
33978706,1,0,0,0,1
33975064,1,0,0,0,1
33970775,1,0,0,0,1
33950089,0,0,1,0,1
33949788,1,0,0,0,1
33945670,1,0,0,0,1
33943711,1,0,0,0,1
33941066,1,0,0,0,1
33936693,1,0,0,0,1
33936240,0,0,1,0,1
33931962,1,0,0,0,1
33929905,1,0,0,0,1
34013546,1,0,0,0,1
34021565,0,0,1,0,1
34202667,0,0,1,0,1
34031938,1,0,0,0,1
34201688,1,0,0,0,1
34174768,1,0,0,0,1
34149113,0,0,1,0,1
34143258,1,0,0,0,1
34142729,0,0,1,0,1
34142649,1,0,0,0,1
34119511,0,0,1,0,1
34118225,1,0,0,0,1
34110700,0,0,1,0,1
34110353,1,0,0,0,1
34075689,1,0,0,0,1
34075048,1,0,0,0,1
34066586,0,0,1,0,1
34060722,1,0,0,0,1
34058193,1,0,0,0,1
34052554,1,0,0,0,1
34049419,1,0,0,0,1
34040597,1,0,0,0,1
34035977,1,0,0,0,1
33252152,0,0,1,0,1
33221352,1,0,0,0,1
31762883,0,0,1,0,1
32162846,1,0,0,0,1
32237643,1,0,0,0,1
32220274,1,0,0,0,1
32207621,0,0,1,0,1
32203986,1,0,0,0,1
32201215,1,0,0,0,1
32197200,1,0,0,0,1
32193665,1,0,0,0,1
32173907,0,0,1,0,1
32166735,1,0,0,0,1
32159799,1,0,0,0,1
32092125,0,0,1,0,1
32158960,0,0,1,0,1
32142173,0,0,1,0,1
32135311,1,0,0,0,1
32133182,1,0,0,0,1
32130349,0,0,1,0,1
32126880,1,0,0,0,1
32124747,1,0,0,0,1
32117091,1,0,0,0,1
32110549,0,0,1,0,1
32252422,1,0,0,0,1
32279718,1,0,0,0,1
32291797,1,0,0,0,1
32298504,1,0,0,0,1
32525636,1,0,0,0,1
32524198,0,0,1,0,1
32503657,1,0,0,0,1
32479008,1,0,0,0,1
32434287,0,0,1,0,1
32418402,0,0,1,0,1
32406934,0,0,1,0,1
32383664,0,0,1,0,1
32377076,1,0,0,0,1
32361189,1,0,0,0,1
32357900,0,0,1,0,1
32355256,1,0,0,0,1
32345243,0,0,1,0,1
32340523,1,0,0,0,1
32336980,1,0,0,0,1
32309813,0,0,1,0,1
32306916,0,0,1,0,1
32305413,0,0,1,0,1
32299529,1,0,0,0,1
32102410,1,0,0,0,1
32087888,1,0,0,0,1
33212205,1,0,0,0,1
31856478,1,0,0,0,1
31880074,1,0,0,0,1
31879356,1,0,0,0,1
31877774,1,0,0,0,1
31876574,0,0,1,0,1
31876151,1,0,0,0,1
31876150,1,0,0,0,1
31861574,0,0,1,0,1
31860430,0,0,1,0,1
31856684,1,0,0,0,1
31825530,1,0,0,0,1
32052979,0,0,1,0,1
31825476,1,0,0,0,1
31817441,0,0,1,0,1
31816060,0,0,1,0,1
31814602,1,0,0,0,1
31799541,0,0,1,0,1
31796537,0,0,1,0,1
31789510,1,0,0,0,1
31788137,1,0,0,0,1
31765814,0,0,1,0,1
31880119,1,0,0,0,1
31882405,1,0,0,0,1
31883653,1,0,0,0,1
31889552,1,0,0,0,1
32052000,1,0,0,0,1
32020027,1,0,0,0,1
32011239,1,0,0,0,1
32006887,0,0,1,0,1
32004384,0,0,1,0,1
32001723,0,0,0,1,1
31997128,1,0,0,0,1
31980952,0,0,1,0,1
31944119,1,0,0,0,1
31937844,1,0,0,0,1
31925547,1,0,0,0,1
31921385,0,0,0,1,1
31919152,0,0,1,0,1
31917161,0,0,1,0,1
31915917,1,0,0,0,1
31914305,0,0,1,0,1
31907981,0,0,1,0,1
31906445,1,0,0,0,1
31902179,1,0,0,0,1
32525834,1,0,0,0,1
32532169,0,0,1,0,1
32538641,1,0,0,0,1
33000709,1,0,0,0,1
33068490,0,0,1,0,1
33067672,1,0,0,0,1
33064750,1,0,0,0,1
33064443,0,0,1,0,1
33063310,0,0,1,0,1
33060882,0,0,1,0,1
33049782,0,0,1,0,1
33037772,0,0,1,0,1
33021531,0,0,1,0,1
32998125,1,0,0,0,1
32540806,1,0,0,0,1
32993860,0,0,1,0,1
32981949,1,0,0,0,1
32975805,1,0,0,0,1
32974295,1,0,0,0,1
32972178,1,0,0,0,1
32971323,0,0,1,0,1
32970856,0,0,1,0,1
32958503,1,0,0,0,1
32946808,1,0,0,0,1
33068587,0,0,1,0,1
33069397,0,0,1,0,1
33069475,1,0,0,0,1
33070038,1,0,0,0,1
33211768,1,0,0,0,1
33205064,0,0,0,1,1
33204787,0,0,1,0,1
33200665,1,0,0,0,1
33198779,0,0,1,0,1
33198084,0,0,1,0,1
33191046,1,0,0,0,1
33189147,1,0,0,0,1
33167995,0,0,1,0,1
33163646,1,0,0,0,1
33159631,1,0,0,0,1
33159253,1,0,0,0,1
33149697,0,0,1,0,1
33134899,0,0,1,0,1
33128992,0,0,1,0,1
33128396,1,0,0,0,1
33126358,0,0,1,0,1
33120658,1,0,0,0,1
33070890,1,0,0,0,1
32933539,1,0,0,0,1
32931660,1,0,0,0,1
32924122,1,0,0,0,1
32788186,0,0,0,1,1
32778868,1,0,0,0,1
32767789,0,0,1,0,1
32757167,0,0,1,0,1
32715865,1,0,0,0,1
32712155,1,0,0,0,1
32678605,0,0,1,0,1
32644427,0,0,1,0,1
32643095,1,0,0,0,1
32631901,1,0,0,0,1
32628002,1,0,0,0,1
32618435,1,0,0,0,1
32605338,0,0,0,1,1
32604201,1,0,0,0,1
32601368,0,0,1,0,1
32596049,1,0,0,0,1
32588705,1,0,0,0,1
32583105,0,0,1,0,1
32583045,1,0,0,0,1
32552738,1,0,0,0,1
32787246,1,0,0,0,1
32789287,0,0,1,0,1
32924087,0,0,0,1,1
32797377,1,0,0,0,1
32923003,0,0,1,0,1
32919123,1,0,0,0,1
32909880,1,0,0,0,1
32901759,1,0,0,0,1
32878607,0,0,1,0,1
32866463,1,0,0,0,1
32865595,0,0,1,0,1
32850071,1,0,0,0,1
32848328,0,0,1,0,1
32846930,1,0,0,0,1
32844422,1,0,0,0,1
32834879,1,0,0,0,1
32830245,1,0,0,0,1
32828988,1,0,0,0,1
32824042,0,0,1,0,1
32815083,1,0,0,0,1
32812120,0,0,1,0,1
32802716,0,0,1,0,1
32798845,0,0,1,0,1
41080880,1,0,0,0,1
41087164,0,0,1,0,1
28700317,0,0,1,0,1
50256870,0,0,1,0,1
50332029,0,0,1,0,1
50331528,1,0,0,0,1
50319699,1,0,0,0,1
50318467,0,0,1,0,1
50299658,1,0,0,0,1
50296004,1,0,0,0,1
50291368,0,0,1,0,1
50282911,1,0,0,0,1
50282201,0,0,1,0,1
50255130,1,0,0,0,1
50165358,1,0,0,0,1
50252837,0,0,1,0,1
50243945,0,0,1,0,1
50241946,0,0,1,0,1
50240612,1,0,0,0,1
50213378,1,0,0,0,1
50213173,0,0,1,0,1
50210611,1,0,0,0,1
50207365,0,0,1,0,1
50200840,0,0,1,0,1
50339845,0,0,1,0,1
50361964,1,0,0,0,1
50364911,1,0,0,0,1
50366453,1,0,0,0,1
50445531,0,0,1,0,1
50442604,0,0,1,0,1
50439960,1,0,0,0,1
50432178,0,0,1,0,1
50414933,1,0,0,0,1
50411791,1,0,0,0,1
50411330,0,0,1,0,1
50411243,1,0,0,0,1
50401229,1,0,0,0,1
50396427,1,0,0,0,1
50388576,1,0,0,0,1
50386076,1,0,0,0,1
50384225,0,0,1,0,1
50383289,1,0,0,0,1
50380693,1,0,0,0,1
50377301,1,0,0,0,1
50372319,1,0,0,0,1
50369736,0,0,1,0,1
50368164,1,0,0,0,1
50173892,0,0,1,0,1
50157334,1,0,0,0,1
50453660,1,0,0,0,1
49967558,1,0,0,0,1
50006975,0,0,1,0,1
50006528,1,0,0,0,1
50005319,1,0,0,0,1
50002645,0,0,1,0,1
50002162,1,0,0,0,1
50001799,1,0,0,0,1
50001302,1,0,0,0,1
49991005,0,0,1,0,1
49988341,0,0,1,0,1
49964890,0,0,1,0,1
50152355,1,0,0,0,1
49956329,0,0,1,0,1
49951208,1,0,0,0,1
49950511,1,0,0,0,1
49924063,1,0,0,0,1
49900664,1,0,0,0,1
49897449,0,0,1,0,1
49883421,1,0,0,0,1
49879147,0,0,1,0,1
49867487,0,0,0,1,1
50008174,0,0,1,0,1
50013026,0,0,1,0,1
50015739,1,0,0,0,1
50028109,0,0,1,0,1
50148553,0,0,1,0,1
50145118,0,0,1,0,1
50138907,1,0,0,0,1
50137233,0,0,1,0,1
50132533,1,0,0,0,1
50131208,0,0,1,0,1
50126257,1,0,0,0,1
50116334,0,0,1,0,1
50116095,0,0,1,0,1
50097540,1,0,0,0,1
50086945,1,0,0,0,1
50086145,0,0,1,0,1
50084376,0,0,1,0,1
50084137,1,0,0,0,1
50080673,0,0,1,0,1
50072658,1,0,0,0,1
50059393,1,0,0,0,1
50053165,1,0,0,0,1
50031308,0,0,1,0,1
50452489,0,0,1,0,1
50455731,1,0,0,0,1
48277456,1,0,0,0,1
50925964,1,0,0,0,1
51002691,1,0,0,0,1
50997070,1,0,0,0,1
50995154,1,0,0,0,1
50994782,1,0,0,0,1
50988308,1,0,0,0,1
50945119,0,0,1,0,1
50943387,1,0,0,0,1
50942578,1,0,0,0,1
50939666,1,0,0,0,1
50921963,1,0,0,0,1
50820799,1,0,0,0,1
50920322,1,0,0,0,1
50909072,0,0,1,0,1
50909051,1,0,0,0,1
50904121,1,0,0,0,1
50894847,1,0,0,0,1
50893272,1,0,0,0,1
50865592,0,0,1,0,1
50864989,0,0,1,0,1
50839249,0,0,1,0,1
51021121,0,0,1,0,1
51035062,0,0,1,0,1
51068857,1,0,0,0,1
51099309,0,0,1,0,1
51300628,1,0,0,0,1
51297731,1,0,0,0,1
51282128,0,0,1,0,1
51278311,1,0,0,0,1
51268465,1,0,0,0,1
51266038,1,0,0,0,1
51262617,0,0,1,0,1
51256572,0,0,1,0,1
51248302,0,0,1,0,1
51248093,1,0,0,0,1
51238762,0,0,1,0,1
51237731,1,0,0,0,1
51230222,1,0,0,0,1
51220825,1,0,0,0,1
51219881,0,0,1,0,1
51209309,1,0,0,0,1
51186155,1,0,0,0,1
51162561,1,0,0,0,1
51105827,1,0,0,0,1
50831521,1,0,0,0,1
50814868,1,0,0,0,1
50459536,0,0,1,0,1
50526314,0,0,1,0,1
50605761,1,0,0,0,1
50597835,0,0,1,0,1
50594702,0,0,1,0,1
50593964,1,0,0,0,1
50588693,0,0,1,0,1
50556869,0,0,1,0,1
50556696,1,0,0,0,1
50549394,0,0,1,0,1
50537550,1,0,0,0,1
50520440,0,0,1,0,1
50778925,1,0,0,0,1
50520029,0,0,1,0,1
50497157,0,0,1,0,1
50489309,0,0,1,0,1
50485365,0,0,1,0,1
50482164,1,0,0,0,1
50477855,1,0,0,0,1
50466143,0,0,1,0,1
50463621,1,0,0,0,1
50462669,0,0,1,0,1
50612145,1,0,0,0,1
50615055,0,0,1,0,1
50643703,1,0,0,0,1
50661711,0,0,1,0,1
50772718,0,0,1,0,1
50772475,1,0,0,0,1
50771613,1,0,0,0,1
50769650,0,0,1,0,1
50768537,0,0,1,0,1
50762019,0,0,1,0,1
50761842,1,0,0,0,1
50750250,1,0,0,0,1
50742544,1,0,0,0,1
50740281,1,0,0,0,1
50730169,1,0,0,0,1
50729557,0,0,1,0,1
50727041,0,0,1,0,1
50690190,1,0,0,0,1
50688724,0,0,1,0,1
50687223,1,0,0,0,1
50682735,1,0,0,0,1
50681342,1,0,0,0,1
50678424,1,0,0,0,1
49861582,0,0,1,0,1
49827772,0,0,1,0,1
49812079,0,0,1,0,1
48806776,1,0,0,0,1
48870194,1,0,0,0,1
48859528,1,0,0,0,1
48858084,1,0,0,0,1
48851196,0,0,1,0,1
48822474,1,0,0,0,1
48819868,0,0,1,0,1
48816743,1,0,0,0,1
48815188,1,0,0,0,1
48812051,1,0,0,0,1
48805583,1,0,0,0,1
48695642,0,0,1,0,1
48793181,0,0,1,0,1
48771484,1,0,0,0,1
48745427,1,0,0,0,1
48726094,0,0,1,0,1
48723117,0,0,1,0,1
48723057,1,0,0,0,1
48721735,1,0,0,0,1
48711094,0,0,1,0,1
48698934,1,0,0,0,1
48880382,1,0,0,0,1
48880473,1,0,0,0,1
48881330,1,0,0,0,1
48881919,0,0,1,0,1
49024977,0,0,1,0,1
49021868,1,0,0,0,1
49019705,1,0,0,0,1
49018902,1,0,0,0,1
48984291,0,0,1,0,1
48980919,1,0,0,0,1
48978249,0,0,1,0,1
48977510,1,0,0,0,1
48972208,0,0,1,0,1
48961085,0,0,1,0,1
48960226,0,0,1,0,1
48958589,1,0,0,0,1
48958358,0,0,1,0,1
48952468,1,0,0,0,1
48937055,1,0,0,0,1
48913242,0,0,1,0,1
48904356,1,0,0,0,1
48900122,1,0,0,0,1
48895336,1,0,0,0,1
48696992,0,0,1,0,1
48685956,0,0,1,0,1
49804236,1,0,0,0,1
48442001,0,0,1,0,1
48542743,1,0,0,0,1
48539240,0,0,1,0,1
48534909,1,0,0,0,1
48533809,1,0,0,0,1
48523649,1,0,0,0,1
48498971,1,0,0,0,1
48498097,1,0,0,0,1
48492929,0,0,1,0,1
48446355,0,0,1,0,1
48438698,1,0,0,0,1
48685877,0,0,0,1,1
48434623,1,0,0,0,1
48427159,1,0,0,0,1
48414103,1,0,0,0,1
48402458,1,0,0,0,1
48372942,0,0,1,0,1
48367358,0,0,1,0,1
48351548,0,0,1,0,1
48345272,1,0,0,0,1
48303314,0,0,1,0,1
48547519,1,0,0,0,1
48565842,0,0,1,0,1
48573053,0,0,1,0,1
48577772,1,0,0,0,1
48685332,0,0,1,0,1
48681901,1,0,0,0,1
48677964,0,0,1,0,1
48677247,1,0,0,0,1
48674244,1,0,0,0,1
48671504,1,0,0,0,1
48664130,1,0,0,0,1
48660417,0,0,1,0,1
48656306,1,0,0,0,1
48636660,0,0,1,0,1
48634163,0,0,1,0,1
48630747,1,0,0,0,1
48628501,1,0,0,0,1
48627335,0,0,1,0,1
48603189,0,0,1,0,1
48601058,1,0,0,0,1
48593893,1,0,0,0,1
48592068,0,0,1,0,1
48582770,0,0,1,0,1
49027208,1,0,0,0,1
49027658,1,0,0,0,1
49032950,1,0,0,0,1
49570763,1,0,0,0,1
49641082,0,0,1,0,1
49639577,0,0,1,0,1
49636275,1,0,0,0,1
49630478,1,0,0,0,1
49592958,0,0,1,0,1
49589973,0,0,1,0,1
49582324,0,0,1,0,1
49580011,1,0,0,0,1
49572092,1,0,0,0,1
49553194,1,0,0,0,1
49036237,1,0,0,0,1
49522403,0,0,1,0,1
49514708,0,0,1,0,1
49513668,1,0,0,0,1
49509847,1,0,0,0,1
49505120,0,0,1,0,1
49494357,1,0,0,0,1
49494045,1,0,0,0,1
49487367,1,0,0,0,1
49485109,0,0,1,0,1
49645950,1,0,0,0,1
49649740,0,0,1,0,1
49651648,0,0,1,0,1
49651890,0,0,1,0,1
49781652,0,0,1,0,1
49754509,0,0,1,0,1
49753169,0,0,1,0,1
49750805,0,0,1,0,1
49745989,1,0,0,0,1
49738780,0,0,1,0,1
49737913,1,0,0,0,1
49736414,0,0,1,0,1
49730010,0,0,1,0,1
49727048,1,0,0,0,1
49720830,0,0,1,0,1
49716547,1,0,0,0,1
49709755,1,0,0,0,1
49701856,0,0,1,0,1
49673620,1,0,0,0,1
49671297,1,0,0,0,1
49664763,0,0,1,0,1
49656804,1,0,0,0,1
49654304,1,0,0,0,1
49482081,0,0,1,0,1
49453860,1,0,0,0,1
49435973,1,0,0,0,1
49203318,1,0,0,0,1
49202674,1,0,0,0,1
49199759,1,0,0,0,1
49197104,1,0,0,0,1
49193707,0,0,1,0,1
49191712,1,0,0,0,1
49181430,1,0,0,0,1
49177258,1,0,0,0,1
49167534,1,0,0,0,1
49166783,0,0,0,1,1
49133999,0,0,1,0,1
49123284,1,0,0,0,1
49121324,0,0,1,0,1
49120717,0,0,1,0,1
49120239,1,0,0,0,1
49095662,1,0,0,0,1
49090209,1,0,0,0,1
49089627,0,0,1,0,1
49082748,0,0,1,0,1
49045679,0,0,1,0,1
49202910,0,0,1,0,1
49216953,1,0,0,0,1
49431548,0,0,1,0,1
49223549,1,0,0,0,1
49413208,1,0,0,0,1
49410148,1,0,0,0,1
49379520,1,0,0,0,1
49376270,1,0,0,0,1
49367316,1,0,0,0,1
49347979,0,0,1,0,1
49347242,1,0,0,0,1
49296586,0,0,1,0,1
49294106,0,0,1,0,1
49293611,0,0,1,0,1
49293535,1,0,0,0,1
49286334,0,0,1,0,1
49280870,0,0,1,0,1
49279577,0,0,1,0,1
49275064,1,0,0,0,1
49270426,0,0,1,0,1
49268145,1,0,0,0,1
49260425,1,0,0,0,1
49255756,0,0,1,0,1
51309850,0,0,1,0,1
51312690,1,0,0,0,1
51329030,0,0,1,0,1
54280519,1,0,0,0,1
54375099,0,0,1,0,1
54374748,0,0,1,0,1
54368503,0,0,1,0,1
54353888,0,0,1,0,1
54351163,1,0,0,0,1
54345530,0,0,1,0,1
54342301,1,0,0,0,1
54294445,1,0,0,0,1
54283244,1,0,0,0,1
54279433,0,0,1,0,1
54198006,0,0,1,0,1
54279355,1,0,0,0,1
54269012,0,0,1,0,1
54262760,0,0,1,0,1
54261444,0,0,1,0,1
54256065,0,0,1,0,1
54242258,0,0,1,0,1
54235026,1,0,0,0,1
54217635,1,0,0,0,1
54206554,1,0,0,0,1
54377368,1,0,0,0,1
54384811,1,0,0,0,1
54398134,0,0,1,0,1
54401544,0,0,1,0,1
54743396,1,0,0,0,1
54743212,1,0,0,0,1
54689021,0,0,1,0,1
54677106,1,0,0,0,1
54675040,0,0,1,0,1
54657257,1,0,0,0,1
54640485,0,0,1,0,1
54634154,0,0,1,0,1
54634134,0,0,1,0,1
54632171,1,0,0,0,1
54582219,0,0,1,0,1
54541149,0,0,1,0,1
54539364,1,0,0,0,1
54536829,1,0,0,0,1
54508926,1,0,0,0,1
54498900,1,0,0,0,1
54454582,1,0,0,0,1
54433895,1,0,0,0,1
54402768,0,0,1,0,1
54205873,0,0,1,0,1
54130868,1,0,0,0,1
53363226,1,0,0,0,1
53477091,1,0,0,0,1
53648985,1,0,0,0,1
53642216,1,0,0,0,1
53632978,1,0,0,0,1
53627900,0,0,1,0,1
53624923,0,0,1,0,1
53618094,1,0,0,0,1
53582731,1,0,0,0,1
53562827,1,0,0,0,1
53492531,1,0,0,0,1
53475735,0,0,1,0,1
54123180,0,0,1,0,1
53468381,1,0,0,0,1
53462017,1,0,0,0,1
53450065,0,0,1,0,1
53445174,0,0,1,0,1
53440969,1,0,0,0,1
53413881,0,0,1,0,1
53387593,0,0,1,0,1
53375167,1,0,0,0,1
53370168,1,0,0,0,1
53686400,0,0,1,0,1
53693534,1,0,0,0,1
53720018,1,0,0,0,1
53722078,1,0,0,0,1
54081802,0,0,1,0,1
54012364,1,0,0,0,1
54001858,1,0,0,0,1
53955282,1,0,0,0,1
53931758,1,0,0,0,1
53930780,0,0,1,0,1
53927342,1,0,0,0,1
53911974,0,0,1,0,1
53887408,1,0,0,0,1
53883793,1,0,0,0,1
53863688,1,0,0,0,1
53862397,1,0,0,0,1
53850552,0,0,1,0,1
53821069,1,0,0,0,1
53819985,0,0,1,0,1
53773419,0,0,1,0,1
53771409,1,0,0,0,1
53766519,1,0,0,0,1
53759518,0,0,1,0,1
54748204,0,0,1,0,1
54763152,0,0,1,0,1
54769760,0,0,1,0,1
55570509,1,0,0,0,1
55725808,0,0,1,0,1
55713789,1,0,0,0,1
55709707,1,0,0,0,1
55682735,1,0,0,0,1
55656242,1,0,0,0,1
55618434,0,0,1,0,1
55617221,1,0,0,0,1
55607877,0,0,1,0,1
55602526,1,0,0,0,1
55567227,0,0,1,0,1
54772069,0,0,1,0,1
55557006,1,0,0,0,1
55527442,0,0,1,0,1
55468876,1,0,0,0,1
55468128,0,0,1,0,1
55465174,1,0,0,0,1
55454768,1,0,0,0,1
55454228,1,0,0,0,1
55439236,1,0,0,0,1
55430096,1,0,0,0,1
55775706,1,0,0,0,1
55807631,0,0,1,0,1
55808233,0,0,1,0,1
55815112,1,0,0,0,1
56138849,0,0,1,0,1
56130007,1,0,0,0,1
56124518,0,0,1,0,1
56074896,1,0,0,0,1
56067189,1,0,0,0,1
56066018,0,0,1,0,1
56051614,1,0,0,0,1
56044722,0,0,1,0,1
56031043,1,0,0,0,1
55981584,0,0,1,0,1
55979182,0,0,0,1,1
55972382,1,0,0,0,1
55952349,1,0,0,0,1
55853534,0,0,1,0,1
55836825,1,0,0,0,1
55831301,1,0,0,0,1
55829442,1,0,0,0,1
55826318,1,0,0,0,1
55823684,1,0,0,0,1
55425915,1,0,0,0,1
55413233,1,0,0,0,1
55398056,1,0,0,0,1
55148803,1,0,0,0,1
55086196,1,0,0,0,1
55062858,1,0,0,0,1
55060863,0,0,1,0,1
55036405,0,0,0,1,1
55033043,1,0,0,0,1
54975120,1,0,0,0,1
54966810,0,0,1,0,1
54917558,1,0,0,0,1
54908796,1,0,0,0,1
54898333,1,0,0,0,1
54854984,1,0,0,0,1
54846547,1,0,0,0,1
54836034,1,0,0,0,1
54832948,1,0,0,0,1
54807420,0,0,1,0,1
54799031,1,0,0,0,1
54784332,1,0,0,0,1
54780556,1,0,0,0,1
54778990,0,0,1,0,1
55122324,0,0,1,0,1
55149412,1,0,0,0,1
55394597,1,0,0,0,1
55149825,1,0,0,0,1
55389878,0,0,1,0,1
55346267,0,0,1,0,1
55339775,1,0,0,0,1
55324782,0,0,1,0,1
55302128,0,0,1,0,1
55293656,1,0,0,0,1
55229297,1,0,0,0,1
55223948,1,0,0,0,1
55202404,1,0,0,0,1
55198931,0,0,1,0,1
55197894,0,0,1,0,1
55197031,1,0,0,0,1
55191496,1,0,0,0,1
55190776,1,0,0,0,1
55183922,1,0,0,0,1
55179950,0,0,1,0,1
55177705,1,0,0,0,1
55170899,1,0,0,0,1
55165952,0,0,1,0,1
53365451,0,0,1,0,1
53319402,0,0,1,0,1
51333762,1,0,0,0,1
51829088,1,0,0,0,1
51940393,1,0,0,0,1
51937928,1,0,0,0,1
51924404,0,0,1,0,1
51913826,0,0,1,0,1
51913270,1,0,0,0,1
51870709,1,0,0,0,1
51857469,1,0,0,0,1
51857129,1,0,0,0,1
51839283,0,0,1,0,1
51812548,1,0,0,0,1
51664119,0,0,1,0,1
51764491,0,0,1,0,1
51752700,0,0,1,0,1
51746762,1,0,0,0,1
51734800,0,0,1,0,1
51698646,0,0,1,0,1
51690846,0,0,1,0,1
51688993,1,0,0,0,1
51684417,1,0,0,0,1
51678353,0,0,1,0,1
51965453,0,0,1,0,1
51992385,0,0,1,0,1
52022983,1,0,0,0,1
52031734,0,0,1,0,1
52183960,1,0,0,0,1
52183380,1,0,0,0,1
52179765,1,0,0,0,1
52170593,1,0,0,0,1
52166457,0,0,1,0,1
52155780,0,0,1,0,1
52138912,1,0,0,0,1
52135038,1,0,0,0,1
52129673,0,0,1,0,1
52127857,0,0,1,0,1
52127678,0,0,1,0,1
52112891,0,0,1,0,1
52083976,1,0,0,0,1
52071286,1,0,0,0,1
52062343,0,0,0,1,1
52054118,0,0,1,0,1
52052321,0,0,1,0,1
52049429,1,0,0,0,1
52040778,0,0,1,0,1
51664729,1,0,0,0,1
51662642,1,0,0,0,1
53301314,1,0,0,0,1
51419167,1,0,0,0,1
51439873,0,0,1,0,1
51439340,1,0,0,0,1
51438025,1,0,0,0,1
51434460,0,0,1,0,1
51433399,1,0,0,0,1
51432814,0,0,1,0,1
51430742,0,0,1,0,1
51426261,1,0,0,0,1
51425591,0,0,1,0,1
51414586,1,0,0,0,1
51652888,0,0,1,0,1
51381179,0,0,1,0,1
51367478,0,0,1,0,1
51364562,0,0,1,0,1
51358854,1,0,0,0,1
51356178,1,0,0,0,1
51349952,0,0,1,0,1
51348096,0,0,1,0,1
51338091,1,0,0,0,1
51337085,0,0,1,0,1
51446803,1,0,0,0,1
51447330,0,0,1,0,1
51450214,1,0,0,0,1
51499758,0,0,1,0,1
51651427,1,0,0,0,1
51637918,1,0,0,0,1
51614806,0,0,1,0,1
51610412,0,0,1,0,1
51607512,1,0,0,0,1
51605949,0,0,1,0,1
51594665,0,0,1,0,1
51563463,0,0,1,0,1
51547093,1,0,0,0,1
51538996,1,0,0,0,1
51538274,1,0,0,0,1
51536620,0,0,1,0,1
51525788,1,0,0,0,1
51525183,0,0,1,0,1
51522009,0,0,1,0,1
51517754,0,0,1,0,1
51513795,1,0,0,0,1
51509098,1,0,0,0,1
51504193,1,0,0,0,1
52190465,1,0,0,0,1
52191882,0,0,1,0,1
52203920,1,0,0,0,1
52752145,0,0,1,0,1
52831325,0,0,1,0,1
52807146,1,0,0,0,1
52799398,0,0,1,0,1
52796837,1,0,0,0,1
52794726,0,0,1,0,1
52780335,1,0,0,0,1
52768036,0,0,1,0,1
52767716,0,0,1,0,1
52763343,1,0,0,0,1
52729038,1,0,0,0,1
52221728,0,0,1,0,1
52725589,1,0,0,0,1
52720583,1,0,0,0,1
52716387,1,0,0,0,1
52711374,1,0,0,0,1
52705961,1,0,0,0,1
52699613,0,0,1,0,1
52676179,1,0,0,0,1
52676089,1,0,0,0,1
52674088,0,0,1,0,1
52834548,1,0,0,0,1
52855544,1,0,0,0,1
52942822,1,0,0,0,1
52949531,1,0,0,0,1
53258494,1,0,0,0,1
53223410,1,0,0,0,1
53217509,0,0,1,0,1
53216788,0,0,1,0,1
53209258,0,0,1,0,1
53206623,1,0,0,0,1
53169195,0,0,1,0,1
53163551,0,0,1,0,1
53153865,1,0,0,0,1
53127489,1,0,0,0,1
53099839,0,0,1,0,1
53051331,0,0,1,0,1
53041792,1,0,0,0,1
52999390,0,0,1,0,1
52989652,1,0,0,0,1
52981364,0,0,1,0,1
52973925,0,0,1,0,1
52970439,1,0,0,0,1
52964447,1,0,0,0,1
52656488,0,0,1,0,1
52656361,0,0,1,0,1
52644225,1,0,0,0,1
52445657,0,0,1,0,1
52430092,1,0,0,0,1
52413373,1,0,0,0,1
52411631,1,0,0,0,1
52395622,1,0,0,0,1
52377121,1,0,0,0,1
52376462,1,0,0,0,1
52368720,1,0,0,0,1
52364746,1,0,0,0,1
52363997,1,0,0,0,1
52357574,0,0,1,0,1
52356702,0,0,1,0,1
52339704,1,0,0,0,1
52336636,1,0,0,0,1
52332281,0,0,1,0,1
52310314,0,0,1,0,1
52267190,0,0,0,1,1
52267166,1,0,0,0,1
52264713,1,0,0,0,1
52251660,0,0,1,0,1
52432205,1,0,0,0,1
52453644,1,0,0,0,1
52630170,0,0,1,0,1
52454185,0,0,1,0,1
52616278,1,0,0,0,1
52613466,0,0,1,0,1
52602009,0,0,1,0,1
52601644,0,0,1,0,1
52593822,1,0,0,0,1
52593429,0,0,1,0,1
52586141,1,0,0,0,1
52584471,1,0,0,0,1
52575889,1,0,0,0,1
52559052,1,0,0,0,1
52551507,0,0,1,0,1
52547346,1,0,0,0,1
52539349,1,0,0,0,1
52538564,1,0,0,0,1
52530136,1,0,0,0,1
52529356,1,0,0,0,1
52526463,1,0,0,0,1
52525871,1,0,0,0,1
52491837,0,1,0,0,1
48287405,0,0,1,0,1
48264768,0,0,1,0,1
41091852,0,0,1,0,1
43531190,0,0,1,0,1
43610994,1,0,0,0,1
43601655,0,0,1,0,1
43599290,1,0,0,0,1
43585775,1,0,0,0,1
43585545,0,0,1,0,1
43549139,1,0,0,0,1
43549138,1,0,0,0,1
43534773,1,0,0,0,1
43533460,0,0,1,0,1
43518492,0,0,1,0,1
43380791,0,0,1,0,1
43509184,1,0,0,0,1
43490965,0,0,1,0,1
43461100,1,0,0,0,1
43449898,0,0,1,0,1
43443842,1,0,0,0,1
43436738,1,0,0,0,1
43431319,1,0,0,0,1
43429598,1,0,0,0,1
43426547,0,0,1,0,1
43637999,0,0,1,0,1
43642470,0,0,1,0,1
43654009,1,0,0,0,1
43661884,1,0,0,0,1
43864152,1,0,0,0,1
43853650,1,0,0,0,1
43846246,0,0,1,0,1
43825948,1,0,0,0,1
43825799,1,0,0,0,1
43823149,1,0,0,0,1
43821705,0,0,1,0,1
43803591,1,0,0,0,1
43779028,0,0,1,0,1
43768534,0,0,1,0,1
43754478,0,0,1,0,1
43740859,0,0,1,0,1
43733051,1,0,0,0,1
43719554,0,0,1,0,1
43707936,0,0,1,0,1
43684878,1,0,0,0,1
43682230,1,0,0,0,1
43669488,1,0,0,0,1
43669213,0,0,1,0,1
43390488,0,0,1,0,1
43376059,1,0,0,0,1
43876308,1,0,0,0,1
43038322,1,0,0,0,1
43151590,1,0,0,0,1
43137812,1,0,0,0,1
43126741,1,0,0,0,1
43125231,1,0,0,0,1
43121487,1,0,0,0,1
43112955,1,0,0,0,1
43108922,1,0,0,0,1
43085567,1,0,0,0,1
43052750,1,0,0,0,1
43014167,1,0,0,0,1
43371759,1,0,0,0,1
43011952,1,0,0,0,1
43008598,1,0,0,0,1
43004238,1,0,0,0,1
42991737,1,0,0,0,1
42979789,0,0,1,0,1
42959506,1,0,0,0,1
42956813,1,0,0,0,1
42954481,0,0,1,0,1
42951928,0,0,1,0,1
43169359,1,0,0,0,1
43172104,1,0,0,0,1
43180601,1,0,0,0,1
43184079,0,0,1,0,1
43370599,1,0,0,0,1
43361668,0,0,1,0,1
43339525,1,0,0,0,1
43315893,0,0,1,0,1
43311385,1,0,0,0,1
43305568,1,0,0,0,1
43298844,0,0,1,0,1
43275413,1,0,0,0,1
43272945,1,0,0,0,1
43264429,0,0,1,0,1
43237704,0,0,1,0,1
43232773,1,0,0,0,1
43232214,1,0,0,0,1
43226806,0,0,1,0,1
43221758,1,0,0,0,1
43220844,1,0,0,0,1
43219894,1,0,0,0,1
43203249,0,0,1,0,1
43197578,1,0,0,0,1
43870735,1,0,0,0,1
43885876,0,0,0,1,1
48264527,1,0,0,0,1
44457353,1,0,0,0,1
44632313,0,0,1,0,1
44630169,1,0,0,0,1
44623374,0,0,1,0,1
44605035,1,0,0,0,1
44596503,1,0,0,0,1
44593150,1,0,0,0,1
44539148,1,0,0,0,1
44498923,1,0,0,0,1
44459590,0,0,0,1,1
44452747,1,0,0,0,1
44355774,1,0,0,0,1
44439712,0,0,1,0,1
44418477,1,0,0,0,1
44381804,1,0,0,0,1
44378858,0,0,1,0,1
44378460,0,0,1,0,1
44378396,1,0,0,0,1
44369272,0,0,1,0,1
44361695,0,0,1,0,1
44358777,0,0,1,0,1
44642799,0,0,1,0,1
44665470,0,0,1,0,1
44666806,1,0,0,0,1
44695873,1,0,0,0,1
44866282,1,0,0,0,1
44862267,0,0,1,0,1
44853219,1,0,0,0,1
44850669,1,0,0,0,1
44835881,0,0,1,0,1
44811074,1,0,0,0,1
44798128,1,0,0,0,1
44783194,1,0,0,0,1
44782700,1,0,0,0,1
44782054,0,0,1,0,1
44779572,0,0,1,0,1
44772065,1,0,0,0,1
44753370,1,0,0,0,1
44745096,0,0,1,0,1
44707475,0,0,1,0,1
44706591,1,0,0,0,1
44706272,0,0,1,0,1
44703029,1,0,0,0,1
44697034,0,0,1,0,1
44357881,0,0,1,0,1
44346809,1,0,0,0,1
43887166,0,0,1,0,1
43967768,1,0,0,0,1
44106439,0,0,1,0,1
44102819,1,0,0,0,1
44099001,1,0,0,0,1
44071830,0,0,1,0,1
44050884,0,0,1,0,1
44007314,1,0,0,0,1
44002343,1,0,0,0,1
43993869,0,0,1,0,1
43977828,1,0,0,0,1
43964569,0,0,1,0,1
44346409,1,0,0,0,1
43963849,1,0,0,0,1
43956548,1,0,0,0,1
43951918,1,0,0,0,1
43949321,0,0,1,0,1
43945071,1,0,0,0,1
43936824,0,0,1,0,1
43908809,0,0,1,0,1
43893277,0,0,1,0,1
43889585,0,0,1,0,1
44107591,0,0,1,0,1
44118283,0,0,1,0,1
44119494,1,0,0,0,1
44140036,0,0,1,0,1
44338944,1,0,0,0,1
44336290,1,0,0,0,1
44321906,1,0,0,0,1
44295724,1,0,0,0,1
44295617,1,0,0,0,1
44278310,0,0,1,0,1
44273727,0,0,1,0,1
44262594,0,0,1,0,1
44262118,0,0,1,0,1
44253752,1,0,0,0,1
44251528,1,0,0,0,1
44225290,1,0,0,0,1
44223203,0,0,1,0,1
44220091,0,0,1,0,1
44211580,1,0,0,0,1
44201154,1,0,0,0,1
44193702,0,0,1,0,1
44174247,1,0,0,0,1
44153917,0,0,1,0,1
42951726,1,0,0,0,1
42950170,0,0,1,0,1
42947876,1,0,0,0,1
41617175,0,0,1,0,1
41680155,0,0,1,0,1
41667978,0,0,1,0,1
41666301,0,0,1,0,1
41657584,1,0,0,0,1
41655831,0,0,1,0,1
41654488,0,0,1,0,1
41638669,0,0,1,0,1
41620310,1,0,0,0,1
41619645,1,0,0,0,1
41602405,1,0,0,0,1
41511227,1,0,0,0,1
41582866,1,0,0,0,1
41577453,1,0,0,0,1
41573259,1,0,0,0,1
41573197,1,0,0,0,1
41564602,1,0,0,0,1
41560662,0,0,1,0,1
41556599,1,0,0,0,1
41550565,1,0,0,0,1
41535999,0,0,1,0,1
41680962,1,0,0,0,1
41698272,0,0,1,0,1
41704832,0,0,1,0,1
41733161,1,0,0,0,1
41913683,1,0,0,0,1
41913012,1,0,0,0,1
41865841,0,0,1,0,1
41858333,0,0,1,0,1
41844294,1,0,0,0,1
41835277,1,0,0,0,1
41834661,1,0,0,0,1
41828288,1,0,0,0,1
41822736,1,0,0,0,1
41810578,1,0,0,0,1
41775303,1,0,0,0,1
41774713,0,0,1,0,1
41769353,1,0,0,0,1
41764756,1,0,0,0,1
41762539,1,0,0,0,1
41757762,1,0,0,0,1
41750634,0,0,1,0,1
41743945,1,0,0,0,1
41739719,1,0,0,0,1
41514104,1,0,0,0,1
41510712,0,0,1,0,1
42946393,0,0,1,0,1
41191579,0,0,1,0,1
41316877,0,0,1,0,1
41306788,1,0,0,0,1
41281138,0,0,1,0,1
41280277,1,0,0,0,1
41265342,1,0,0,0,1
41232114,0,0,1,0,1
41213523,1,0,0,0,1
41209536,1,0,0,0,1
41194120,1,0,0,0,1
41185455,1,0,0,0,1
41510518,1,0,0,0,1
41184818,0,0,1,0,1
41171451,0,0,1,0,1
41158436,1,0,0,0,1
41140356,1,0,0,0,1
41135932,1,0,0,0,1
41112084,1,0,0,0,1
41100295,0,0,1,0,1
41096941,1,0,0,0,1
41094794,1,0,0,0,1
41319262,1,0,0,0,1
41324442,0,0,1,0,1
41325253,1,0,0,0,1
41330687,0,0,1,0,1
41503213,0,0,1,0,1
41497327,1,0,0,0,1
41484943,0,0,1,0,1
41471799,1,0,0,0,1
41468177,1,0,0,0,1
41466973,1,0,0,0,1
41464907,1,0,0,0,1
41430560,1,0,0,0,1
41429901,1,0,0,0,1
41426347,1,0,0,0,1
41424652,1,0,0,0,1
41411803,0,0,1,0,1
41406733,1,0,0,0,1
41405875,0,0,1,0,1
41399494,1,0,0,0,1
41398078,0,0,1,0,1
41393276,0,0,0,1,1
41368372,1,0,0,0,1
41349199,1,0,0,0,1
41930087,0,0,1,0,1
41932662,1,0,0,0,1
41939513,0,0,1,0,1
42515688,1,0,0,0,1
42627213,0,0,1,0,1
42626435,0,0,1,0,1
42570179,0,0,1,0,1
42555896,1,0,0,0,1
42545174,1,0,0,0,1
42538643,1,0,0,0,1
42537893,1,0,0,0,1
42535703,1,0,0,0,1
42531584,1,0,0,0,1
42502139,1,0,0,0,1
41945908,0,0,1,0,1
42492299,1,0,0,0,1
42488595,0,0,1,0,1
42486495,0,0,1,0,1
42428175,1,0,0,0,1
42424450,0,0,1,0,1
42423050,1,0,0,0,1
42419832,1,0,0,0,1
42418809,1,0,0,0,1
42418421,1,0,0,0,1
42660040,1,0,0,0,1
42677381,1,0,0,0,1
42691960,0,0,1,0,1
42713726,0,0,1,0,1
42928837,0,0,1,0,1
42906017,1,0,0,0,1
42905408,1,0,0,0,1
42905152,1,0,0,0,1
42893832,0,0,1,0,1
42889787,1,0,0,0,1
42854068,0,0,1,0,1
42849963,1,0,0,0,1
42807409,0,0,1,0,1
42795691,0,0,1,0,1
42788011,1,0,0,0,1
42783841,1,0,0,0,1
42783238,0,0,1,0,1
42771225,0,0,1,0,1
42767903,1,0,0,0,1
42764722,0,0,0,1,1
42732656,0,0,1,0,1
42727726,0,0,1,0,1
42723666,1,0,0,0,1
42399786,1,0,0,0,1
42320409,1,0,0,0,1
42315851,0,0,1,0,1
42133913,1,0,0,0,1
42085952,1,0,0,0,1
42082221,0,0,1,0,1
42082112,1,0,0,0,1
42081806,0,0,0,1,1
42079873,0,0,1,0,1
42061478,0,0,1,0,1
42052329,1,0,0,0,1
42048980,0,0,1,0,1
42034713,0,0,1,0,1
42030960,1,0,0,0,1
42024620,1,0,0,0,1
42023877,1,0,0,0,1
42008401,1,0,0,0,1
41968597,1,0,0,0,1
41963149,1,0,0,0,1
41951749,1,0,0,0,1
41950627,1,0,0,0,1
41949280,0,0,1,0,1
41949088,1,0,0,0,1
42121413,1,0,0,0,1
42140178,1,0,0,0,1
42311622,1,0,0,0,1
42140979,1,0,0,0,1
42311387,1,0,0,0,1
42308954,1,0,0,0,1
42304005,1,0,0,0,1
42300406,1,0,0,0,1
42291391,1,0,0,0,1
42283996,1,0,0,0,1
42278723,0,0,1,0,1
42237462,1,0,0,0,1
42237225,0,0,1,0,1
42233780,1,0,0,0,1
42226482,1,0,0,0,1
42213050,1,0,0,0,1
42204606,1,0,0,0,1
42197611,1,0,0,0,1
42154612,1,0,0,0,1
42151184,0,0,1,0,1
42150813,0,0,1,0,1
42147412,1,0,0,0,1
42144338,0,0,1,0,1
44869463,1,0,0,0,1
44875359,0,0,0,1,1
44881523,1,0,0,0,1
47014375,1,0,0,0,1
47121117,0,0,1,0,1
47105925,0,0,1,0,1
47104818,1,0,0,0,1
47100454,1,0,0,0,1
47099125,0,0,1,0,1
47048567,0,0,1,0,1
47047377,1,0,0,0,1
47036828,1,0,0,0,1
47015275,1,0,0,0,1
47013708,0,0,1,0,1
46857976,0,0,1,0,1
46976642,1,0,0,0,1
46972551,1,0,0,0,1
46946480,1,0,0,0,1
46941561,1,0,0,0,1
46933987,0,0,1,0,1
46901221,1,0,0,0,1
46900979,1,0,0,0,1
46889591,0,0,1,0,1
46887682,0,0,1,0,1
47125955,1,0,0,0,1
47139786,0,0,1,0,1
47139912,1,0,0,0,1
47151333,1,0,0,0,1
47461622,1,0,0,0,1
47457325,1,0,0,0,1
47453782,1,0,0,0,1
47426195,0,0,1,0,1
47411697,0,0,1,0,1
47407352,0,0,1,0,1
47380199,1,0,0,0,1
47353889,0,0,1,0,1
47341316,1,0,0,0,1
47289872,1,0,0,0,1
47275801,1,0,0,0,1
47267079,1,0,0,0,1
47266834,0,0,1,0,1
47260217,0,0,1,0,1
47232411,1,0,0,0,1
47228873,0,0,1,0,1
47198995,1,0,0,0,1
47176167,0,0,1,0,1
47152279,0,0,1,0,1
46881049,1,0,0,0,1
46855885,1,0,0,0,1
46412380,1,0,0,0,1
46545526,1,0,0,0,1
46595030,0,0,1,0,1
46594996,1,0,0,0,1
46594096,0,0,0,1,1
46588955,1,0,0,0,1
46579560,1,0,0,0,1
46574350,1,0,0,0,1
46562860,0,0,1,0,1
46559411,1,0,0,0,1
46555645,0,1,0,0,1
46544348,1,0,0,0,1
46851431,1,0,0,0,1
46540057,0,0,0,1,1
46501846,1,0,0,0,1
46501842,0,0,1,0,1
46495186,1,0,0,0,1
46476909,0,0,1,0,1
46474221,0,0,1,0,1
46473712,1,0,0,0,1
46467513,0,0,1,0,1
46464995,1,0,0,0,1
46599828,1,0,0,0,1
46601876,1,0,0,0,1
46631730,1,0,0,0,1
46638457,0,0,0,1,1
46848226,0,0,1,0,1
46844755,0,0,1,0,1
46822312,1,0,0,0,1
46815771,1,0,0,0,1
46798824,1,0,0,0,1
46789694,0,0,1,0,1
46787065,1,0,0,0,1
46785121,1,0,0,0,1
46778191,0,0,1,0,1
46723538,1,0,0,0,1
46722604,1,0,0,0,1
46712160,0,0,1,0,1
46710719,1,0,0,0,1
46694098,1,0,0,0,1
46690777,0,0,1,0,1
46667080,1,0,0,0,1
46650449,0,0,1,0,1
46643729,1,0,0,0,1
46641887,1,0,0,0,1
47465031,0,0,1,0,1
47472192,0,0,1,0,1
47489718,0,0,1,0,1
48024019,1,0,0,0,1
48081884,0,0,1,0,1
48078451,1,0,0,0,1
48075081,1,0,0,0,1
48057837,0,0,1,0,1
48056617,0,0,1,0,1
48055483,0,0,1,0,1
48053679,1,0,0,0,1
48036408,0,0,1,0,1
48035228,0,0,1,0,1
48016303,0,0,1,0,1
47501348,0,0,1,0,1
48007438,1,0,0,0,1
47989547,0,0,1,0,1
2234,1,0,0,0,1
47954479,0,0,1,0,1
47938832,1,0,0,0,1
47931146,0,0,1,0,1
47898830,1,0,0,0,1
47896181,0,0,1,0,1
47893591,0,0,1,0,1
48086821,0,0,1,0,1
48091946,1,0,0,0,1
48104557,1,0,0,0,1
48106825,0,0,1,0,1
48261452,1,0,0,0,1
48244550,1,0,0,0,1
48240655,1,0,0,0,1
48205496,1,0,0,0,1
48202082,1,0,0,0,1
48201791,1,0,0,0,1
48201284,1,0,0,0,1
48194192,1,0,0,0,1
48189371,1,0,0,0,1
48182426,0,0,1,0,1
48176086,0,0,1,0,1
48171900,0,0,1,0,1
48170780,0,0,1,0,1
48167507,0,0,1,0,1
48164151,1,0,0,0,1
48161896,1,0,0,0,1
48148603,0,0,1,0,1
48136758,1,0,0,0,1
48107620,0,0,1,0,1
47886371,0,0,1,0,1
47864677,1,0,0,0,1
47860375,0,0,1,0,1
47663806,0,0,1,0,1
47657014,0,0,1,0,1
47638752,0,0,1,0,1
47636934,1,0,0,0,1
47617616,0,0,1,0,1
47596725,1,0,0,0,1
47595754,0,0,1,0,1
47585809,1,0,0,0,1
47584049,1,0,0,0,1
47577415,0,0,1,0,1
47576131,1,0,0,0,1
47550622,0,0,1,0,1
47546771,0,0,1,0,1
47541749,1,0,0,0,1
47539363,1,0,0,0,1
47536613,1,0,0,0,1
47518086,0,0,1,0,1
47515751,0,0,1,0,1
47513931,1,0,0,0,1
47511212,0,0,1,0,1
47661247,0,0,1,0,1
47666490,0,0,0,1,1
47857861,0,0,1,0,1
47675184,0,0,1,0,1
47856685,0,0,1,0,1
47853522,0,0,1,0,1
47851593,1,0,0,0,1
47844929,1,0,0,0,1
47844060,1,0,0,0,1
47843891,1,0,0,0,1
47825300,0,0,1,0,1
47817193,0,0,1,0,1
47800913,1,0,0,0,1
47792689,1,0,0,0,1
47790995,1,0,0,0,1
47790612,1,0,0,0,1
47787755,1,0,0,0,1
47785416,1,0,0,0,1
47783628,0,0,1,0,1
47773961,0,0,1,0,1
47729727,0,0,1,0,1
47716416,1,0,0,0,1
47703629,1,0,0,0,1
46430057,1,0,0,0,1
46407854,0,0,1,0,1
44883261,1,0,0,0,1
45399701,0,0,1,0,1
45469626,0,0,1,0,1
45451107,1,0,0,0,1
45446889,1,0,0,0,1
45444713,1,0,0,0,1
45440805,0,0,1,0,1
45433475,1,0,0,0,1
45409030,1,0,0,0,1
45408439,0,0,1,0,1
45404805,0,1,0,0,1
45397566,0,0,1,0,1
45315085,1,0,0,0,1
45381282,1,0,0,0,1
45378115,1,0,0,0,1
45364547,1,0,0,0,1
45364265,1,0,0,0,1
45359132,1,0,0,0,1
45354224,0,0,1,0,1
45336046,1,0,0,0,1
45329725,0,0,1,0,1
45319780,1,0,0,0,1
45499169,1,0,0,0,1
45502946,1,0,0,0,1
45513630,0,0,1,0,1
45516192,0,0,1,0,1
45618730,0,0,1,0,1
45613202,0,0,1,0,1
45608786,1,0,0,0,1
45608369,0,0,1,0,1
45605434,0,0,1,0,1
45604174,1,0,0,0,1
45601339,1,0,0,0,1
45596004,0,0,1,0,1
45589955,1,0,0,0,1
45558825,1,0,0,0,1
45557152,1,0,0,0,1
45553025,1,0,0,0,1
45552680,0,0,1,0,1
45550171,1,0,0,0,1
45535904,1,0,0,0,1
45534171,0,0,1,0,1
45531690,0,0,1,0,1
45519906,0,0,1,0,1
45519775,1,0,0,0,1
45315631,1,0,0,0,1
45303998,0,0,1,0,1
46407533,1,0,0,0,1
44996501,0,0,1,0,1
45082108,0,0,1,0,1
45045974,0,0,1,0,1
45033715,1,0,0,0,1
45029559,1,0,0,0,1
45023742,1,0,0,0,1
45012816,1,0,0,0,1
45005719,1,0,0,0,1
45000778,0,0,1,0,1
44999436,1,0,0,0,1
44996314,0,0,1,0,1
45295976,1,0,0,0,1
44951851,0,0,1,0,1
44941648,1,0,0,0,1
44941423,1,0,0,0,1
44937903,1,0,0,0,1
44929652,0,0,1,0,1
44927221,1,0,0,0,1
44924968,0,0,1,0,1
44887928,0,0,0,1,1
44887757,1,0,0,0,1
45082547,1,0,0,0,1
45085848,0,0,1,0,1
45093051,0,0,1,0,1
45101237,1,0,0,0,1
45293333,0,0,0,1,1
45293248,1,0,0,0,1
45286894,1,0,0,0,1
45267566,0,0,1,0,1
45247861,1,0,0,0,1
45247495,1,0,0,0,1
45239300,1,0,0,0,1
45226868,1,0,0,0,1
45208389,1,0,0,0,1
45201692,1,0,0,0,1
45198805,1,0,0,0,1
45197707,1,0,0,0,1
45197192,1,0,0,0,1
45192944,1,0,0,0,1
45168846,1,0,0,0,1
45166068,1,0,0,0,1
45155504,1,0,0,0,1
45143217,1,0,0,0,1
45103252,0,0,1,0,1
45623372,0,0,1,0,1
45625618,1,0,0,0,1
45628363,0,0,1,0,1
46178050,0,0,0,1,1
46222477,1,0,0,0,1
46220916,1,0,0,0,1
46220101,0,0,1,0,1
46201715,0,0,1,0,1
46200692,1,0,0,0,1
46182994,1,0,0,0,1
46182625,0,0,1,0,1
46182242,1,0,0,0,1
46180583,0,0,1,0,1
46176891,1,0,0,0,1
45656701,1,0,0,0,1
46174078,1,0,0,0,1
46109528,0,0,1,0,1
46108407,1,0,0,0,1
46096478,0,0,1,0,1
46094733,1,0,0,0,1
46087238,0,0,1,0,1
46083939,1,0,0,0,1
46068130,1,0,0,0,1
46038731,0,0,1,0,1
46224196,0,0,0,1,1
46224845,1,0,0,0,1
46234202,1,0,0,0,1
46252162,1,0,0,0,1
46404051,1,0,0,0,1
46401675,0,0,1,0,1
46399563,0,0,1,0,1
46395463,1,0,0,0,1
46382018,1,0,0,0,1
46370904,1,0,0,0,1
46329646,1,0,0,0,1
46329096,0,0,1,0,1
46324691,1,0,0,0,1
46323876,1,0,0,0,1
46317725,1,0,0,0,1
46312628,1,0,0,0,1
46311875,0,0,1,0,1
46309248,0,0,1,0,1
46301997,0,0,1,0,1
46296435,1,0,0,0,1
46289881,1,0,0,0,1
46257760,1,0,0,0,1
46256682,0,0,1,0,1
46015557,0,0,1,0,1
46013146,0,0,1,0,1
45994853,1,0,0,0,1
45854238,1,0,0,0,1
45832664,0,0,1,0,1
45830633,0,0,1,0,1
45824326,1,0,0,0,1
45815117,1,0,0,0,1
45786960,0,0,1,0,1
45778782,1,0,0,0,1
45775461,0,0,1,0,1
45774825,1,0,0,0,1
45763784,1,0,0,0,1
45754257,0,0,1,0,1
45748188,0,0,1,0,1
45732625,1,0,0,0,1
45700928,1,0,0,0,1
45697173,1,0,0,0,1
45694734,0,0,1,0,1
45690587,1,0,0,0,1
45688062,0,0,1,0,1
45677054,1,0,0,0,1
45673606,0,0,1,0,1
45850983,1,0,0,0,1
45858744,0,0,1,0,1
45994562,0,0,1,0,1
45859613,1,0,0,0,1
45958654,1,0,0,0,1
45955013,1,0,0,0,1
45951143,0,0,1,0,1
45950544,1,0,0,0,1
45949720,1,0,0,0,1
45944558,0,0,1,0,1
45941973,0,0,1,0,1
45941254,0,0,1,0,1
45935367,0,0,1,0,1
45934567,0,0,1,0,1
45928403,0,0,1,0,1
45927588,0,0,1,0,1
45924792,1,0,0,0,1
45922975,1,0,0,0,1
45921092,0,0,1,0,1
45913415,0,0,1,0,1
45909314,0,0,1,0,1
45864201,1,0,0,0,1
45859780,0,0,1,0,1
28704372,1,0,0,0,1
28699661,1,0,0,0,1
13013978,1,0,0,0,1
17576229,1,0,0,0,1
17619450,0,0,1,0,1
17618198,0,0,1,0,1
17617027,1,0,0,0,1
17616658,1,0,0,0,1
17616305,0,0,1,0,1
17601262,1,0,0,0,1
17599413,1,0,0,0,1
17594508,1,0,0,0,1
17592620,1,0,0,0,1
17575348,1,0,0,0,1
17530762,1,0,0,0,1
17572238,1,0,0,0,1
17568735,1,0,0,0,1
17565034,1,0,0,0,1
17557097,0,0,1,0,1
17556768,0,0,1,0,1
17551871,1,0,0,0,1
17550546,1,0,0,0,1
17544112,1,0,0,0,1
17543924,0,0,1,0,1
17631246,1,0,0,0,1
17634934,1,0,0,0,1
17638955,1,0,0,0,1
17647550,1,0,0,0,1
17767705,0,0,1,0,1
17766289,0,0,1,0,1
17764574,0,0,1,0,1
17760140,1,0,0,0,1
17742578,1,0,0,0,1
17739111,1,0,0,0,1
17737894,1,0,0,0,1
17737666,1,0,0,0,1
17737517,0,0,1,0,1
17719747,1,0,0,0,1
17719708,0,0,1,0,1
17682312,0,0,1,0,1
17682043,1,0,0,0,1
17681072,1,0,0,0,1
17680372,1,0,0,0,1
17675081,0,0,1,0,1
17673366,0,0,1,0,1
17672907,0,0,1,0,1
17658078,0,0,1,0,1
17540607,1,0,0,0,1
17529646,0,0,1,0,1
17770598,1,0,0,0,1
17384869,0,0,1,0,1
17429844,1,0,0,0,1
17428620,0,0,1,0,1
17425841,1,0,0,0,1
17420347,0,0,1,0,1
17419817,0,0,1,0,1
17414475,0,0,1,0,1
17408626,1,0,0,0,1
17389236,1,0,0,0,1
17385374,0,0,1,0,1
17383399,1,0,0,0,1
17527800,1,0,0,0,1
17382731,0,0,1,0,1
17382149,0,0,1,0,1
17381128,0,0,1,0,1
17380286,1,0,0,0,1
17379284,1,0,0,0,1
17371775,0,0,1,0,1
17371022,0,0,1,0,1
17367500,1,0,0,0,1
17365319,0,0,1,0,1
17444700,1,0,0,0,1
17452999,0,0,1,0,1
17456385,1,0,0,0,1
17459413,1,0,0,0,1
17525930,0,0,1,0,1
17525654,1,0,0,0,1
17523196,1,0,0,0,1
17518954,0,0,1,0,1
17507097,1,0,0,0,1
17506042,1,0,0,0,1
17501091,0,0,1,0,1
17498682,1,0,0,0,1
17497762,0,0,1,0,1
17490821,1,0,0,0,1
17480722,0,0,1,0,1
17478161,1,0,0,0,1
17475146,1,0,0,0,1
17475096,1,0,0,0,1
17473615,0,0,1,0,1
17465563,0,0,1,0,1
17465490,1,0,0,0,1
17463775,1,0,0,0,1
17462538,1,0,0,0,1
17770510,1,0,0,0,1
17770682,1,0,0,0,1
16548032,1,0,0,0,1
18060780,0,0,1,0,1
18111963,1,0,0,0,1
18105672,0,0,1,0,1
18104054,1,0,0,0,1
18094896,1,0,0,0,1
18093303,1,0,0,0,1
18091928,1,0,0,0,1
18091877,1,0,0,0,1
18066933,0,0,1,0,1
18065375,1,0,0,0,1
18051675,1,0,0,0,1
17984997,1,0,0,0,1
18049970,1,0,0,0,1
18048584,0,0,1,0,1
18043118,1,0,0,0,1
18042477,1,0,0,0,1
18041691,1,0,0,0,1
18038832,1,0,0,0,1
18018059,1,0,0,0,1
18008945,1,0,0,0,1
18007776,0,0,1,0,1
18115545,1,0,0,0,1
18138735,1,0,0,0,1
18139801,1,0,0,0,1
18142696,1,0,0,0,1
18270371,1,0,0,0,1
18264329,0,0,1,0,1
18260424,0,0,1,0,1
18259103,1,0,0,0,1
18254644,1,0,0,0,1
18226127,1,0,0,0,1
18220713,1,0,0,0,1
18214457,1,0,0,0,1
18209807,0,0,1,0,1
18208026,1,0,0,0,1
18202019,1,0,0,0,1
18198406,0,0,1,0,1
18192430,0,0,1,0,1
18189742,1,0,0,0,1
18170333,0,0,1,0,1
18167404,0,0,1,0,1
18167085,1,0,0,0,1
18163268,1,0,0,0,1
18142892,1,0,0,0,1
18007143,0,0,1,0,1
17982486,1,0,0,0,1
17770967,1,0,0,0,1
17833051,1,0,0,0,1
17860156,0,0,1,0,1
17853061,1,0,0,0,1
17848391,1,0,0,0,1
17848380,1,0,0,0,1
17848036,0,0,1,0,1
17845933,1,0,0,0,1
17844480,1,0,0,0,1
17842194,0,0,1,0,1
17838718,1,0,0,0,1
17832807,0,0,1,0,1
17981316,1,0,0,0,1
17831516,1,0,0,0,1
17824959,0,0,1,0,1
17820666,1,0,0,0,1
17820079,0,0,1,0,1
17797698,0,0,1,0,1
17794638,0,0,1,0,1
17791294,0,0,1,0,1
17775359,1,0,0,0,1
17772042,1,0,0,0,1
17861935,1,0,0,0,1
17870643,1,0,0,0,1
17871237,0,0,1,0,1
17873135,1,0,0,0,1
17981136,1,0,0,0,1
17958831,1,0,0,0,1
17958459,1,0,0,0,1
17956111,1,0,0,0,1
17944053,1,0,0,0,1
17942384,1,0,0,0,1
17925599,0,0,1,0,1
17923141,1,0,0,0,1
17906387,0,0,1,0,1
17898332,1,0,0,0,1
17898189,1,0,0,0,1
17893360,1,0,0,0,1
17891677,1,0,0,0,1
17889038,0,0,1,0,1
17888644,1,0,0,0,1
17888612,1,0,0,0,1
17887542,1,0,0,0,1
17879321,1,0,0,0,1
17877302,1,0,0,0,1
17347754,1,0,0,0,1
17347275,1,0,0,0,1
17345576,0,0,0,1,1
16781567,0,0,1,0,1
16826094,1,0,0,0,1
16823940,1,0,0,0,1
16809858,1,0,0,0,1
16795575,0,0,1,0,1
16794996,1,0,0,0,1
16794494,0,0,1,0,1
16792346,1,0,0,0,1
16782911,1,0,0,0,1
16782056,1,0,0,0,1
16768238,1,0,0,0,1
16713474,1,0,0,0,1
16765013,1,0,0,0,1
16762482,0,0,1,0,1
16761703,1,0,0,0,1
16753102,1,0,0,0,1
16751902,0,0,1,0,1
16727332,0,0,1,0,1
16725099,1,0,0,0,1
16721721,0,0,1,0,1
16720485,1,0,0,0,1
16828535,1,0,0,0,1
16838156,1,0,0,0,1
16853124,1,0,0,0,1
16855791,0,0,1,0,1
16949652,1,0,0,0,1
16947051,1,0,0,0,1
16934136,0,0,1,0,1
16929950,1,0,0,0,1
16926937,1,0,0,0,1
16926880,0,0,1,0,1
16923190,0,0,1,0,1
16919101,0,0,1,0,1
16916408,1,0,0,0,1
16911403,1,0,0,0,1
16911296,0,0,1,0,1
16910623,1,0,0,0,1
16903474,1,0,0,0,1
16897284,1,0,0,0,1
16883913,0,0,1,0,1
16881300,0,0,1,0,1
16879147,0,0,1,0,1
16864813,1,0,0,0,1
16860700,1,0,0,0,1
16718650,0,0,1,0,1
16713332,0,0,1,0,1
17339848,1,0,0,0,1
16583238,1,0,0,0,1
16616158,1,0,0,0,1
16598550,1,0,0,0,1
16597520,0,0,1,0,1
16597509,1,0,0,0,1
16596651,1,0,0,0,1
16595498,1,0,0,0,1
16593547,1,0,0,0,1
16591072,1,0,0,0,1
16586817,1,0,0,0,1
16574437,1,0,0,0,1
16708043,0,0,1,0,1
16572957,0,0,1,0,1
16572955,0,0,1,0,1
16572580,0,0,1,0,1
16570892,1,0,0,0,1
16569168,1,0,0,0,1
16568465,0,0,1,0,1
16549535,1,0,0,0,1
16549175,1,0,0,0,1
16548665,1,0,0,0,1
16617640,1,0,0,0,1
16617981,0,0,1,0,1
16625210,1,0,0,0,1
16627758,0,0,1,0,1
16707319,0,0,1,0,1
16705993,0,0,1,0,1
16702803,1,0,0,0,1
16686968,0,0,1,0,1
16686426,0,0,1,0,1
16684717,0,0,1,0,1
16683850,1,0,0,0,1
16682678,1,0,0,0,1
16682397,1,0,0,0,1
16677444,0,0,1,0,1
16675838,1,0,0,0,1
16666294,1,0,0,0,1
16664390,1,0,0,0,1
16662303,0,0,1,0,1
16641600,1,0,0,0,1
16639428,1,0,0,0,1
16639377,0,0,1,0,1
16638733,1,0,0,0,1
16632017,1,0,0,0,1
16954469,0,0,1,0,1
16960038,0,0,1,0,1
16960158,0,0,1,0,1
17198795,1,0,0,0,1
17225790,1,0,0,0,1
17224232,0,0,0,1,1
17221402,0,0,1,0,1
17218010,1,0,0,0,1
17215474,0,0,1,0,1
17213431,1,0,0,0,1
17212510,1,0,0,0,1
17211451,1,0,0,0,1
17204066,0,0,1,0,1
17193773,1,0,0,0,1
16962160,0,0,1,0,1
17191693,0,0,1,0,1
17184568,0,0,1,0,1
17183013,0,0,1,0,1
17181881,1,0,0,0,1
17178268,0,0,1,0,1
17176974,1,0,0,0,1
17164818,1,0,0,0,1
17163531,0,0,1,0,1
17156658,0,0,1,0,1
17227473,1,0,0,0,1
17232044,0,0,1,0,1
17234494,0,0,1,0,1
17239096,0,0,1,0,1
17330506,0,0,1,0,1
17326743,0,0,1,0,1
17322363,1,0,0,0,1
17314413,1,0,0,0,1
17312454,1,0,0,0,1
17289499,1,0,0,0,1
17286936,1,0,0,0,1
17274880,0,0,1,0,1
17271293,1,0,0,0,1
17266991,0,0,1,0,1
17266546,1,0,0,0,1
17265086,1,0,0,0,1
17261034,0,0,1,0,1
17259339,1,0,0,0,1
17258663,1,0,0,0,1
17256091,1,0,0,0,1
17247976,1,0,0,0,1
17244404,1,0,0,0,1
17241205,1,0,0,0,1
17155244,1,0,0,0,1
17153180,0,0,1,0,1
17153037,0,0,1,0,1
17055374,1,0,0,0,1
17051015,1,0,0,0,1
17041154,1,0,0,0,1
17019201,0,0,1,0,1
17018997,1,0,0,0,1
17018355,1,0,0,0,1
17012496,0,0,1,0,1
17011560,1,0,0,0,1
17010910,1,0,0,0,1
17005953,1,0,0,0,1
17000648,1,0,0,0,1
16989237,1,0,0,0,1
16977462,0,0,1,0,1
16976271,0,0,1,0,1
16970067,0,0,1,0,1
16969920,1,0,0,0,1
16968100,0,0,1,0,1
16963843,1,0,0,0,1
16962694,0,0,1,0,1
16962600,1,0,0,0,1
17052634,0,0,1,0,1
17062221,1,0,0,0,1
17151343,0,0,1,0,1
17065519,1,0,0,0,1
17145227,1,0,0,0,1
17139611,1,0,0,0,1
17132728,1,0,0,0,1
17122534,1,0,0,0,1
17118501,0,0,1,0,1
17116465,1,0,0,0,1
17110907,0,0,1,0,1
17108681,1,0,0,0,1
17108566,1,0,0,0,1
17106992,1,0,0,0,1
17102153,1,0,0,0,1
17101801,1,0,0,0,1
17087544,1,0,0,0,1
17085996,1,0,0,0,1
17085442,1,0,0,0,1
17084566,1,0,0,0,1
17079377,0,0,1,0,1
17076357,1,0,0,0,1
17066941,0,0,1,0,1
18272255,1,0,0,0,1
18277294,0,0,1,0,1
18283992,1,0,0,0,1
19693990,1,0,0,0,1
19755511,1,0,0,0,1
19750664,1,0,0,0,1
19749140,1,0,0,0,1
19740343,1,0,0,0,1
19739033,0,0,1,0,1
19735589,1,0,0,0,1
19735540,0,0,1,0,1
19734419,1,0,0,0,1
19703184,1,0,0,0,1
19692901,1,0,0,0,1
19640594,1,0,0,0,1
19692652,0,0,1,0,1
19688038,1,0,0,0,1
19679637,0,0,1,0,1
19660044,0,0,1,0,1
19659393,1,0,0,0,1
19655924,1,0,0,0,1
19655631,1,0,0,0,1
19653318,0,0,1,0,1
19650141,0,0,1,0,1
19758346,1,0,0,0,1
19785181,1,0,0,0,1
19789003,0,0,1,0,1
19789539,0,0,1,0,1
19874128,0,0,1,0,1
19868844,0,0,1,0,1
19866179,0,0,1,0,1
19864547,1,0,0,0,1
19859349,1,0,0,0,1
19850240,0,0,1,0,1
19847352,1,0,0,0,1
19842087,0,0,1,0,1
19839188,1,0,0,0,1
19838610,0,0,1,0,1
19834927,0,0,1,0,1
19834743,1,0,0,0,1
19831141,1,0,0,0,1
19810363,1,0,0,0,1
19808313,1,0,0,0,1
19806882,1,0,0,0,1
19802029,1,0,0,0,1
19800918,0,0,1,0,1
19791955,1,0,0,0,1
19644902,1,0,0,0,1
19638778,0,0,1,0,1
19408182,0,0,1,0,1
19480603,0,0,1,0,1
19510896,0,0,1,0,1
19510462,1,0,0,0,1
19510122,0,0,1,0,1
19509387,1,0,0,0,1
19508332,1,0,0,0,1
19504744,0,0,0,1,1
19504544,0,0,1,0,1
19498957,0,0,1,0,1
19491505,1,0,0,0,1
19478732,1,0,0,0,1
19638238,0,0,1,0,1
19474504,1,0,0,0,1
19471714,1,0,0,0,1
19466874,1,0,0,0,1
19464893,1,0,0,0,1
19458285,1,0,0,0,1
19457310,1,0,0,0,1
19435113,1,0,0,0,1
19419141,0,0,1,0,1
19409609,1,0,0,0,1
19512999,1,0,0,0,1
19529332,0,0,1,0,1
19529891,1,0,0,0,1
19534131,0,0,1,0,1
19634331,1,0,0,0,1
19630705,1,0,0,0,1
19627702,1,0,0,0,1
19600872,0,0,1,0,1
19595683,0,0,1,0,1
19591194,1,0,0,0,1
19586959,1,0,0,0,1
19585203,1,0,0,0,1
19578509,1,0,0,0,1
19572312,0,0,1,0,1
19569903,1,0,0,0,1
19569282,0,0,1,0,1
19561602,1,0,0,0,1
19557813,1,0,0,0,1
19547144,1,0,0,0,1
19543830,0,0,1,0,1
19541889,1,0,0,0,1
19537871,0,0,1,0,1
19536409,1,0,0,0,1
19875386,1,0,0,0,1
19876158,0,0,1,0,1
19877163,0,0,1,0,1
20172814,1,0,0,0,1
20220433,1,0,0,0,1
20219152,0,0,1,0,1
20217469,0,0,1,0,1
20196756,1,0,0,0,1
20192028,0,0,1,0,1
20181084,0,0,1,0,1
20178795,1,0,0,0,1
20177190,0,0,1,0,1
20177186,1,0,0,0,1
20170794,1,0,0,0,1
19878684,0,0,0,1,1
20167238,1,0,0,0,1
20166817,1,0,0,0,1
20164973,1,0,0,0,1
20164579,0,0,1,0,1
20163996,1,0,0,0,1
20160518,0,0,1,0,1
20156894,0,0,1,0,1
20154754,0,0,1,0,1
20136355,1,0,0,0,1
20220930,0,0,1,0,1
20222164,1,0,0,0,1
20222165,0,0,1,0,1
20222376,0,0,1,0,1
20309915,1,0,0,0,1
20287808,1,0,0,0,1
20283471,1,0,0,0,1
20279155,1,0,0,0,1
20279153,1,0,0,0,1
20273041,1,0,0,0,1
20271650,0,0,1,0,1
20271527,1,0,0,0,1
20266976,0,0,1,0,1
20241220,0,0,1,0,1
20241112,1,0,0,0,1
20239669,1,0,0,0,1
20237633,0,0,1,0,1
20236928,1,0,0,0,1
20235276,1,0,0,0,1
20234611,1,0,0,0,1
20233558,1,0,0,0,1
20232428,0,0,1,0,1
20223894,1,0,0,0,1
20134231,0,0,1,0,1
20133610,0,0,1,0,1
20121732,0,0,1,0,1
20018795,1,0,0,0,1
20008462,1,0,0,0,1
20007675,1,0,0,0,1
20006428,1,0,0,0,1
19996277,1,0,0,0,1
19983675,0,0,1,0,1
19977987,1,0,0,0,1
19976579,1,0,0,0,1
19975102,1,0,0,0,1
19965673,0,0,1,0,1
19965375,0,0,1,0,1
19955930,0,0,0,1,1
19955578,0,0,1,0,1
19940836,0,0,1,0,1
19930911,1,0,0,0,1
19927798,1,0,0,0,1
19922549,1,0,0,0,1
19900075,0,0,1,0,1
19900030,1,0,0,0,1
19885346,0,0,1,0,1
20017962,0,0,1,0,1
20019653,0,0,1,0,1
20118062,0,0,1,0,1
20021635,0,0,1,0,1
20117485,1,0,0,0,1
20115148,1,0,0,0,1
20113500,1,0,0,0,1
20109188,1,0,0,0,1
20104851,1,0,0,0,1
20092101,1,0,0,0,1
20090450,1,0,0,0,1
20086355,0,0,1,0,1
20069770,0,0,1,0,1
20068971,1,0,0,0,1
20067071,1,0,0,0,1
20056779,1,0,0,0,1
20052489,1,0,0,0,1
20047729,0,0,1,0,1
20044978,0,0,0,1,1
20037314,0,0,1,0,1
20034804,1,0,0,0,1
20033436,0,0,1,0,1
20030974,1,0,0,0,1
19408191,1,0,0,0,1
19407197,0,0,1,0,1
18284376,1,0,0,0,1
18670647,1,0,0,0,1
18694441,1,0,0,0,1
18693665,1,0,0,0,1
18692297,0,0,1,0,1
18690148,1,0,0,0,1
18683197,1,0,0,0,1
18681479,0,0,1,0,1
18678912,1,0,0,0,1
18674671,0,0,1,0,1
18671223,0,0,1,0,1
18668835,1,0,0,0,1
18594883,0,0,1,0,1
18664080,1,0,0,0,1
18655355,0,0,1,0,1
18654847,0,0,1,0,1
18653145,1,0,0,0,1
18646528,1,0,0,0,1
18609156,1,0,0,0,1
18608785,1,0,0,0,1
18605299,0,0,1,0,1
18600626,1,0,0,0,1
18697326,1,0,0,0,1
18712636,1,0,0,0,1
18726889,1,0,0,0,1
18727732,1,0,0,0,1
18834080,1,0,0,0,1
18833883,1,0,0,0,1
18831006,1,0,0,0,1
18830662,0,0,1,0,1
18825679,1,0,0,0,1
18824752,1,0,0,0,1
18810552,0,0,1,0,1
18802626,0,0,1,0,1
18799694,1,0,0,0,1
18770940,0,0,1,0,1
18767788,1,0,0,0,1
18763685,1,0,0,0,1
18762837,1,0,0,0,1
18753186,1,0,0,0,1
18750238,1,0,0,0,1
18746337,1,0,0,0,1
18743582,1,0,0,0,1
18732561,1,0,0,0,1
18730893,0,0,1,0,1
18599809,1,0,0,0,1
18594426,1,0,0,0,1
19400984,1,0,0,0,1
18382740,1,0,0,0,1
18474702,1,0,0,0,1
18462292,1,0,0,0,1
18458368,1,0,0,0,1
18451417,0,0,1,0,1
18419593,0,0,1,0,1
18412434,1,0,0,0,1
18405982,0,0,1,0,1
18403410,0,0,1,0,1
18388112,1,0,0,0,1
18370504,0,0,1,0,1
18591697,0,0,1,0,1
18351549,1,0,0,0,1
18343265,0,0,1,0,1
18342421,1,0,0,0,1
18333085,1,0,0,0,1
18320031,1,0,0,0,1
18305503,1,0,0,0,1
18289867,0,0,1,0,1
18287406,0,0,1,0,1
18286622,1,0,0,0,1
18481424,1,0,0,0,1
18486833,0,0,1,0,1
18488454,1,0,0,0,1
18489745,0,0,1,0,1
18588115,1,0,0,0,1
18586628,0,0,1,0,1
18579864,1,0,0,0,1
18576994,0,0,1,0,1
18575991,1,0,0,0,1
18570567,1,0,0,0,1
18569998,1,0,0,0,1
18566028,1,0,0,0,1
18565670,0,0,1,0,1
18556644,1,0,0,0,1
18554823,1,0,0,0,1
18547000,0,0,0,1,1
18527346,0,0,1,0,1
18523979,0,0,1,0,1
18515933,0,0,1,0,1
18511925,1,0,0,0,1
18511357,0,0,1,0,1
18506733,1,0,0,0,1
18492106,0,0,1,0,1
18838868,1,0,0,0,1
18841819,0,0,1,0,1
18864992,1,0,0,0,1
19202140,1,0,0,0,1
19242857,1,0,0,0,1
19240279,0,0,1,0,1
19238497,0,0,1,0,1
19235293,1,0,0,0,1
19233588,1,0,0,0,1
19228782,1,0,0,0,1
19227044,1,0,0,0,1
19226492,0,0,1,0,1
19202566,1,0,0,0,1
19179837,1,0,0,0,1
18866837,0,0,1,0,1
19175487,1,0,0,0,1
19168930,1,0,0,0,1
19163998,0,0,1,0,1
19143974,0,0,1,0,1
19141737,1,0,0,0,1
19139463,1,0,0,0,1
19135883,1,0,0,0,1
19135506,1,0,0,0,1
19130629,0,0,1,0,1
19244346,1,0,0,0,1
19250606,1,0,0,0,1
19251040,0,0,1,0,1
19258174,1,0,0,0,1
19395095,0,0,1,0,1
19393988,1,0,0,0,1
19390428,1,0,0,0,1
19390192,1,0,0,0,1
19380568,1,0,0,0,1
19374097,0,0,1,0,1
19359650,0,0,1,0,1
19340034,0,0,1,0,1
19338842,1,0,0,0,1
19338074,1,0,0,0,1
19336311,1,0,0,0,1
19331883,1,0,0,0,1
19306238,1,0,0,0,1
19300279,1,0,0,0,1
19298428,1,0,0,0,1
19297877,0,0,1,0,1
19294795,1,0,0,0,1
19282734,1,0,0,0,1
19264942,1,0,0,0,1
19124621,0,0,1,0,1
19111611,1,0,0,0,1
19101984,1,0,0,0,1
18953786,1,0,0,0,1
18940748,1,0,0,0,1
18940662,1,0,0,0,1
18934709,0,0,1,0,1
18933388,1,0,0,0,1
18929364,1,0,0,0,1
18925854,1,0,0,0,1
18922831,1,0,0,0,1
18922562,0,0,1,0,1
18900298,0,0,1,0,1
18893401,1,0,0,0,1
18887576,1,0,0,0,1
18886072,0,0,1,0,1
18884557,1,0,0,0,1
18883243,0,0,1,0,1
18881301,0,0,1,0,1
18876264,1,0,0,0,1
18874199,1,0,0,0,1
18873268,0,0,1,0,1
18870872,1,0,0,0,1
18941320,1,0,0,0,1
18954159,0,0,1,0,1
19072805,1,0,0,0,1
18957069,1,0,0,0,1
19071455,1,0,0,0,1
19066350,1,0,0,0,1
19059946,0,0,1,0,1
19056507,1,0,0,0,1
19049309,0,0,1,0,1
19046961,0,0,1,0,1
19044783,0,0,1,0,1
19044620,0,0,1,0,1
19034179,1,0,0,0,1
19007308,1,0,0,0,1
19006966,0,0,1,0,1
19004207,1,0,0,0,1
19000672,0,0,1,0,1
18998261,0,0,1,0,1
18990231,1,0,0,0,1
18987128,1,0,0,0,1
18985761,1,0,0,0,1
18981759,0,0,1,0,1
18978289,1,0,0,0,1
16548316,0,0,1,0,1
16547637,0,0,1,0,1
20319948,1,0,0,0,1
14258860,1,0,0,0,1
14291250,0,0,1,0,1
14290161,1,0,0,0,1
14283205,0,0,1,0,1
14278457,0,0,1,0,1
14278450,1,0,0,0,1
14276413,1,0,0,0,1
14273136,1,0,0,0,1
14264966,0,0,1,0,1
14262697,1,0,0,0,1
14252950,1,0,0,0,1
14174901,1,0,0,0,1
14249909,0,0,1,0,1
14249332,0,0,1,0,1
14239676,1,0,0,0,1
14235190,1,0,0,0,1
14235061,0,0,1,0,1
14231957,1,0,0,0,1
14200913,0,0,1,0,1
14197781,1,0,0,0,1
14196588,1,0,0,0,1
14291958,0,0,1,0,1
14294841,0,0,1,0,1
14295613,1,0,0,0,1
14295824,0,0,1,0,1
14378244,1,0,0,0,1
14374073,1,0,0,0,1
14368288,1,0,0,0,1
14366869,0,0,1,0,1
14360314,1,0,0,0,1
14358525,1,0,0,0,1
14332985,1,0,0,0,1
14329995,1,0,0,0,1
14328715,1,0,0,0,1
14327476,1,0,0,0,1
14324326,0,0,1,0,1
14318669,1,0,0,0,1
14317804,1,0,0,0,1
14317260,1,0,0,0,1
14315424,1,0,0,0,1
14314420,1,0,0,0,1
14314393,1,0,0,0,1
14297465,1,0,0,0,1
14296610,1,0,0,0,1
14194388,0,0,1,0,1
14168640,1,0,0,0,1
14380456,0,0,1,0,1
14011859,1,0,0,0,1
14053042,1,0,0,0,1
14049772,1,0,0,0,1
14035846,0,0,1,0,1
14035480,1,0,0,0,1
14035150,1,0,0,0,1
14022130,1,0,0,0,1
14020493,1,0,0,0,1
14019963,0,0,1,0,1
14018666,0,0,1,0,1
14005489,1,0,0,0,1
14163479,1,0,0,0,1
14001033,0,0,1,0,1
13989494,0,0,1,0,1
13976132,1,0,0,0,1
13974626,1,0,0,0,1
13974214,1,0,0,0,1
13972159,1,0,0,0,1
13968910,1,0,0,0,1
13954781,1,0,0,0,1
13951574,0,0,1,0,1
14058714,1,0,0,0,1
14060030,1,0,0,0,1
14061805,1,0,0,0,1
14064072,0,0,1,0,1
14162601,1,0,0,0,1
14159944,1,0,0,0,1
14157243,1,0,0,0,1
14156628,1,0,0,0,1
14152383,1,0,0,0,1
14142169,1,0,0,0,1
14140782,0,0,1,0,1
14139236,1,0,0,0,1
14138135,1,0,0,0,1
14120733,0,0,1,0,1
14117835,1,0,0,0,1
14103679,0,0,1,0,1
14103310,0,0,1,0,1
14102923,0,0,1,0,1
14092176,1,0,0,0,1
14087588,1,0,0,0,1
14086478,0,0,1,0,1
14084903,1,0,0,0,1
14081811,1,0,0,0,1
14379366,1,0,0,0,1
14383655,1,0,0,0,1
16545323,1,0,0,0,1
14684238,1,0,0,0,1
14713587,0,0,1,0,1
14713321,0,0,1,0,1
14710145,0,0,1,0,1
14707270,1,0,0,0,1
14697084,1,0,0,0,1
14694408,0,0,1,0,1
14691130,1,0,0,0,1
14687687,1,0,0,0,1
14684764,1,0,0,0,1
14680684,1,0,0,0,1
14603774,1,0,0,0,1
14680337,0,0,1,0,1
14667282,0,0,1,0,1
14664356,1,0,0,0,1
14651590,1,0,0,0,1
14641776,1,0,0,0,1
14635561,1,0,0,0,1
14621589,0,0,1,0,1
14611780,1,0,0,0,1
14608584,1,0,0,0,1
14715701,1,0,0,0,1
14720647,1,0,0,0,1
14722556,1,0,0,0,1
14722881,1,0,0,0,1
14793862,1,0,0,0,1
14789017,0,0,1,0,1
14786085,1,0,0,0,1
14785032,0,0,1,0,1
14772147,0,0,1,0,1
14768898,1,0,0,0,1
14764376,0,0,1,0,1
14759766,1,0,0,0,1
14759473,1,0,0,0,1
14758945,1,0,0,0,1
14751888,0,0,1,0,1
14751594,1,0,0,0,1
14747290,1,0,0,0,1
14736455,1,0,0,0,1
14731964,0,0,1,0,1
14730409,0,0,1,0,1
14727039,1,0,0,0,1
14726038,0,0,1,0,1
14725504,0,0,1,0,1
14607718,1,0,0,0,1
14601436,1,0,0,0,1
14384914,0,0,1,0,1
14456700,1,0,0,0,1
14503638,1,0,0,0,1
14499116,1,0,0,0,1
14495913,1,0,0,0,1
14482395,1,0,0,0,1
14476679,0,0,1,0,1
14472525,1,0,0,0,1
14470110,1,0,0,0,1
14466771,1,0,0,0,1
14461742,1,0,0,0,1
14447643,1,0,0,0,1
14600914,1,0,0,0,1
14444017,1,0,0,0,1
14438618,1,0,0,0,1
14435697,1,0,0,0,1
14430349,0,0,1,0,1
14422667,1,0,0,0,1
14416504,0,0,1,0,1
14404488,1,0,0,0,1
14396207,0,0,1,0,1
14391637,1,0,0,0,1
14505375,0,0,1,0,1
14512391,1,0,0,0,1
14517584,0,0,1,0,1
14521416,1,0,0,0,1
14593603,1,0,0,0,1
14590096,1,0,0,0,1
14588919,1,0,0,0,1
14586567,1,0,0,0,1
14582705,1,0,0,0,1
14565422,1,0,0,0,1
14565233,1,0,0,0,1
14564591,1,0,0,0,1
14561264,1,0,0,0,1
14561160,1,0,0,0,1
14559352,1,0,0,0,1
14555746,1,0,0,0,1
14549202,1,0,0,0,1
14546480,1,0,0,0,1
14545465,1,0,0,0,1
14544355,1,0,0,0,1
14538085,1,0,0,0,1
14524071,1,0,0,0,1
14521821,1,0,0,0,1
13946450,0,0,1,0,1
13937830,1,0,0,0,1
13934498,1,0,0,0,1
13291840,1,0,0,0,1
13322259,1,0,0,0,1
13321649,1,0,0,0,1
13314076,1,0,0,0,1
13313020,0,0,0,1,1
13312279,1,0,0,0,1
13307277,1,0,0,0,1
13304615,0,0,1,0,1
13303603,1,0,0,0,1
13297495,1,0,0,0,1
13284260,1,0,0,0,1
13209857,1,0,0,0,1
13283118,1,0,0,0,1
13278817,1,0,0,0,1
13275837,1,0,0,0,1
13272957,0,0,1,0,1
13270449,0,0,1,0,1
13269546,1,0,0,0,1
13262918,1,0,0,0,1
13224803,1,0,0,0,1
13219494,1,0,0,0,1
13322715,1,0,0,0,1
13322744,1,0,0,0,1
13324284,1,0,0,0,1
13337141,1,0,0,0,1
13448824,0,0,1,0,1
13440686,0,0,1,0,1
13425453,0,0,1,0,1
13425452,1,0,0,0,1
13414796,1,0,0,0,1
13412408,0,0,1,0,1
13405138,1,0,0,0,1
13402436,1,0,0,0,1
13400096,1,0,0,0,1
13392472,1,0,0,0,1
13392284,1,0,0,0,1
13379749,0,0,1,0,1
13373889,0,0,1,0,1
13360423,1,0,0,0,1
13356805,0,0,1,0,1
13351185,1,0,0,0,1
13348283,1,0,0,0,1
13341919,0,0,1,0,1
13340829,0,0,1,0,1
13212779,1,0,0,0,1
13208109,0,0,1,0,1
13929469,0,0,1,0,1
13040838,1,0,0,0,1
13089720,1,0,0,0,1
13081524,0,0,1,0,1
13077418,1,0,0,0,1
13076168,0,0,1,0,1
13068601,1,0,0,0,1
13060798,0,0,1,0,1
13046376,1,0,0,0,1
13043852,1,0,0,0,1
13042298,1,0,0,0,1
13036811,1,0,0,0,1
13207691,0,0,1,0,1
13034246,0,0,1,0,1
13033706,1,0,0,0,1
13032983,1,0,0,0,1
13031522,1,0,0,0,1
13031379,1,0,0,0,1
13027278,1,0,0,0,1
13026391,1,0,0,0,1
13025262,0,0,1,0,1
13023370,1,0,0,0,1
13092234,0,0,1,0,1
13093738,1,0,0,0,1
13094498,0,0,1,0,1
13107477,1,0,0,0,1
13207016,1,0,0,0,1
13200818,0,0,1,0,1
13187650,1,0,0,0,1
13175303,1,0,0,0,1
13168457,0,0,1,0,1
13165300,1,0,0,0,1
13164593,0,0,1,0,1
13161042,1,0,0,0,1
13156191,0,0,0,1,1
13148824,1,0,0,0,1
13137787,0,0,1,0,1
13135873,1,0,0,0,1
13134612,1,0,0,0,1
13132515,0,0,1,0,1
13129524,1,0,0,0,1
13128030,1,0,0,0,1
13125674,0,0,1,0,1
13109606,1,0,0,0,1
13109081,1,0,0,0,1
13451102,0,0,1,0,1
13454974,1,0,0,0,1
13456636,1,0,0,0,1
13784676,1,0,0,0,1
13833292,1,0,0,0,1
13832446,1,0,0,0,1
13829968,1,0,0,0,1
13825378,0,0,1,0,1
13794250,0,0,1,0,1
13794148,0,0,1,0,1
13791418,1,0,0,0,1
13789963,1,0,0,0,1
13788158,1,0,0,0,1
13775180,1,0,0,0,1
13460023,1,0,0,0,1
13768808,1,0,0,0,1
13762763,1,0,0,0,1
13755526,1,0,0,0,1
13755179,1,0,0,0,1
13754273,0,0,1,0,1
13753058,1,0,0,0,1
13736818,1,0,0,0,1
13733669,0,0,1,0,1
13731605,1,0,0,0,1
13838573,1,0,0,0,1
13839239,1,0,0,0,1
13859188,1,0,0,0,1
13865475,1,0,0,0,1
13929249,0,0,1,0,1
13917722,0,0,1,0,1
13909018,1,0,0,0,1
13908017,0,0,1,0,1
13907788,0,0,1,0,1
13905701,1,0,0,0,1
13898361,0,0,1,0,1
13897826,0,0,1,0,1
13896771,1,0,0,0,1
13891989,1,0,0,0,1
13888373,1,0,0,0,1
13888249,1,0,0,0,1
13888072,1,0,0,0,1
13887067,1,0,0,0,1
13885459,1,0,0,0,1
13878635,0,0,1,0,1
13873590,0,0,1,0,1
13873015,1,0,0,0,1
13866555,0,0,1,0,1
13730809,1,0,0,0,1
13717514,1,0,0,0,1
13715158,0,0,1,0,1
13561307,1,0,0,0,1
13541655,0,0,1,0,1
13536599,1,0,0,0,1
13535952,1,0,0,0,1
13530279,0,0,1,0,1
13529740,1,0,0,0,1
13525339,1,0,0,0,1
13524185,1,0,0,0,1
13518566,1,0,0,0,1
13509844,0,0,1,0,1
13502865,1,0,0,0,1
13501136,0,0,1,0,1
13490820,0,0,1,0,1
13486939,1,0,0,0,1
13481367,1,0,0,0,1
13466647,1,0,0,0,1
13465396,1,0,0,0,1
13463652,0,0,1,0,1
13461496,1,0,0,0,1
13460416,1,0,0,0,1
13543967,1,0,0,0,1
13565460,1,0,0,0,1
13713658,0,0,1,0,1
13603374,1,0,0,0,1
13713605,1,0,0,0,1
13708762,0,0,1,0,1
13705706,0,0,1,0,1
13698410,0,0,1,0,1
13693119,1,0,0,0,1
13678083,1,0,0,0,1
13667779,0,0,1,0,1
13667544,1,0,0,0,1
13667539,0,0,1,0,1
13664226,0,0,1,0,1
13644419,0,0,1,0,1
13644183,0,0,1,0,1
13643709,0,0,1,0,1
13637847,1,0,0,0,1
13632182,1,0,0,0,1
13617520,0,0,0,1,1
13616538,0,0,1,0,1
13607787,1,0,0,0,1
13605253,1,0,0,0,1
14796247,0,0,1,0,1
14805627,0,0,1,0,1
14805863,1,0,0,0,1
15927582,1,0,0,0,1
15985137,1,0,0,0,1
15980538,1,0,0,0,1
15978364,0,0,1,0,1
15969987,1,0,0,0,1
15960720,0,0,1,0,1
15954950,0,0,1,0,1
15942750,0,0,1,0,1
15939103,0,0,1,0,1
15932734,1,0,0,0,1
15912749,1,0,0,0,1
15859636,0,0,1,0,1
15910436,1,0,0,0,1
15907782,1,0,0,0,1
15904258,1,0,0,0,1
15899061,0,0,0,1,1
15897880,0,0,1,0,1
15892935,0,0,1,0,1
15887987,1,0,0,0,1
15880141,1,0,0,0,1
15872365,1,0,0,0,1
15990609,1,0,0,0,1
15995278,1,0,0,0,1
16000650,1,0,0,0,1
16003147,1,0,0,0,1
16118005,1,0,0,0,1
16112733,1,0,0,0,1
16112564,1,0,0,0,1
16108688,1,0,0,0,1
16106756,1,0,0,0,1
16096674,1,0,0,0,1
16091512,1,0,0,0,1
16089151,1,0,0,0,1
16081505,1,0,0,0,1
16069958,1,0,0,0,1
16069319,0,0,1,0,1
16068417,1,0,0,0,1
16052479,1,0,0,0,1
16051761,1,0,0,0,1
16050180,0,0,1,0,1
16044489,1,0,0,0,1
16019176,1,0,0,0,1
16016579,0,0,0,1,1
16009412,1,0,0,0,1
15863914,0,0,1,0,1
15858985,1,0,0,0,1
15642271,0,0,1,0,1
15675912,1,0,0,0,1
15730200,0,0,1,0,1
15729463,1,0,0,0,1
15723065,0,0,1,0,1
15722117,1,0,0,0,1
15717497,1,0,0,0,1
15702477,1,0,0,0,1
15697894,0,0,1,0,1
15697051,1,0,0,0,1
15679125,0,0,0,1,1
15674437,1,0,0,0,1
15857126,1,0,0,0,1
15672224,1,0,0,0,1
15670189,1,0,0,0,1
15655054,1,0,0,0,1
15653283,0,0,1,0,1
15651999,1,0,0,0,1
15651644,0,0,1,0,1
15651084,1,0,0,0,1
15649936,1,0,0,0,1
15649508,0,0,1,0,1
15730873,1,0,0,0,1
15743117,0,0,1,0,1
15743237,0,0,1,0,1
15758568,1,0,0,0,1
15855000,1,0,0,0,1
15853933,0,0,1,0,1
15853337,1,0,0,0,1
15853327,1,0,0,0,1
15833732,0,0,1,0,1
15831593,1,0,0,0,1
15823815,0,0,1,0,1
15821855,0,0,1,0,1
15817252,1,0,0,0,1
15815237,0,0,1,0,1
15809410,1,0,0,0,1
15808806,0,0,1,0,1
15807180,1,0,0,0,1
15788147,1,0,0,0,1
15778597,0,0,1,0,1
15775091,1,0,0,0,1
15763944,0,0,1,0,1
15762897,0,0,1,0,1
15760812,1,0,0,0,1
16142344,0,0,1,0,1
16143307,1,0,0,0,1
16152090,0,0,1,0,1
16402063,1,0,0,0,1
16430135,0,0,1,0,1
16427741,1,0,0,0,1
16426665,0,0,1,0,1
16425715,0,0,1,0,1
16419236,1,0,0,0,1
16418143,1,0,0,0,1
16414492,0,0,1,0,1
16413765,1,0,0,0,1
16404967,1,0,0,0,1
16399575,0,0,1,0,1
16156297,0,0,1,0,1
16398154,1,0,0,0,1
16396888,1,0,0,0,1
16395114,0,0,1,0,1
16394525,1,0,0,0,1
16385739,0,0,1,0,1
16385595,0,0,1,0,1
16382059,0,0,1,0,1
16379550,1,0,0,0,1
16357378,0,0,1,0,1
16430584,1,0,0,0,1
16430857,1,0,0,0,1
16438279,1,0,0,0,1
16442583,0,0,1,0,1
16545187,0,0,1,0,1
16533401,0,0,1,0,1
16532782,1,0,0,0,1
16523946,1,0,0,0,1
16516195,1,0,0,0,1
16512899,1,0,0,0,1
16504510,0,0,1,0,1
16504373,1,0,0,0,1
16504161,1,0,0,0,1
16502641,1,0,0,0,1
16500110,0,0,1,0,1
16499705,1,0,0,0,1
16478353,0,0,1,0,1
16476167,1,0,0,0,1
16472227,1,0,0,0,1
16466962,1,0,0,0,1
16460889,1,0,0,0,1
16460821,1,0,0,0,1
16458904,1,0,0,0,1
16356851,0,0,1,0,1
16351647,1,0,0,0,1
16345024,0,0,1,0,1
16260034,1,0,0,0,1
16240783,1,0,0,0,1
16222762,1,0,0,0,1
16220152,1,0,0,0,1
16212805,1,0,0,0,1
16212001,1,0,0,0,1
16209547,1,0,0,0,1
16206231,0,0,1,0,1
16205855,1,0,0,0,1
16205472,1,0,0,0,1
16204937,1,0,0,0,1
16200683,1,0,0,0,1
16190490,0,0,1,0,1
16190232,1,0,0,0,1
16183358,1,0,0,0,1
16182430,1,0,0,0,1
16173306,0,0,1,0,1
16168122,1,0,0,0,1
16165864,1,0,0,0,1
16157078,0,0,1,0,1
16245979,1,0,0,0,1
16260491,0,0,1,0,1
16342472,1,0,0,0,1
16261306,1,0,0,0,1
16339935,0,0,1,0,1
16336054,0,0,1,0,1
16326744,1,0,0,0,1
16325217,1,0,0,0,1
16323123,1,0,0,0,1
16319702,1,0,0,0,1
16319448,0,0,1,0,1
16308791,1,0,0,0,1
16308032,1,0,0,0,1
16307015,1,0,0,0,1
16306708,1,0,0,0,1
16305093,1,0,0,0,1
16304160,1,0,0,0,1
16300425,0,0,1,0,1
16297020,0,0,1,0,1
16296388,0,0,1,0,1
16279317,1,0,0,0,1
16273067,0,0,1,0,1
16262749,1,0,0,0,1
15646137,1,0,0,0,1
15641304,1,0,0,0,1
14813211,1,0,0,0,1
15031128,1,0,0,0,1
15090552,1,0,0,0,1
15082988,1,0,0,0,1
15081024,1,0,0,0,1
15065559,1,0,0,0,1
15063464,0,0,1,0,1
15057355,0,0,1,0,1
15053086,1,0,0,0,1
15049157,0,0,1,0,1
15047396,1,0,0,0,1
15025293,1,0,0,0,1
14988945,1,0,0,0,1
15020878,1,0,0,0,1
15019621,0,0,1,0,1
15017590,0,0,1,0,1
15010925,1,0,0,0,1
15010803,1,0,0,0,1
15008796,1,0,0,0,1
15008143,1,0,0,0,1
15002363,0,0,1,0,1
14995329,0,0,1,0,1
15094887,1,0,0,0,1
15100977,1,0,0,0,1
15102423,1,0,0,0,1
15105524,1,0,0,0,1
15218314,0,0,1,0,1
15215529,1,0,0,0,1
15200493,1,0,0,0,1
15197291,1,0,0,0,1
15196926,1,0,0,0,1
15195194,1,0,0,0,1
15193965,1,0,0,0,1
15185319,0,0,1,0,1
15179425,1,0,0,0,1
15179301,1,0,0,0,1
15172283,1,0,0,0,1
15163256,0,0,1,0,1
15153596,0,0,1,0,1
15152746,0,0,1,0,1
15139808,0,0,1,0,1
15134458,1,0,0,0,1
15131644,1,0,0,0,1
15109029,0,0,1,0,1
15105912,1,0,0,0,1
14990573,1,0,0,0,1
14979188,1,0,0,0,1
15639713,0,0,1,0,1
14862780,1,0,0,0,1
14905080,1,0,0,0,1
14890430,0,0,1,0,1
14885449,1,0,0,0,1
14884322,1,0,0,0,1
14883090,0,0,1,0,1
14883031,1,0,0,0,1
14875796,0,0,1,0,1
14865754,1,0,0,0,1
14864202,1,0,0,0,1
14861483,1,0,0,0,1
14978548,0,0,1,0,1
14859827,1,0,0,0,1
14854832,0,0,1,0,1
14852867,1,0,0,0,1
14840359,0,0,1,0,1
14833285,1,0,0,0,1
14818535,0,0,1,0,1
14815035,1,0,0,0,1
14813832,0,0,1,0,1
14813763,1,0,0,0,1
14905237,1,0,0,0,1
14906518,1,0,0,0,1
14906645,0,0,1,0,1
14909147,0,0,1,0,1
14973101,1,0,0,0,1
14965776,0,0,1,0,1
14961638,1,0,0,0,1
14948568,1,0,0,0,1
14947424,1,0,0,0,1
14946552,0,0,1,0,1
14946082,1,0,0,0,1
14945039,1,0,0,0,1
14936625,1,0,0,0,1
14934881,1,0,0,0,1
14933972,0,0,1,0,1
14933692,1,0,0,0,1
14927662,1,0,0,0,1
14927500,1,0,0,0,1
14927368,1,0,0,0,1
14925591,1,0,0,0,1
14923355,1,0,0,0,1
14914020,1,0,0,0,1
14911623,1,0,0,0,1
15221897,1,0,0,0,1
15222883,1,0,0,0,1
15226172,1,0,0,0,1
15538912,1,0,0,0,1
15560695,1,0,0,0,1
15559190,1,0,0,0,1
15558725,0,0,1,0,1
15553988,1,0,0,0,1
15548442,0,0,1,0,1
15546865,1,0,0,0,1
15544712,1,0,0,0,1
15543098,0,0,1,0,1
15540040,1,0,0,0,1
15537676,0,0,1,0,1
15231187,1,0,0,0,1
15536301,1,0,0,0,1
15535829,1,0,0,0,1
15535189,1,0,0,0,1
15534068,0,0,1,0,1
15531096,0,0,1,0,1
15529083,1,0,0,0,1
15524268,0,0,1,0,1
15523549,1,0,0,0,1
15520206,1,0,0,0,1
15565209,1,0,0,0,1
15569216,0,0,1,0,1
15570509,1,0,0,0,1
15573381,1,0,0,0,1
15638528,1,0,0,0,1
15636404,1,0,0,0,1
15635060,1,0,0,0,1
15620304,1,0,0,0,1
15619730,1,0,0,0,1
15615036,0,0,1,0,1
15613411,1,0,0,0,1
15600805,1,0,0,0,1
15588382,0,0,1,0,1
15588105,1,0,0,0,1
15586729,1,0,0,0,1
15586309,1,0,0,0,1
15586243,1,0,0,0,1
15586151,1,0,0,0,1
15584115,1,0,0,0,1
15582617,1,0,0,0,1
15581933,1,0,0,0,1
15579169,0,0,1,0,1
15578838,1,0,0,0,1
15516668,1,0,0,0,1
15487773,0,0,1,0,1
15485954,1,0,0,0,1
15338067,0,0,1,0,1
15331680,1,0,0,0,1
15321576,0,0,1,0,1
15321386,1,0,0,0,1
15318459,0,0,1,0,1
15311573,0,0,1,0,1
15310048,1,0,0,0,1
15303279,0,0,1,0,1
15300402,1,0,0,0,1
15300025,1,0,0,0,1
15297517,1,0,0,0,1
15279171,1,0,0,0,1
15278522,1,0,0,0,1
15276015,1,0,0,0,1
15271110,1,0,0,0,1
15267937,1,0,0,0,1
15266695,1,0,0,0,1
15266675,1,0,0,0,1
15265556,1,0,0,0,1
15232120,1,0,0,0,1
15337454,0,0,1,0,1
15344181,1,0,0,0,1
15478812,0,0,1,0,1
15347665,1,0,0,0,1
15476792,1,0,0,0,1
15474495,0,0,1,0,1
15449599,1,0,0,0,1
15445898,0,0,1,0,1
15442902,0,0,1,0,1
15441931,1,0,0,0,1
15433113,1,0,0,0,1
15430149,1,0,0,0,1
15429555,1,0,0,0,1
15423103,1,0,0,0,1
15416709,0,0,1,0,1
15414317,1,0,0,0,1
15402737,0,0,1,0,1
15398860,0,0,1,0,1
15396656,1,0,0,0,1
15381858,0,0,1,0,1
15377827,0,0,1,0,1
15377463,0,0,1,0,1
15356183,1,0,0,0,1
20318052,0,0,1,0,1
20320155,1,0,0,0,1
28694564,1,0,0,0,1
25010766,1,0,0,0,1
25064629,0,0,1,0,1
25044529,1,0,0,0,1
25043292,1,0,0,0,1
25041906,1,0,0,0,1
25039956,1,0,0,0,1
25037051,0,0,1,0,1
25034419,0,0,1,0,1
25020605,0,0,1,0,1
25015010,1,0,0,0,1
25002053,0,0,1,0,1
24973197,1,0,0,0,1
25001808,1,0,0,0,1
25001454,0,0,1,0,1
25001097,1,0,0,0,1
24999007,1,0,0,0,1
24986742,1,0,0,0,1
24982374,1,0,0,0,1
24981045,0,0,1,0,1
24976518,0,0,1,0,1
24973811,0,0,1,0,1
25064774,0,0,1,0,1
25064838,0,0,1,0,1
25067039,1,0,0,0,1
25076332,1,0,0,0,1
25149936,0,0,1,0,1
25145925,1,0,0,0,1
25137999,0,0,1,0,1
25137968,0,0,0,1,1
25129166,1,0,0,0,1
25118646,1,0,0,0,1
25116387,1,0,0,0,1
25113533,1,0,0,0,1
25112856,1,0,0,0,1
25111426,0,0,1,0,1
25109819,0,0,1,0,1
25108946,0,0,1,0,1
25102191,1,0,0,0,1
25095488,1,0,0,0,1
25093840,0,0,1,0,1
25082393,1,0,0,0,1
25080136,1,0,0,0,1
25079418,1,0,0,0,1
25079039,1,0,0,0,1
24973324,1,0,0,0,1
24968314,1,0,0,0,1
25153542,0,0,1,0,1
24832418,0,0,1,0,1
24856897,1,0,0,0,1
24844621,1,0,0,0,1
24840863,1,0,0,0,1
24840827,0,0,1,0,1
24839116,1,0,0,0,1
24839107,0,0,1,0,1
24835471,0,0,1,0,1
24835386,1,0,0,0,1
24832471,1,0,0,0,1
24832100,1,0,0,0,1
24961320,1,0,0,0,1
24830540,0,0,1,0,1
24821875,0,0,1,0,1
24821272,0,0,1,0,1
24806455,1,0,0,0,1
24805629,1,0,0,0,1
24802960,0,0,1,0,1
24800102,1,0,0,0,1
24797535,1,0,0,0,1
24797068,0,0,1,0,1
24860438,0,0,1,0,1
24865745,0,0,1,0,1
24867105,0,0,1,0,1
24874587,1,0,0,0,1
24954443,1,0,0,0,1
24951732,1,0,0,0,1
24950473,0,0,1,0,1
24944767,0,0,1,0,1
24943910,0,0,1,0,1
24943630,0,0,1,0,1
24940913,1,0,0,0,1
24932156,0,0,1,0,1
24919557,0,0,1,0,1
24915465,1,0,0,0,1
24913451,0,0,1,0,1
24913141,1,0,0,0,1
24909331,0,0,1,0,1
24907501,1,0,0,0,1
24898836,1,0,0,0,1
24897395,1,0,0,0,1
24884055,0,0,1,0,1
24881130,0,0,1,0,1
24878584,0,0,1,0,1
25153167,1,0,0,0,1
25157246,0,0,1,0,1
24007762,1,0,0,0,1
25499953,1,0,0,0,1
25599307,1,0,0,0,1
25597316,1,0,0,0,1
25596183,0,0,1,0,1
25575398,0,0,1,0,1
25549229,0,0,1,0,1
25533198,0,0,1,0,1
25517905,0,0,1,0,1
25507139,1,0,0,0,1
25505776,0,0,1,0,1
25498781,1,0,0,0,1
25431451,1,0,0,0,1
25495114,1,0,0,0,1
25492187,1,0,0,0,1
25490213,1,0,0,0,1
25481333,1,0,0,0,1
25476493,1,0,0,0,1
25475028,0,0,1,0,1
25468672,0,0,1,0,1
25468442,1,0,0,0,1
25454304,1,0,0,0,1
25602048,0,0,1,0,1
25605654,0,0,1,0,1
25606136,1,0,0,0,1
25651976,1,0,0,0,1
25821864,0,0,1,0,1
25821059,1,0,0,0,1
25812202,0,0,1,0,1
25807709,0,0,1,0,1
25796636,1,0,0,0,1
25768880,0,0,1,0,1
25760832,1,0,0,0,1
25748492,1,0,0,0,1
25744379,1,0,0,0,1
25715117,0,0,1,0,1
25712247,0,0,1,0,1
25710035,0,0,1,0,1
25705033,1,0,0,0,1
25699917,1,0,0,0,1
25690203,0,0,1,0,1
25689357,1,0,0,0,1
25687571,1,0,0,0,1
25683499,1,0,0,0,1
25673940,1,0,0,0,1
25439443,1,0,0,0,1
25419685,1,0,0,0,1
25165109,0,0,1,0,1
25233493,1,0,0,0,1
25271688,0,0,1,0,1
25268374,0,0,1,0,1
25266756,1,0,0,0,1
25266538,1,0,0,0,1
25266527,1,0,0,0,1
25264954,0,0,1,0,1
25261935,1,0,0,0,1
25249481,0,0,1,0,1
25233652,0,0,1,0,1
25233305,1,0,0,0,1
25415637,1,0,0,0,1
25227079,1,0,0,0,1
25226604,1,0,0,0,1
25214775,1,0,0,0,1
25196982,1,0,0,0,1
25188010,1,0,0,0,1
25171838,1,0,0,0,1
25169027,1,0,0,0,1
25168328,1,0,0,0,1
25168319,1,0,0,0,1
25275192,1,0,0,0,1
25277762,1,0,0,0,1
25295888,0,0,1,0,1
25300542,1,0,0,0,1
25410835,1,0,0,0,1
25408903,0,0,1,0,1
25406101,1,0,0,0,1
25404246,1,0,0,0,1
25402037,1,0,0,0,1
25401356,1,0,0,0,1
25394253,1,0,0,0,1
25379501,0,0,1,0,1
25370215,0,0,1,0,1
25368839,1,0,0,0,1
25358619,1,0,0,0,1
25354313,0,0,1,0,1
25347213,1,0,0,0,1
25345804,1,0,0,0,1
25339875,1,0,0,0,1
25335136,1,0,0,0,1
25323622,1,0,0,0,1
25321849,1,0,0,0,1
25311040,0,0,1,0,1
24796204,1,0,0,0,1
24796157,1,0,0,0,1
24793480,0,0,1,0,1
24319977,1,0,0,0,1
24344873,1,0,0,0,1
24344136,0,0,1,0,1
24338669,1,0,0,0,1
24338366,1,0,0,0,1
24337956,0,0,1,0,1
24337877,0,0,1,0,1
24334762,1,0,0,0,1
24333247,1,0,0,0,1
24327574,0,0,1,0,1
24319884,1,0,0,0,1
24261901,1,0,0,0,1
24304455,1,0,0,0,1
24302484,1,0,0,0,1
24300850,1,0,0,0,1
24295818,0,0,1,0,1
24291027,0,0,1,0,1
24288550,1,0,0,0,1
24273673,0,0,1,0,1
24270606,0,0,1,0,1
24268565,1,0,0,0,1
24347671,0,0,1,0,1
24373587,0,0,1,0,1
24373940,1,0,0,0,1
24378438,1,0,0,0,1
24424456,1,0,0,0,1
24423704,0,0,1,0,1
24419496,1,0,0,0,1
24418469,1,0,0,0,1
24415699,1,0,0,0,1
24413323,1,0,0,0,1
24412529,0,0,1,0,1
24411752,0,0,1,0,1
24404928,1,0,0,0,1
24404906,1,0,0,0,1
24403405,1,0,0,0,1
24393270,1,0,0,0,1
24391916,0,0,1,0,1
24386929,1,0,0,0,1
24383863,0,0,1,0,1
24383253,0,0,1,0,1
24382598,0,0,1,0,1
24381419,1,0,0,0,1
24379402,1,0,0,0,1
24263304,0,0,1,0,1
24259346,0,0,1,0,1
24780521,0,0,1,0,1
24051501,1,0,0,0,1
24117644,0,0,1,0,1
24103915,1,0,0,0,1
24103270,1,0,0,0,1
24094081,0,0,1,0,1
24090598,1,0,0,0,1
24088306,1,0,0,0,1
24079691,0,0,1,0,1
24074596,1,0,0,0,1
24071322,1,0,0,0,1
24048208,1,0,0,0,1
24253453,0,0,1,0,1
24047387,1,0,0,0,1
24038764,0,0,1,0,1
24037775,1,0,0,0,1
24031106,1,0,0,0,1
24030482,0,0,1,0,1
24020898,0,0,1,0,1
24020050,1,0,0,0,1
24018769,1,0,0,0,1
24013611,1,0,0,0,1
24118443,1,0,0,0,1
24122579,0,0,1,0,1
24123701,1,0,0,0,1
24123958,1,0,0,0,1
24243967,0,0,1,0,1
24232065,1,0,0,0,1
24225915,1,0,0,0,1
24215329,0,0,1,0,1
24204840,0,0,1,0,1
24204269,0,0,1,0,1
24198076,1,0,0,0,1
24195130,1,0,0,0,1
24170873,1,0,0,0,1
24170648,0,0,1,0,1
24157955,1,0,0,0,1
24155326,0,0,1,0,1
24144577,1,0,0,0,1
24140532,1,0,0,0,1
24132118,0,0,1,0,1
24131677,1,0,0,0,1
24131487,1,0,0,0,1
24128401,1,0,0,0,1
24127267,1,0,0,0,1
24425113,1,0,0,0,1
24430182,1,0,0,0,1
24438122,0,0,1,0,1
24657274,1,0,0,0,1
24678971,1,0,0,0,1
24674790,1,0,0,0,1
24673896,1,0,0,0,1
24672682,0,0,1,0,1
24667595,0,0,1,0,1
24666317,0,0,1,0,1
24665599,1,0,0,0,1
24665235,1,0,0,0,1
24663740,0,0,1,0,1
24648109,1,0,0,0,1
24446167,1,0,0,0,1
24643923,0,0,1,0,1
24640579,1,0,0,0,1
24634123,1,0,0,0,1
24633966,0,0,1,0,1
24633205,0,0,1,0,1
24631598,1,0,0,0,1
24630962,0,0,1,0,1
24630374,1,0,0,0,1
24629261,0,0,1,0,1
24696055,1,0,0,0,1
24697585,1,0,0,0,1
24699718,1,0,0,0,1
24704747,1,0,0,0,1
24777219,0,0,1,0,1
24772574,1,0,0,0,1
24771293,0,0,1,0,1
24770539,1,0,0,0,1
24767731,1,0,0,0,1
24765466,0,0,1,0,1
24764219,0,0,1,0,1
24762196,0,0,1,0,1
24747103,1,0,0,0,1
24744819,0,0,1,0,1
24743701,1,0,0,0,1
24740457,1,0,0,0,1
24717198,1,0,0,0,1
24714733,0,0,1,0,1
24710778,0,0,1,0,1
24709527,1,0,0,0,1
24707895,1,0,0,0,1
24707177,1,0,0,0,1
24706492,0,0,0,1,1
24628477,1,0,0,0,1
24625767,0,0,1,0,1
24625694,0,0,1,0,1
24520756,1,0,0,0,1
24517667,1,0,0,0,1
24517455,1,0,0,0,1
24516141,0,0,1,0,1
24508767,0,0,1,0,1
24503246,0,0,1,0,1
24500940,1,0,0,0,1
24487418,0,0,1,0,1
24467359,1,0,0,0,1
24466431,0,0,1,0,1
24466159,0,0,1,0,1
24464178,1,0,0,0,1
24461143,0,0,1,0,1
24459217,0,0,1,0,1
24459029,0,0,1,0,1
24454906,1,0,0,0,1
24450948,1,0,0,0,1
24449433,1,0,0,0,1
24448775,0,0,1,0,1
24446277,1,0,0,0,1
24517762,0,0,1,0,1
24529969,1,0,0,0,1
24622893,0,0,1,0,1
24530917,1,0,0,0,1
24607072,1,0,0,0,1
24600395,1,0,0,0,1
24600315,0,0,1,0,1
24598868,0,0,1,0,1
24595687,0,0,1,0,1
24591977,0,0,1,0,1
24591710,0,0,1,0,1
24591281,1,0,0,0,1
24590092,0,0,1,0,1
24576989,1,0,0,0,1
24576978,1,0,0,0,1
24570526,0,0,1,0,1
24559181,0,0,1,0,1
24557646,1,0,0,0,1
24555785,0,0,1,0,1
24554369,0,0,1,0,1
24551170,1,0,0,0,1
24549757,1,0,0,0,1
24546033,0,0,1,0,1
25822424,1,0,0,0,1
25840204,1,0,0,0,1
25846948,1,0,0,0,1
27589508,1,0,0,0,1
27712875,1,0,0,0,1
27694509,0,0,1,0,1
27670418,1,0,0,0,1
27655941,1,0,0,0,1
27655084,1,0,0,0,1
27652670,1,0,0,0,1
27646625,1,0,0,0,1
27619928,0,0,1,0,1
27596962,1,0,0,0,1
27567524,0,0,1,0,1
27527984,1,0,0,0,1
27559992,1,0,0,0,1
27558716,0,0,1,0,1
27554902,1,0,0,0,1
27551876,1,0,0,0,1
27551651,1,0,0,0,1
27549528,1,0,0,0,1
27547703,1,0,0,0,1
27544156,1,0,0,0,1
27534002,0,0,1,0,1
27742407,1,0,0,0,1
27751504,0,0,1,0,1
27755788,1,0,0,0,1
27780735,1,0,0,0,1
27891261,1,0,0,0,1
27885164,0,0,1,0,1
27867038,1,0,0,0,1
27851000,1,0,0,0,1
27847787,1,0,0,0,1
27828692,1,0,0,0,1
27815282,1,0,0,0,1
27813626,0,0,1,0,1
27813383,1,0,0,0,1
27809907,0,0,1,0,1
27808478,1,0,0,0,1
27807705,0,0,1,0,1
27796238,1,0,0,0,1
27796188,1,0,0,0,1
27792743,1,0,0,0,1
27789935,1,0,0,0,1
27784469,0,0,1,0,1
27783476,1,0,0,0,1
27782348,0,0,1,0,1
27531553,1,0,0,0,1
27506975,0,0,1,0,1
27201435,1,0,0,0,1
27285825,0,0,1,0,1
27379154,0,0,1,0,1
27376622,0,0,0,1,1
27364574,1,0,0,0,1
27331181,1,0,0,0,1
27315819,1,0,0,0,1
27315132,0,0,1,0,1
27314977,1,0,0,0,1
27294359,0,0,1,0,1
27293055,1,0,0,0,1
27283579,0,0,1,0,1
27504587,1,0,0,0,1
27272337,1,0,0,0,1
27266433,0,0,1,0,1
27265072,1,0,0,0,1
27263990,1,0,0,0,1
27245607,1,0,0,0,1
27240092,0,0,1,0,1
27227937,0,0,1,0,1
27227850,1,0,0,0,1
27222839,1,0,0,0,1
27379417,0,0,1,0,1
27427335,0,0,1,0,1
27428499,1,0,0,0,1
27431753,1,0,0,0,1
27503203,0,0,1,0,1
27502743,1,0,0,0,1
27502620,1,0,0,0,1
27502041,0,0,1,0,1
27502008,0,0,1,0,1
27499750,1,0,0,0,1
27497250,1,0,0,0,1
27494721,1,0,0,0,1
27488921,1,0,0,0,1
27483010,0,0,1,0,1
27479250,1,0,0,0,1
27473592,1,0,0,0,1
27465368,0,0,1,0,1
27462282,0,0,1,0,1
27445710,1,0,0,0,1
27443386,0,0,1,0,1
27441163,1,0,0,0,1
27439632,1,0,0,0,1
27439022,0,0,1,0,1
27894798,1,0,0,0,1
27906470,0,0,1,0,1
27919510,1,0,0,0,1
28380119,1,0,0,0,1
28449520,1,0,0,0,1
28429835,0,0,1,0,1
28425101,0,0,1,0,1
28415634,1,0,0,0,1
28413263,0,0,1,0,1
28408861,0,0,1,0,1
28408288,0,0,1,0,1
28400686,0,0,1,0,1
28398689,0,0,1,0,1
28365672,0,0,1,0,1
27919611,0,0,1,0,1
28345063,1,0,0,0,1
28340943,1,0,0,0,1
28337487,0,0,1,0,1
28336810,1,0,0,0,1
28316764,0,0,1,0,1
28316637,1,0,0,0,1
28303435,1,0,0,0,1
28299758,1,0,0,0,1
28290772,0,0,1,0,1
28460565,1,0,0,0,1
28518140,1,0,0,0,1
28534039,0,0,1,0,1
28546873,0,0,1,0,1
28680349,0,0,1,0,1
28649998,0,0,1,0,1
28647831,1,0,0,0,1
28642235,1,0,0,0,1
28640162,1,0,0,0,1
28632805,1,0,0,0,1
28629958,1,0,0,0,1
28629925,1,0,0,0,1
28626337,0,0,1,0,1
28618103,1,0,0,0,1
28613272,0,0,1,0,1
28604125,0,0,1,0,1
28601986,1,0,0,0,1
28588488,1,0,0,0,1
28584159,0,0,1,0,1
28577166,1,0,0,0,1
28557516,0,0,1,0,1
28557212,0,0,1,0,1
28556029,1,0,0,0,1
28283044,1,0,0,0,1
28275011,1,0,0,0,1
28269324,0,0,1,0,1
28055322,1,0,0,0,1
28015622,1,0,0,0,1
28013319,1,0,0,0,1
28012130,1,0,0,0,1
28007844,0,0,1,0,1
27998261,1,0,0,0,1
27982346,0,0,1,0,1
27977002,0,0,1,0,1
27974744,0,0,1,0,1
27974363,1,0,0,0,1
27974352,1,0,0,0,1
27973696,1,0,0,0,1
27973267,1,0,0,0,1
27969560,0,0,1,0,1
27953420,1,0,0,0,1
27952234,0,0,1,0,1
27949819,1,0,0,0,1
27932675,1,0,0,0,1
27927011,1,0,0,0,1
27921486,1,0,0,0,1
28035940,1,0,0,0,1
28057253,1,0,0,0,1
28258694,1,0,0,0,1
28065838,0,0,1,0,1
28250527,0,0,1,0,1
28249503,0,0,1,0,1
28242204,1,0,0,0,1
28230559,1,0,0,0,1
28229044,0,0,1,0,1
28212095,1,0,0,0,1
28211968,0,0,1,0,1
28209974,1,0,0,0,1
28193427,1,0,0,0,1
28189446,1,0,0,0,1
28187447,1,0,0,0,1
28186801,1,0,0,0,1
28181993,0,0,1,0,1
28131813,1,0,0,0,1
28121352,0,0,1,0,1
28119886,0,0,1,0,1
28110419,1,0,0,0,1
28071093,0,0,1,0,1
28068651,1,0,0,0,1
27204642,1,0,0,0,1
27198421,1,0,0,0,1
25847920,1,0,0,0,1
26201936,1,0,0,0,1
26315518,0,0,1,0,1
26302195,0,0,1,0,1
26297795,0,0,1,0,1
26295451,1,0,0,0,1
26260328,0,0,1,0,1
26244773,1,0,0,0,1
26225727,0,0,1,0,1
26219578,0,0,1,0,1
26218375,1,0,0,0,1
26180644,1,0,0,0,1
26119672,1,0,0,0,1
26178075,1,0,0,0,1
26177358,1,0,0,0,1
26164700,0,0,1,0,1
26163238,0,0,1,0,1
26162659,0,0,1,0,1
26156848,1,0,0,0,1
26135496,0,0,1,0,1
26134830,1,0,0,0,1
26129793,0,0,1,0,1
26319385,1,0,0,0,1
26330490,0,0,1,0,1
26346459,1,0,0,0,1
26347594,0,0,1,0,1
26476746,1,0,0,0,1
26474885,1,0,0,0,1
26459329,0,0,1,0,1
26444500,0,0,1,0,1
26443890,0,0,1,0,1
26440049,0,0,1,0,1
26438408,1,0,0,0,1
26435150,1,0,0,0,1
26433326,1,0,0,0,1
26427666,1,0,0,0,1
26420701,0,0,1,0,1
26415767,1,0,0,0,1
26408085,0,0,1,0,1
26390396,1,0,0,0,1
26388856,1,0,0,0,1
26383916,0,0,1,0,1
26382037,1,0,0,0,1
26380626,1,0,0,0,1
26364541,0,0,1,0,1
26124805,0,0,1,0,1
26117696,0,0,1,0,1
27187487,0,0,1,0,1
25895198,1,0,0,0,1
25968714,0,0,1,0,1
25967444,1,0,0,0,1
25965792,1,0,0,0,1
25961456,0,0,1,0,1
25952709,1,0,0,0,1
25950119,1,0,0,0,1
25913948,0,0,1,0,1
25906862,1,0,0,0,1
25896614,1,0,0,0,1
25889607,1,0,0,0,1
26108514,0,0,1,0,1
25889523,1,0,0,0,1
25889382,0,0,1,0,1
25880686,0,0,1,0,1
25865233,1,0,0,0,1
25859072,1,0,0,0,1
25858923,0,0,1,0,1
25856942,1,0,0,0,1
25854571,0,0,1,0,1
25854469,1,0,0,0,1
25968876,0,0,1,0,1
25969601,1,0,0,0,1
25971488,0,0,1,0,1
26004891,0,0,1,0,1
26106667,1,0,0,0,1
26100862,1,0,0,0,1
26095943,0,0,1,0,1
26090217,0,0,1,0,1
26089087,0,0,1,0,1
26081002,0,0,1,0,1
26073602,1,0,0,0,1
26071530,1,0,0,0,1
26064594,1,0,0,0,1
26055080,0,0,1,0,1
26054687,0,0,1,0,1
26049810,1,0,0,0,1
26033344,0,0,1,0,1
26024758,1,0,0,0,1
26024433,1,0,0,0,1
26024349,0,0,1,0,1
26018110,0,0,1,0,1
26017313,1,0,0,0,1
26012172,1,0,0,0,1
26484511,1,0,0,0,1
26485995,1,0,0,0,1
26494424,1,0,0,0,1
26924376,1,0,0,0,1
26989131,1,0,0,0,1
26984764,0,0,1,0,1
26976628,1,0,0,0,1
26975156,1,0,0,0,1
26959668,1,0,0,0,1
26958744,0,0,1,0,1
26942242,1,0,0,0,1
26929394,1,0,0,0,1
26928086,1,0,0,0,1
26923140,1,0,0,0,1
26494979,1,0,0,0,1
26921025,1,0,0,0,1
26909087,0,0,1,0,1
26908204,1,0,0,0,1
26902068,1,0,0,0,1
26901061,1,0,0,0,1
26898137,0,0,1,0,1
26885466,0,0,1,0,1
26880156,0,0,1,0,1
26865924,0,0,1,0,1
26992810,1,0,0,0,1
27001949,0,0,1,0,1
27053744,1,0,0,0,1
27054897,0,0,1,0,1
27186037,0,0,1,0,1
27181498,0,0,0,1,1
27159049,1,0,0,0,1
27158859,1,0,0,0,1
27154283,1,0,0,0,1
27132406,0,0,1,0,1
27126954,1,0,0,0,1
27126531,1,0,0,0,1
27116445,0,0,1,0,1
27109516,1,0,0,0,1
27107891,0,0,1,0,1
27106481,1,0,0,0,1
27105320,0,0,1,0,1
27103894,0,0,1,0,1
27078779,1,0,0,0,1
27077862,1,0,0,0,1
27072226,0,0,1,0,1
27071572,1,0,0,0,1
27070336,0,0,1,0,1
26860800,0,0,1,0,1
26856136,1,0,0,0,1
26825592,1,0,0,0,1
26693629,1,0,0,0,1
26681543,1,0,0,0,1
26676357,1,0,0,0,1
26662589,1,0,0,0,1
26656760,1,0,0,0,1
26644197,1,0,0,0,1
26641826,1,0,0,0,1
26630249,0,0,1,0,1
26600861,1,0,0,0,1
26595479,0,0,1,0,1
26585911,1,0,0,0,1
26558533,0,0,1,0,1
26557574,1,0,0,0,1
26546007,1,0,0,0,1
26543202,0,0,1,0,1
26517955,0,0,1,0,1
26502234,1,0,0,0,1
26500764,0,0,1,0,1
26500272,1,0,0,0,1
26499961,0,0,1,0,1
26681738,1,0,0,0,1
26710027,0,0,1,0,1
26822855,1,0,0,0,1
26714887,0,0,1,0,1
26819401,1,0,0,0,1
26819117,0,0,1,0,1
26818265,1,0,0,0,1
26817172,1,0,0,0,1
26814623,1,0,0,0,1
26804769,0,0,1,0,1
26795979,0,0,1,0,1
26790498,0,0,1,0,1
26781753,1,0,0,0,1
26772304,0,0,1,0,1
26766402,1,0,0,0,1
26765262,1,0,0,0,1
26756453,0,0,1,0,1
26754726,1,0,0,0,1
26748898,1,0,0,0,1
26744799,1,0,0,0,1
26738513,1,0,0,0,1
26734176,1,0,0,0,1
26731382,0,0,0,1,1
24010376,0,0,1,0,1
24001156,0,0,1,0,1
20324421,1,0,0,0,1
21497854,0,0,1,0,1
21536937,0,0,1,0,1
21535262,1,0,0,0,1
21531418,1,0,0,0,1
21529335,1,0,0,0,1
21527486,1,0,0,0,1
21503447,1,0,0,0,1
21500500,0,0,1,0,1
21499988,0,0,1,0,1
21498793,1,0,0,0,1
21495656,0,0,0,1,1
21455632,0,0,1,0,1
21492250,0,0,0,1,1
21491458,1,0,0,0,1
21490784,1,0,0,0,1
21480920,1,0,0,0,1
21468915,1,0,0,0,1
21468170,1,0,0,0,1
21466891,1,0,0,0,1
21466735,0,0,1,0,1
21466618,1,0,0,0,1
21541169,0,0,1,0,1
21543930,1,0,0,0,1
21546973,0,0,1,0,1
21548059,1,0,0,0,1
21660030,1,0,0,0,1
21657795,1,0,0,0,1
21652004,1,0,0,0,1
21651082,0,0,1,0,1
21647215,1,0,0,0,1
21641864,1,0,0,0,1
21641228,1,0,0,0,1
21634948,0,0,1,0,1
21628800,1,0,0,0,1
21620922,1,0,0,0,1
21604714,0,0,1,0,1
21601222,1,0,0,0,1
21600904,0,0,1,0,1
21600813,0,0,1,0,1
21594229,1,0,0,0,1
21570720,1,0,0,0,1
21568299,0,0,1,0,1
21560088,1,0,0,0,1
21554910,0,0,1,0,1
21462953,1,0,0,0,1
21452718,0,0,1,0,1
21662822,1,0,0,0,1
21269488,0,0,1,0,1
21341524,1,0,0,0,1
21336880,1,0,0,0,1
21336090,1,0,0,0,1
21332287,1,0,0,0,1
21299270,0,0,1,0,1
21299191,1,0,0,0,1
21293445,0,0,1,0,1
21283171,1,0,0,0,1
21279472,1,0,0,0,1
21266886,1,0,0,0,1
21452140,1,0,0,0,1
21260428,1,0,0,0,1
21256980,0,0,1,0,1
21255768,1,0,0,0,1
21247073,0,0,1,0,1
21229563,1,0,0,0,1
21228368,1,0,0,0,1
21227711,0,0,1,0,1
21221697,1,0,0,0,1
21218657,1,0,0,0,1
21350216,1,0,0,0,1
21352288,1,0,0,0,1
21353640,1,0,0,0,1
21369808,0,0,1,0,1
21445795,1,0,0,0,1
21430239,0,0,1,0,1
21425186,1,0,0,0,1
21420343,1,0,0,0,1
21419119,1,0,0,0,1
21418952,0,0,1,0,1
21410546,0,0,1,0,1
21409261,1,0,0,0,1
21400616,1,0,0,0,1
21400222,1,0,0,0,1
21400083,0,0,1,0,1
21383358,1,0,0,0,1
21381325,0,0,1,0,1
21380762,1,0,0,0,1
21380187,0,0,1,0,1
21376704,0,0,1,0,1
21376165,1,0,0,0,1
21375734,0,0,1,0,1
21372426,1,0,0,0,1
21661360,1,0,0,0,1
21663531,0,0,1,0,1
23992867,1,0,0,0,1
22007415,0,0,1,0,1
22059655,0,0,1,0,1
22057975,1,0,0,0,1
22051363,0,0,1,0,1
22047286,1,0,0,0,1
22030138,1,0,0,0,1
22029264,0,0,1,0,1
22020112,1,0,0,0,1
22019073,0,0,1,0,1
22017065,1,0,0,0,1
22006854,1,0,0,0,1
21960625,1,0,0,0,1
22005943,0,0,1,0,1
22004774,0,0,1,0,1
21996012,1,0,0,0,1
21986616,1,0,0,0,1
21979970,1,0,0,0,1
21977919,0,0,0,1,1
21977427,0,0,1,0,1
21965282,0,0,1,0,1
21964818,1,0,0,0,1
22059980,0,0,1,0,1
22063782,1,0,0,0,1
22067387,1,0,0,0,1
22079796,1,0,0,0,1
22194698,1,0,0,0,1
22189723,0,0,1,0,1
22188911,1,0,0,0,1
22171747,1,0,0,0,1
22166692,0,0,1,0,1
22162980,1,0,0,0,1
22159648,0,0,1,0,1
22154340,1,0,0,0,1
22141007,0,0,1,0,1
22136368,1,0,0,0,1
22125548,1,0,0,0,1
22118802,0,0,1,0,1
22117802,1,0,0,0,1
22099204,1,0,0,0,1
22098752,1,0,0,0,1
22090713,1,0,0,0,1
22089583,1,0,0,0,1
22089161,1,0,0,0,1
22087408,1,0,0,0,1
21964394,1,0,0,0,1
21959207,0,0,1,0,1
21680683,1,0,0,0,1
21742264,1,0,0,0,1
21787420,1,0,0,0,1
21785798,1,0,0,0,1
21784449,1,0,0,0,1
21782731,0,0,1,0,1
21773199,1,0,0,0,1
21768449,0,0,1,0,1
21768291,1,0,0,0,1
21753108,1,0,0,0,1
21742914,1,0,0,0,1
21739563,0,0,1,0,1
21944539,1,0,0,0,1
21733475,1,0,0,0,1
21706654,1,0,0,0,1
21706118,0,0,1,0,1
21697957,0,0,1,0,1
21695819,1,0,0,0,1
21694428,0,0,0,1,1
21686560,0,0,1,0,1
21685221,1,0,0,0,1
21683421,0,0,1,0,1
21789707,1,0,0,0,1
21804910,1,0,0,0,1
21806075,0,0,1,0,1
21816318,0,0,1,0,1
21941065,1,0,0,0,1
21938310,0,0,1,0,1
21937306,0,0,0,1,1
21937063,0,0,1,0,1
21930475,1,0,0,0,1
21921891,0,0,1,0,1
21918321,1,0,0,0,1
21911709,1,0,0,0,1
21909330,1,0,0,0,1
21906247,0,0,1,0,1
21894865,1,0,0,0,1
21894410,0,0,1,0,1
21891606,0,0,1,0,1
21889213,0,0,1,0,1
21881605,0,0,1,0,1
21877010,1,0,0,0,1
21849863,1,0,0,0,1
21838149,0,0,1,0,1
21833312,1,0,0,0,1
21211868,0,0,1,0,1
21208237,0,0,1,0,1
21206846,1,0,0,0,1
20627511,1,0,0,0,1
20671127,0,0,1,0,1
20670246,1,0,0,0,1
20670026,1,0,0,0,1
20668390,1,0,0,0,1
20667334,1,0,0,0,1
20659309,1,0,0,0,1
20639127,0,0,1,0,1
20638443,1,0,0,0,1
20630497,0,0,1,0,1
20624434,1,0,0,0,1
20566940,1,0,0,0,1
20614129,1,0,0,0,1
20608771,1,0,0,0,1
20607449,1,0,0,0,1
20604809,1,0,0,0,1
20592462,1,0,0,0,1
20586090,0,0,1,0,1
20583125,0,0,1,0,1
20576411,0,0,1,0,1
20569770,0,0,1,0,1
20676068,1,0,0,0,1
20684495,1,0,0,0,1
20691165,0,0,1,0,1
20692024,1,0,0,0,1
20809866,1,0,0,0,1
20808466,0,0,1,0,1
20804098,0,0,1,0,1
20780113,1,0,0,0,1
20778884,1,0,0,0,1
20765208,1,0,0,0,1
20761853,0,0,1,0,1
20754989,0,0,1,0,1
20745804,1,0,0,0,1
20729779,0,0,1,0,1
20729128,1,0,0,0,1
20713614,1,0,0,0,1
20707006,0,0,1,0,1
20703641,1,0,0,0,1
20700823,1,0,0,0,1
20700765,0,0,1,0,1
20700509,1,0,0,0,1
20700305,1,0,0,0,1
20694807,1,0,0,0,1
20567256,1,0,0,0,1
20565470,1,0,0,0,1
21203835,1,0,0,0,1
20377328,1,0,0,0,1
20446747,1,0,0,0,1
20440955,0,0,1,0,1
20435647,1,0,0,0,1
20416352,0,0,1,0,1
20413013,1,0,0,0,1
20411855,0,0,1,0,1
20404001,1,0,0,0,1
20398684,1,0,0,0,1
20379079,0,0,1,0,1
20375986,1,0,0,0,1
20563033,0,0,1,0,1
20367564,0,0,1,0,1
20367358,1,0,0,0,1
20366520,1,0,0,0,1
20364466,1,0,0,0,1
20357771,0,0,1,0,1
20354912,0,0,1,0,1
20337316,0,0,0,1,1
20336287,1,0,0,0,1
20336015,0,0,1,0,1
20446890,0,0,1,0,1
20449160,1,0,0,0,1
20471565,0,0,1,0,1
20474743,0,0,1,0,1
20557896,0,0,1,0,1
20557884,1,0,0,0,1
20549983,1,0,0,0,1
20543178,1,0,0,0,1
20540369,0,0,1,0,1
20536793,1,0,0,0,1
20536731,1,0,0,0,1
20536249,0,0,1,0,1
20535965,1,0,0,0,1
20535183,1,0,0,0,1
20534981,1,0,0,0,1
20527965,1,0,0,0,1
20518155,1,0,0,0,1
20517979,1,0,0,0,1
20515415,1,0,0,0,1
20510488,1,0,0,0,1
20491372,0,0,1,0,1
20483451,1,0,0,0,1
20480059,1,0,0,0,1
20810804,0,0,1,0,1
20812159,0,0,1,0,1
20820856,0,0,1,0,1
21046508,1,0,0,0,1
21096602,0,0,1,0,1
21096298,0,0,1,0,1
21086012,0,0,1,0,1
21079341,1,0,0,0,1
21064917,1,0,0,0,1
21064077,1,0,0,0,1
21060554,1,0,0,0,1
21060064,0,0,1,0,1
21056771,1,0,0,0,1
21041659,1,0,0,0,1
20822611,0,0,1,0,1
21030441,0,0,1,0,1
21026813,1,0,0,0,1
21026294,0,0,1,0,1
21019302,1,0,0,0,1
21019043,1,0,0,0,1
21016896,1,0,0,0,1
21016608,1,0,0,0,1
21012470,0,0,1,0,1
21010698,1,0,0,0,1
21099366,1,0,0,0,1
21100276,1,0,0,0,1
21106043,1,0,0,0,1
21110000,1,0,0,0,1
21188854,1,0,0,0,1
21182556,0,0,1,0,1
21180293,0,0,1,0,1
21176915,1,0,0,0,1
21175522,0,0,1,0,1
21175506,1,0,0,0,1
21172422,1,0,0,0,1
21157951,0,0,1,0,1
21147839,0,0,1,0,1
21145652,1,0,0,0,1
21140491,0,0,1,0,1
21136805,0,0,1,0,1
21132706,0,0,1,0,1
21130844,1,0,0,0,1
21130473,0,0,1,0,1
21129281,1,0,0,0,1
21127686,1,0,0,0,1
21127377,0,0,1,0,1
21112602,1,0,0,0,1
21009723,0,0,1,0,1
21008600,1,0,0,0,1
21003389,0,0,1,0,1
20912185,1,0,0,0,1
20911595,1,0,0,0,1
20907226,1,0,0,0,1
20907184,1,0,0,0,1
20906160,0,0,1,0,1
20906077,1,0,0,0,1
20902552,0,0,1,0,1
20901391,1,0,0,0,1
20900568,0,0,1,0,1
20884486,0,0,1,0,1
20875858,1,0,0,0,1
20868549,1,0,0,0,1
20863433,1,0,0,0,1
20855056,0,0,1,0,1
20854377,1,0,0,0,1
20852937,1,0,0,0,1
20830484,0,0,1,0,1
20828468,0,0,1,0,1
20825054,0,0,1,0,1
20824976,0,0,1,0,1
20911928,1,0,0,0,1
20914464,1,0,0,0,1
20992861,0,0,1,0,1
20926711,0,0,1,0,1
20990447,0,0,1,0,1
20989611,1,0,0,0,1
20988865,1,0,0,0,1
20987432,0,0,1,0,1
20985215,0,0,1,0,1
20976078,0,0,1,0,1
20971414,1,0,0,0,1
20971383,1,0,0,0,1
20971070,1,0,0,0,1
20955075,0,0,1,0,1
20954844,0,0,1,0,1
20952876,1,0,0,0,1
20952448,1,0,0,0,1
20950225,1,0,0,0,1
20945243,1,0,0,0,1
20942935,0,0,1,0,1
20934972,0,0,1,0,1
20933060,0,0,1,0,1
20932025,0,0,1,0,1
22198017,1,0,0,0,1
22200018,1,0,0,0,1
22205488,1,0,0,0,1
23454048,1,0,0,0,1
23540800,1,0,0,0,1
23538896,1,0,0,0,1
23505542,0,0,1,0,1
23502626,0,0,1,0,1
23501405,0,0,1,0,1
23486811,0,0,1,0,1
23479368,0,0,1,0,1
23465153,1,0,0,0,1
23455550,1,0,0,0,1
23443666,1,0,0,0,1
23376733,1,0,0,0,1
23436785,1,0,0,0,1
23434483,1,0,0,0,1
23429756,1,0,0,0,1
23424461,1,0,0,0,1
23424348,1,0,0,0,1
23423519,0,0,1,0,1
23407300,1,0,0,0,1
23397935,1,0,0,0,1
23386756,0,0,1,0,1
23545344,0,0,1,0,1
23548340,0,0,1,0,1
23552267,0,0,1,0,1
23570473,0,0,1,0,1
23635670,0,0,1,0,1
23634203,1,0,0,0,1
23625464,0,0,1,0,1
23624611,1,0,0,0,1
23621417,1,0,0,0,1
23619636,1,0,0,0,1
23619449,0,0,1,0,1
23606088,1,0,0,0,1
23596542,1,0,0,0,1
23593179,1,0,0,0,1
23592584,0,0,1,0,1
23590752,1,0,0,0,1
23589288,0,0,1,0,1
23588055,0,0,1,0,1
23581605,0,0,1,0,1
23575706,0,0,1,0,1
23574544,0,0,1,0,1
23573737,1,0,0,0,1
23573717,1,0,0,0,1
23383529,1,0,0,0,1
23371413,1,0,0,0,1
23147135,1,0,0,0,1
23215098,1,0,0,0,1
23261539,1,0,0,0,1
23260853,1,0,0,0,1
23257199,1,0,0,0,1
23256032,1,0,0,0,1
23254491,1,0,0,0,1
23254432,1,0,0,0,1
23244570,1,0,0,0,1
23243453,1,0,0,0,1
23231840,1,0,0,0,1
23212298,1,0,0,0,1
23356363,1,0,0,0,1
23208262,0,0,1,0,1
23192585,0,0,1,0,1
23189573,1,0,0,0,1
23187157,0,0,1,0,1
23185007,0,0,1,0,1
23178728,1,0,0,0,1
23168773,1,0,0,0,1
23156396,0,0,1,0,1
23149564,1,0,0,0,1
23267477,1,0,0,0,1
23269913,0,0,1,0,1
23290881,0,0,1,0,1
23293950,1,0,0,0,1
23356064,1,0,0,0,1
23345098,0,0,1,0,1
23342410,1,0,0,0,1
23342156,0,0,1,0,1
23341466,0,0,1,0,1
23340570,1,0,0,0,1
23340108,1,0,0,0,1
23335662,0,0,1,0,1
23334541,1,0,0,0,1
23317640,1,0,0,0,1
23316651,1,0,0,0,1
23311838,1,0,0,0,1
23309908,1,0,0,0,1
23308381,0,0,1,0,1
23307388,0,0,1,0,1
23303311,0,0,1,0,1
23301337,0,0,1,0,1
23299635,0,0,1,0,1
23296177,0,0,1,0,1
23652900,0,0,1,0,1
23654735,1,0,0,0,1
23659408,1,0,0,0,1
23899821,1,0,0,0,1
23913163,0,0,1,0,1
23911502,1,0,0,0,1
23911445,1,0,0,0,1
23910847,0,0,1,0,1
23908524,1,0,0,0,1
23905369,1,0,0,0,1
23905146,1,0,0,0,1
23901417,1,0,0,0,1
23901404,1,0,0,0,1
23899573,1,0,0,0,1
23659683,1,0,0,0,1
23884430,0,0,1,0,1
23878336,0,0,1,0,1
23870466,1,0,0,0,1
23862900,1,0,0,0,1
23861788,0,0,1,0,1
23861205,0,0,1,0,1
23860096,1,0,0,0,1
23854797,0,0,1,0,1
23853826,0,0,1,0,1
23913784,1,0,0,0,1
23914377,0,0,1,0,1
23918431,0,0,1,0,1
23936649,1,0,0,0,1
23991556,0,0,1,0,1
23991242,1,0,0,0,1
23991239,0,0,1,0,1
23988743,0,0,1,0,1
23985682,1,0,0,0,1
23985505,1,0,0,0,1
23981711,1,0,0,0,1
23980229,1,0,0,0,1
23971734,0,0,1,0,1
23971405,1,0,0,0,1
23971401,0,0,0,1,1
23971160,0,0,1,0,1
23970798,0,0,1,0,1
23952383,1,0,0,0,1
23949144,1,0,0,0,1
23945185,1,0,0,0,1
23944868,1,0,0,0,1
23939128,1,0,0,0,1
23936958,0,0,1,0,1
23852000,1,0,0,0,1
23851015,1,0,0,0,1
23850513,1,0,0,0,1
23747060,1,0,0,0,1
23732730,1,0,0,0,1
23727216,1,0,0,0,1
23722638,1,0,0,0,1
23720407,1,0,0,0,1
23719409,0,0,1,0,1
23715762,0,0,1,0,1
23713669,1,0,0,0,1
23708355,1,0,0,0,1
23698012,0,0,1,0,1
23697064,0,0,1,0,1
23696703,1,0,0,0,1
23693099,1,0,0,0,1
23688348,1,0,0,0,1
23684948,0,0,1,0,1
23680153,1,0,0,0,1
23678781,1,0,0,0,1
23677128,0,0,1,0,1
23671946,1,0,0,0,1
23667219,0,0,1,0,1
23733399,1,0,0,0,1
23748343,0,0,0,1,1
23847597,1,0,0,0,1
23751556,0,0,1,0,1
23847354,0,0,1,0,1
23835825,0,0,1,0,1
23833056,1,0,0,0,1
23826651,0,0,1,0,1
23824219,0,0,1,0,1
23821373,1,0,0,0,1
23821111,0,0,1,0,1
23820907,1,0,0,0,1
23813425,0,0,1,0,1
23812318,1,0,0,0,1
23794363,1,0,0,0,1
23790442,1,0,0,0,1
23789523,1,0,0,0,1
23788242,0,0,1,0,1
23778570,1,0,0,0,1
23778489,1,0,0,0,1
23777742,1,0,0,0,1
23760930,0,0,1,0,1
23752440,0,0,1,0,1
23147852,0,0,1,0,1
23131509,0,0,0,1,1
22205787,1,0,0,0,1
22489244,0,0,1,0,1
22527211,1,0,0,0,1
22526256,1,0,0,0,1
22508819,0,0,1,0,1
22507599,0,0,1,0,1
22507452,1,0,0,0,1
22503794,0,0,1,0,1
22502429,1,0,0,0,1
22502212,1,0,0,0,1
22502130,0,0,1,0,1
22487371,1,0,0,0,1
22382732,0,0,0,1,1
22462003,1,0,0,0,1
22447518,1,0,0,0,1
22445947,1,0,0,0,1
22440410,1,0,0,0,1
22432953,0,0,1,0,1
22427766,0,0,1,0,1
22414947,0,0,1,0,1
22410600,0,0,1,0,1
22410033,1,0,0,0,1
22527661,0,0,1,0,1
22530714,1,0,0,0,1
22533562,1,0,0,0,1
22534244,0,0,1,0,1
22616989,1,0,0,0,1
22613302,1,0,0,0,1
22611054,1,0,0,0,1
22608145,1,0,0,0,1
22595345,0,0,1,0,1
22593050,1,0,0,0,1
22591930,0,0,1,0,1
22591516,0,0,1,0,1
22578720,0,0,1,0,1
22572797,1,0,0,0,1
22568612,1,0,0,0,1
22565156,0,0,1,0,1
22560728,1,0,0,0,1
22553662,1,0,0,0,1
22550357,0,0,1,0,1
22549130,1,0,0,0,1
22543733,0,0,1,0,1
22541901,1,0,0,0,1
22540706,1,0,0,0,1
22388424,0,0,1,0,1
22375303,0,0,1,0,1
23129690,0,0,0,1,1
22246427,1,0,0,0,1
22282829,0,0,1,0,1
22280299,0,0,1,0,1
22264156,0,0,1,0,1
22262958,1,0,0,0,1
22261783,1,0,0,0,1
22259039,0,0,1,0,1
22257525,1,0,0,0,1
22254292,1,0,0,0,1
22249707,1,0,0,0,1
22245795,0,0,1,0,1
22373907,1,0,0,0,1
22244527,1,0,0,0,1
22243932,0,0,1,0,1
22227178,1,0,0,0,1
22225635,0,0,1,0,1
22223682,0,0,1,0,1
22219331,0,0,1,0,1
22218564,1,0,0,0,1
22216726,1,0,0,0,1
22214626,1,0,0,0,1
22283291,0,0,1,0,1
22284124,0,0,1,0,1
22286061,0,0,1,0,1
22286077,1,0,0,0,1
22369387,1,0,0,0,1
22367030,1,0,0,0,1
22365640,1,0,0,0,1
22364252,1,0,0,0,1
22363037,1,0,0,0,1
22347382,1,0,0,0,1
22347036,0,0,1,0,1
22346913,1,0,0,0,1
22345670,0,0,1,0,1
22344488,1,0,0,0,1
22343983,0,0,1,0,1
22338025,1,0,0,0,1
22337277,1,0,0,0,1
22323950,1,0,0,0,1
22322427,1,0,0,0,1
22313730,0,0,1,0,1
22302461,1,0,0,0,1
22292023,1,0,0,0,1
22288459,0,0,1,0,1
22625462,1,0,0,0,1
22627365,1,0,0,0,1
22628166,0,0,1,0,1
22963797,0,0,1,0,1
23018972,1,0,0,0,1
23006601,0,0,1,0,1
23003756,0,0,1,0,1
23003173,0,0,1,0,1
23002143,1,0,0,0,1
22997536,0,0,1,0,1
22994376,0,0,1,0,1
22992748,1,0,0,0,1
22980167,1,0,0,0,1
22963233,1,0,0,0,1
22645955,0,0,1,0,1
22953164,0,0,1,0,1
22938957,1,0,0,0,1
22935835,1,0,0,0,1
22935573,1,0,0,0,1
22927646,1,0,0,0,1
22919533,0,0,1,0,1
22899202,0,0,1,0,1
22895835,1,0,0,0,1
22894987,1,0,0,0,1
23024846,1,0,0,0,1
23025661,1,0,0,0,1
23026033,1,0,0,0,1
23027289,0,0,1,0,1
23124921,0,0,1,0,1
23121273,1,0,0,0,1
23116198,0,0,1,0,1
23099342,0,0,1,0,1
23090421,1,0,0,0,1
23089516,0,0,1,0,1
23086547,1,0,0,0,1
23084155,1,0,0,0,1
23083111,1,0,0,0,1
23077718,0,0,1,0,1
23066402,1,0,0,0,1
23051154,1,0,0,0,1
23048955,0,0,1,0,1
23048845,1,0,0,0,1
23046908,0,0,1,0,1
23046080,1,0,0,0,1
23039272,0,0,1,0,1
23033819,1,0,0,0,1
23027887,0,0,1,0,1
22893778,1,0,0,0,1
22888115,0,0,1,0,1
22887221,0,0,1,0,1
22769654,1,0,0,0,1
22761603,0,0,1,0,1
22751337,1,0,0,0,1
22739634,1,0,0,0,1
22736811,1,0,0,0,1
22727798,1,0,0,0,1
22727131,1,0,0,0,1
22717726,1,0,0,0,1
22710535,0,0,1,0,1
22703843,0,0,1,0,1
22700616,0,0,1,0,1
22694324,1,0,0,0,1
22688555,0,0,0,1,1
22686810,1,0,0,0,1
22663500,0,0,1,0,1
22661810,1,0,0,0,1
22657141,1,0,0,0,1
22652879,0,0,1,0,1
22651758,1,0,0,0,1
22646790,1,0,0,0,1
22764554,0,0,1,0,1
22770300,1,0,0,0,1
22875538,0,0,1,0,1
22774265,0,0,1,0,1
22866437,1,0,0,0,1
22866409,1,0,0,0,1
22863129,1,0,0,0,1
22861935,1,0,0,0,1
22861607,0,0,1,0,1
22860779,0,0,1,0,1
22858432,0,0,1,0,1
22846970,0,0,1,0,1
22840947,1,0,0,0,1
22840018,1,0,0,0,1
22831759,0,0,1,0,1
22825646,0,0,1,0,1
22816592,1,0,0,0,1
22814290,1,0,0,0,1
22808020,1,0,0,0,1
22805880,1,0,0,0,1
22805576,0,0,1,0,1
22792227,0,0,1,0,1
22781364,1,0,0,0,1
503872891,0,0,0,1,1
